"","genome_position","N","mean_Kd_inverse","N_over_1.5","N_0.15_to_1.5","N_0.09_to_0.15","N_0.04_to_0.09","Total_over_0.04"
"8000",40000000,10000,0.00277018,0,0,8,16,24
"8001",40005000,10000,0.00269735,0,0,7,13,20
"8002",40010000,10000,0.00270852,0,0,5,11,16
"8003",40015000,10000,0.00273554,0,1,2,10,13
"8004",40020000,10000,0.00274632,0,1,3,11,15
"8005",40025000,10000,0.00276621,0,0,4,13,17
"8006",40030000,10000,0.00275662,0,0,1,13,14
"8007",40035000,10000,0.0027364,0,0,0,13,13
"8008",40040000,10000,0.0027107,0,0,5,12,17
"8009",40045000,10000,0.00272458,0,0,10,17,27
"8010",40050000,10000,0.00275297,0,1,7,18,26
"8011",40055000,10000,0.00275583,0,3,4,11,18
"8012",40060000,10000,0.00267487,0,2,3,6,11
"8013",40065000,10000,0.00264681,0,1,1,6,8
"8014",40070000,10000,0.00267507,0,1,1,4,6
"8015",40075000,10000,0.00273712,0,1,7,6,14
"8016",40080000,10000,0.00278827,0,2,8,12,22
"8017",40085000,10000,0.00277833,0,1,4,12,17
"8018",40090000,10000,0.00278398,0,3,2,11,16
"8019",40095000,10000,0.0027613,0,4,3,7,14
"8020",40100000,10000,0.00279704,0,2,5,12,19
"8021",40105000,10000,0.00274848,0,1,3,15,19
"8022",40110000,10000,0.00269765,0,1,2,10,13
"8023",40115000,10000,0.00274934,0,1,3,16,20
"8024",40120000,10000,0.00264455,0,0,2,12,14
"8025",40125000,10000,0.00261525,0,0,3,6,9
"8026",40130000,10000,0.00268082,0,0,4,8,12
"8027",40135000,10000,0.00264905,0,0,4,10,14
"8028",40140000,10000,0.00264684,0,0,5,13,18
"8029",40145000,10000,0.002706,0,1,7,13,21
"8030",40150000,10000,0.00271961,0,1,7,14,22
"8031",40155000,10000,0.00270767,0,0,6,12,18
"8032",40160000,10000,0.0027184,0,0,5,13,18
"8033",40165000,10000,0.00270489,0,0,3,18,21
"8034",40170000,10000,0.00268016,0,0,2,14,16
"8035",40175000,10000,0.00266087,0,0,2,10,12
"8036",40180000,10000,0.00271538,0,0,5,10,15
"8037",40185000,10000,0.00279443,0,1,6,15,22
"8038",40190000,10000,0.00278481,0,2,4,13,19
"8039",40195000,10000,0.00273406,0,1,2,10,13
"8040",40200000,10000,0.00273713,0,1,3,18,22
"8041",40205000,10000,0.00276718,0,1,5,22,28
"8042",40210000,10000,0.00277715,0,0,7,24,31
"8043",40215000,10000,0.00271765,0,0,6,18,24
"8044",40220000,10000,0.00267946,0,0,5,11,16
"8045",40225000,10000,0.00270803,0,0,8,12,20
"8046",40230000,10000,0.0027096,0,0,7,15,22
"8047",40235000,10000,0.00269519,0,0,4,24,28
"8048",40240000,10000,0.00270819,0,0,3,23,26
"8049",40245000,10000,0.00269601,0,0,2,18,20
"8050",40250000,10000,0.00270102,0,0,4,24,28
"8051",40255000,10000,0.00269281,0,0,3,18,21
"8052",40260000,10000,0.00268961,0,0,3,12,15
"8053",40265000,10000,0.00269595,0,0,4,14,18
"8054",40270000,10000,0.00267674,0,0,2,14,16
"8055",40275000,10000,0.00269636,0,1,2,14,17
"8056",40280000,10000,0.00269994,0,1,3,12,16
"8057",40285000,10000,0.00268677,0,2,3,10,15
"8058",40290000,10000,0.00270876,0,3,3,15,21
"8059",40295000,10000,0.00268636,0,1,2,14,17
"8060",40300000,10000,0.00266588,0,1,1,10,12
"8061",40305000,10000,0.00270469,0,3,2,10,15
"8062",40310000,10000,0.00274114,0,4,3,5,12
"8063",40315000,10000,0.00271103,0,2,3,4,9
"8064",40320000,10000,0.00266343,0,0,2,7,9
"8065",40325000,10000,0.00269213,0,0,3,9,12
"8066",40330000,10000,0.00273804,0,1,4,13,18
"8067",40335000,10000,0.00274049,0,1,4,16,21
"8068",40340000,10000,0.00266966,0,0,2,9,11
"8069",40345000,10000,0.00267775,0,0,2,2,4
"8070",40350000,10000,0.00276297,0,1,6,4,11
"8071",40355000,10000,0.00272316,0,1,5,8,14
"8072",40360000,10000,0.00265154,0,0,2,7,9
"8073",40365000,10000,0.00270771,0,1,5,6,12
"8074",40370000,10000,0.00276444,0,1,6,14,21
"8075",40375000,10000,0.0027297,0,1,3,15,19
"8076",40380000,10000,0.00273832,0,2,2,14,18
"8077",40385000,10000,0.00275173,0,2,5,14,21
"8078",40390000,10000,0.00268111,0,1,5,14,20
"8079",40395000,10000,0.0026465,0,0,3,16,19
"8080",40400000,10000,0.00263093,0,1,3,10,14
"8081",40405000,10000,0.00263357,0,1,3,11,15
"8082",40410000,10000,0.00262434,0,0,3,14,17
"8083",40415000,10000,0.00260031,0,1,2,11,14
"8084",40420000,10000,0.00265358,0,1,4,11,16
"8085",40425000,10000,0.00271822,0,1,5,12,18
"8086",40430000,10000,0.00275313,0,2,5,6,13
"8087",40435000,10000,0.00276403,0,1,7,4,12
"8088",40440000,10000,0.00272721,0,2,5,9,16
"8089",40445000,10000,0.00272592,0,2,3,12,17
"8090",40450000,10000,0.00274096,0,0,2,16,18
"8091",40455000,10000,0.00271671,0,1,1,9,11
"8092",40460000,10000,0.00270467,0,2,2,3,7
"8093",40465000,10000,0.00275879,0,3,5,10,18
"8094",40470000,10000,0.00278023,0,3,4,13,20
"8095",40475000,10000,0.00275817,0,2,2,10,14
"8096",40480000,10000,0.0028006,0,1,6,10,17
"8097",40485000,10000,0.00279367,0,1,5,11,17
"8098",40490000,10000,0.00272194,0,1,1,13,15
"8099",40495000,10000,0.00269347,0,0,2,11,13
"8100",40500000,10000,0.00271439,0,0,5,11,16
"8101",40505000,10000,0.00272972,0,1,6,17,24
"8102",40510000,10000,0.00274651,0,1,4,15,20
"8103",40515000,10000,0.00278911,0,1,2,12,15
"8104",40520000,10000,0.00276527,0,1,3,11,15
"8105",40525000,10000,0.00268942,0,0,5,10,15
"8106",40530000,10000,0.00273836,0,2,5,7,14
"8107",40535000,10000,0.00278296,0,3,3,10,16
"8108",40540000,10000,0.00280734,0,2,5,19,26
"8109",40545000,10000,0.00280384,0,1,6,14,21
"8110",40550000,10000,0.00274889,0,0,3,8,11
"8111",40555000,10000,0.00277119,0,1,1,8,10
"8112",40560000,10000,0.00275619,0,2,0,5,7
"8113",40565000,10000,0.00267024,0,1,2,6,9
"8114",40570000,10000,0.00262701,0,0,2,5,7
"8115",40575000,10000,0.00265761,0,1,0,9,10
"8116",40580000,10000,0.00266723,0,1,2,11,14
"8117",40585000,10000,0.00268092,0,0,2,8,10
"8118",40590000,10000,0.00268113,0,0,2,9,11
"8119",40595000,10000,0.00265241,0,1,2,9,12
"8120",40600000,10000,0.00263299,0,2,0,7,9
"8121",40605000,10000,0.00267104,0,1,0,8,9
"8122",40610000,10000,0.00270623,0,1,0,9,10
"8123",40615000,10000,0.00269692,0,1,0,10,11
"8124",40620000,10000,0.00271226,0,0,2,13,15
"8125",40625000,10000,0.00265916,0,0,4,8,12
"8126",40630000,10000,0.00261167,0,0,2,7,9
"8127",40635000,10000,0.0026003,0,0,0,6,6
"8128",40640000,10000,0.00258661,0,1,1,2,4
"8129",40645000,10000,0.0025953,0,1,4,2,7
"8130",40650000,10000,0.00257373,0,0,3,5,8
"8131",40655000,10000,0.00254384,0,1,0,7,8
"8132",40660000,10000,0.00254398,0,1,0,6,7
"8133",40665000,10000,0.00256872,0,0,0,4,4
"8134",40670000,10000,0.00258194,0,0,1,5,6
"8135",40675000,10000,0.00255827,0,0,1,7,8
"8136",40680000,10000,0.00261526,0,0,4,8,12
"8137",40685000,10000,0.00266065,0,0,5,10,15
"8138",40690000,10000,0.00261206,0,0,3,12,15
"8139",40695000,10000,0.00262712,0,0,4,13,17
"8140",40700000,10000,0.00266197,0,0,6,8,14
"8141",40705000,10000,0.00264238,0,0,5,4,9
"8142",40710000,10000,0.0026294,0,0,3,3,6
"8143",40715000,10000,0.00262168,0,0,3,3,6
"8144",40720000,10000,0.00262566,0,0,1,6,7
"8145",40725000,10000,0.00259691,0,0,3,5,8
"8146",40730000,10000,0.00260263,0,0,5,5,10
"8147",40735000,10000,0.0026401,0,1,2,5,8
"8148",40740000,10000,0.00265699,0,2,2,6,10
"8149",40745000,10000,0.00263183,0,1,3,7,11
"8150",40750000,10000,0.00262695,0,0,2,9,11
"8151",40755000,10000,0.00263896,0,1,3,8,12
"8152",40760000,10000,0.00265565,0,2,2,5,9
"8153",40765000,10000,0.00264956,0,1,3,7,11
"8154",40770000,10000,0.00261174,0,0,3,9,12
"8155",40775000,10000,0.00263628,0,1,1,7,9
"8156",40780000,10000,0.00263767,0,1,3,4,8
"8157",40785000,10000,0.00263878,0,1,4,7,12
"8158",40790000,10000,0.00263417,0,2,3,8,13
"8159",40795000,10000,0.00264595,0,2,2,7,11
"8160",40800000,10000,0.00263747,0,3,1,6,10
"8161",40805000,10000,0.00263949,0,2,1,8,11
"8162",40810000,10000,0.00261952,0,0,1,10,11
"8163",40815000,10000,0.00255465,0,0,1,7,8
"8164",40820000,10000,0.00257752,0,0,2,8,10
"8165",40825000,10000,0.00261867,0,0,3,8,11
"8166",40830000,10000,0.00260524,0,0,3,8,11
"8167",40835000,10000,0.00263071,0,0,2,12,14
"8168",40840000,10000,0.00271679,0,2,4,12,18
"8169",40845000,10000,0.00268268,0,2,4,10,16
"8170",40850000,10000,0.00260795,0,1,1,5,7
"8171",40855000,10000,0.00262173,0,1,3,5,9
"8172",40860000,10000,0.00264469,0,0,4,7,11
"8173",40865000,10000,0.0025974,0,0,1,6,7
"8174",40870000,10000,0.00254487,0,0,0,5,5
"8175",40875000,10000,0.00261051,0,1,2,5,8
"8176",40880000,10000,0.00266828,0,2,2,7,11
"8177",40885000,10000,0.00257885,0,1,0,6,7
"8178",40890000,10000,0.00255353,0,0,2,7,9
"8179",40895000,10000,0.00265008,0,0,2,14,16
"8180",40900000,10000,0.00271422,0,1,2,10,13
"8181",40905000,10000,0.00269456,0,2,3,3,8
"8182",40910000,10000,0.00265099,0,1,2,8,11
"8183",40915000,10000,0.00261336,0,1,1,7,9
"8184",40920000,10000,0.00260829,0,1,1,3,5
"8185",40925000,10000,0.00266852,0,0,1,5,6
"8186",40930000,10000,0.00264032,0,0,1,6,7
"8187",40935000,10000,0.00262314,0,1,2,5,8
"8188",40940000,10000,0.00269644,0,1,1,6,8
"8189",40945000,10000,0.0026625,0,0,1,7,8
"8190",40950000,10000,0.00265121,0,2,3,6,11
"8191",40955000,10000,0.00270217,0,3,3,10,16
"8192",40960000,10000,0.0027064,0,2,2,13,17
"8193",40965000,10000,0.0026761,0,1,1,11,13
"8194",40970000,10000,0.00260527,0,1,1,8,10
"8195",40975000,10000,0.00261578,0,1,2,6,9
"8196",40980000,10000,0.0026918,0,0,3,7,10
"8197",40985000,10000,0.00264061,0,0,3,6,9
"8198",40990000,10000,0.00254811,0,0,3,4,7
"8199",40995000,10000,0.00254993,0,0,2,4,6
"8200",41000000,10000,0.00263109,0,2,2,3,7
"8201",41005000,10000,0.00265223,0,2,3,4,9
"8202",41010000,10000,0.00258553,0,0,1,6,7
"8203",41015000,10000,0.00261246,0,0,1,5,6
"8204",41020000,10000,0.00266542,0,1,4,2,7
"8205",41025000,10000,0.00268411,0,1,5,6,12
"8206",41030000,10000,0.00263385,0,0,3,7,10
"8207",41035000,10000,0.00259528,0,0,2,4,6
"8208",41040000,10000,0.00258613,0,0,1,4,5
"8209",41045000,10000,0.00262998,0,0,1,10,11
"8210",41050000,10000,0.00260539,0,1,1,10,12
"8211",41055000,10000,0.00262978,0,1,2,7,10
"8212",41060000,10000,0.00271504,0,2,2,10,14
"8213",41065000,10000,0.00271231,0,3,0,12,15
"8214",41070000,10000,0.00271244,0,1,0,15,16
"8215",41075000,10000,0.00260684,0,0,0,8,8
"8216",41080000,10000,0.0025996,0,1,0,3,4
"8217",41085000,10000,0.00265501,0,1,3,5,9
"8218",41090000,10000,0.00259725,0,0,5,8,13
"8219",41095000,10000,0.00259136,0,0,2,8,10
"8220",41100000,10000,0.0026192,0,0,1,7,8
"8221",41105000,10000,0.00265263,0,0,4,5,9
"8222",41110000,10000,0.00263763,0,0,5,5,10
"8223",41115000,10000,0.00260079,0,0,2,6,8
"8224",41120000,10000,0.00261914,0,0,0,5,5
"8225",41125000,10000,0.00257743,0,0,0,5,5
"8226",41130000,10000,0.002547,0,0,0,4,4
"8227",41135000,10000,0.0026016,0,0,2,6,8
"8228",41140000,10000,0.0026623,0,1,3,7,11
"8229",41145000,10000,0.00261265,0,1,1,3,5
"8230",41150000,10000,0.00257916,0,1,1,2,4
"8231",41155000,10000,0.0026465,0,1,2,6,9
"8232",41160000,10000,0.00267493,0,0,1,7,8
"8233",41165000,10000,0.00264251,0,0,0,5,5
"8234",41170000,10000,0.00261387,0,0,1,3,4
"8235",41175000,10000,0.00266279,0,0,1,4,5
"8236",41180000,10000,0.00270106,0,0,5,6,11
"8237",41185000,10000,0.00267131,0,0,7,7,14
"8238",41190000,10000,0.0026458,0,0,3,7,10
"8239",41195000,10000,0.00262125,0,0,3,6,9
"8240",41200000,10000,0.00262047,0,0,3,6,9
"8241",41205000,10000,0.00264313,0,0,2,6,8
"8242",41210000,10000,0.00267065,0,1,1,10,12
"8243",41215000,10000,0.00268751,0,1,1,12,14
"8244",41220000,10000,0.00264537,0,1,1,6,8
"8245",41225000,10000,0.00263283,0,1,1,3,5
"8246",41230000,10000,0.00265629,0,0,1,5,6
"8247",41235000,10000,0.00265221,0,0,0,6,6
"8248",41240000,10000,0.0026645,0,0,0,4,4
"8249",41245000,10000,0.0026693,0,0,1,5,6
"8250",41250000,10000,0.00264021,0,0,2,7,9
"8251",41255000,10000,0.00261173,0,0,1,4,5
"8252",41260000,10000,0.00260437,0,0,1,4,5
"8253",41265000,10000,0.00262467,0,0,2,3,5
"8254",41270000,10000,0.00263641,0,0,3,2,5
"8255",41275000,10000,0.00267414,0,0,3,7,10
"8256",41280000,10000,0.00268596,0,0,1,8,9
"8257",41285000,10000,0.00265494,0,0,3,10,13
"8258",41290000,10000,0.00264095,0,0,4,15,19
"8259",41295000,10000,0.00261998,0,0,3,13,16
"8260",41300000,10000,0.00266242,0,1,2,7,10
"8261",41305000,10000,0.00271194,0,1,2,3,6
"8262",41310000,10000,0.00269209,0,1,4,4,9
"8263",41315000,10000,0.00269201,0,1,4,6,11
"8264",41320000,10000,0.00267435,0,0,2,7,9
"8265",41325000,10000,0.0026827,0,0,1,5,6
"8266",41330000,10000,0.00271777,0,0,1,2,3
"8267",41335000,10000,0.00268876,0,1,0,4,5
"8268",41340000,10000,0.00270479,0,3,0,5,8
"8269",41345000,10000,0.00271948,0,2,0,4,6
"8270",41350000,10000,0.00267854,0,0,0,6,6
"8271",41355000,10000,0.00257155,0,0,0,4,4
"8272",41360000,10000,0.00261076,0,1,1,5,7
"8273",41365000,10000,0.00273003,0,1,1,12,14
"8274",41370000,10000,0.00272141,0,0,2,14,16
"8275",41375000,10000,0.00271856,0,0,2,13,15
"8276",41380000,10000,0.00269996,0,0,0,8,8
"8277",41385000,10000,0.00267404,0,1,1,5,7
"8278",41390000,10000,0.00268622,0,2,3,5,10
"8279",41395000,10000,0.00273364,0,1,2,9,12
"8280",41400000,10000,0.00274527,0,1,1,13,15
"8281",41405000,10000,0.00275702,0,1,2,11,14
"8282",41410000,10000,0.00272955,0,0,2,13,15
"8283",41415000,10000,0.00268635,0,0,2,14,16
"8284",41420000,10000,0.00276928,0,0,2,9,11
"8285",41425000,10000,0.00276244,0,0,2,10,12
"8286",41430000,10000,0.0026694,0,0,2,12,14
"8287",41435000,10000,0.00268076,0,0,1,5,6
"8288",41440000,10000,0.0027169,0,0,1,3,4
"8289",41445000,10000,0.00277319,0,0,3,11,14
"8290",41450000,10000,0.00274605,0,0,3,10,13
"8291",41455000,10000,0.00266954,0,0,2,5,7
"8292",41460000,10000,0.00270499,0,0,2,8,10
"8293",41465000,10000,0.00275268,0,1,1,8,10
"8294",41470000,10000,0.00273107,0,1,3,7,11
"8295",41475000,10000,0.00279782,0,0,4,12,16
"8296",41480000,10000,0.00281006,0,1,2,12,15
"8297",41485000,10000,0.00276903,0,2,1,9,12
"8298",41490000,10000,0.00278852,0,1,2,9,12
"8299",41495000,10000,0.0027493,0,0,3,7,10
"8300",41500000,10000,0.00276947,0,0,4,6,10
"8301",41505000,10000,0.00274645,0,0,3,5,8
"8302",41510000,10000,0.00269672,0,0,0,8,8
"8303",41515000,10000,0.00279684,0,1,2,13,16
"8304",41520000,10000,0.00281163,0,2,2,11,15
"8305",41525000,10000,0.00271757,0,2,2,7,11
"8306",41530000,10000,0.00272385,0,1,3,9,13
"8307",41535000,10000,0.00277096,0,1,2,13,16
"8308",41540000,10000,0.00271834,0,2,1,10,13
"8309",41545000,10000,0.00269074,0,3,0,6,9
"8310",41550000,10000,0.00277309,0,4,1,7,12
"8311",41555000,10000,0.00276515,0,2,3,8,13
"8312",41560000,10000,0.00271041,0,0,4,7,11
"8313",41565000,10000,0.0027425,0,0,3,9,12
"8314",41570000,10000,0.00278522,0,0,2,8,10
"8315",41575000,10000,0.00273497,0,0,2,9,11
"8316",41580000,10000,0.00277804,0,1,3,9,13
"8317",41585000,10000,0.00279381,0,2,2,7,11
"8318",41590000,10000,0.00269634,0,1,1,9,11
"8319",41595000,10000,0.00274102,0,0,1,8,9
"8320",41600000,10000,0.00271825,0,0,0,7,7
"8321",41605000,10000,0.00267555,0,0,1,7,8
"8322",41610000,10000,0.00276822,0,0,2,9,11
"8323",41615000,10000,0.00279711,0,1,2,8,11
"8324",41620000,10000,0.0027671,0,1,1,5,7
"8325",41625000,10000,0.00277757,0,0,1,9,10
"8326",41630000,10000,0.00286368,0,0,3,19,22
"8327",41635000,10000,0.00283528,0,0,3,14,17
"8328",41640000,10000,0.00277045,0,1,3,11,15
"8329",41645000,10000,0.00273623,0,1,4,14,19
"8330",41650000,10000,0.00273128,0,1,2,9,12
"8331",41655000,10000,0.0027373,0,1,1,5,7
"8332",41660000,10000,0.00271855,0,0,2,9,11
"8333",41665000,10000,0.00271572,0,0,3,14,17
"8334",41670000,10000,0.00269324,0,0,6,16,22
"8335",41675000,10000,0.0027487,0,1,6,20,27
"8336",41680000,10000,0.00275363,0,2,4,17,23
"8337",41685000,10000,0.00265276,0,1,3,13,17
"8338",41690000,10000,0.00265304,0,0,2,12,14
"8339",41695000,10000,0.00273614,0,1,3,13,17
"8340",41700000,10000,0.00273044,0,1,5,14,20
"8341",41705000,10000,0.00272851,0,1,4,13,18
"8342",41710000,10000,0.0027403,0,1,2,13,16
"8343",41715000,10000,0.00271817,0,1,3,13,17
"8344",41720000,10000,0.00274212,0,1,6,15,22
"8345",41725000,10000,0.00278712,0,0,8,15,23
"8346",41730000,10000,0.002778,0,0,7,12,19
"8347",41735000,10000,0.00273583,0,0,5,8,13
"8348",41740000,10000,0.0027554,0,0,5,12,17
"8349",41745000,10000,0.00275572,0,0,5,21,26
"8350",41750000,10000,0.00272466,0,0,5,16,21
"8351",41755000,10000,0.00275516,0,0,8,7,15
"8352",41760000,10000,0.00280186,0,0,7,12,19
"8353",41765000,10000,0.00277838,0,0,4,16,20
"8354",41770000,10000,0.00277262,0,0,3,19,22
"8355",41775000,10000,0.00279447,0,0,3,21,24
"8356",41780000,10000,0.00276394,0,0,5,20,25
"8357",41785000,10000,0.00269925,0,1,4,16,21
"8358",41790000,10000,0.00271567,0,2,4,10,16
"8359",41795000,10000,0.00275158,0,1,5,13,19
"8360",41800000,10000,0.00273231,0,0,3,20,23
"8361",41805000,10000,0.00277759,0,2,2,19,23
"8362",41810000,10000,0.00274843,0,2,1,13,16
"8363",41815000,10000,0.00270544,0,0,3,14,17
"8364",41820000,10000,0.0027346,0,0,6,11,17
"8365",41825000,10000,0.0027383,0,1,4,9,14
"8366",41830000,10000,0.00271791,0,1,3,11,15
"8367",41835000,10000,0.00268667,0,0,3,13,16
"8368",41840000,10000,0.00270668,0,0,4,21,25
"8369",41845000,10000,0.00270039,0,0,3,24,27
"8370",41850000,10000,0.00264375,0,0,1,14,15
"8371",41855000,10000,0.00269468,0,0,4,16,20
"8372",41860000,10000,0.00272304,0,0,6,15,21
"8373",41865000,10000,0.00264821,0,0,4,5,9
"8374",41870000,10000,0.00273611,0,3,2,7,12
"8375",41875000,10000,0.00278207,0,3,3,8,14
"8376",41880000,10000,0.00270728,0,1,4,7,12
"8377",41885000,10000,0.00272298,0,1,4,11,16
"8378",41890000,10000,0.00271045,0,1,2,13,16
"8379",41895000,10000,0.00270565,0,1,1,12,14
"8380",41900000,10000,0.00273337,0,1,1,14,16
"8381",41905000,10000,0.002792,0,4,1,14,19
"8382",41910000,10000,0.00279425,0,3,3,10,16
"8383",41915000,10000,0.00270871,0,0,3,10,13
"8384",41920000,10000,0.00268341,0,0,2,18,20
"8385",41925000,10000,0.00270687,0,0,2,17,19
"8386",41930000,10000,0.00274082,0,0,3,14,17
"8387",41935000,10000,0.00278615,0,1,2,16,19
"8388",41940000,10000,0.0027506,0,1,1,14,16
"8389",41945000,10000,0.00271571,0,1,5,14,20
"8390",41950000,10000,0.0027371,0,1,7,15,23
"8391",41955000,10000,0.00273524,0,0,6,17,23
"8392",41960000,10000,0.00270757,0,0,4,15,19
"8393",41965000,10000,0.00268148,0,0,1,10,11
"8394",41970000,10000,0.00272395,0,1,4,7,12
"8395",41975000,10000,0.00274514,0,1,6,10,17
"8396",41980000,10000,0.0027561,0,0,5,17,22
"8397",41985000,10000,0.002745,0,1,5,12,18
"8398",41990000,10000,0.0026958,0,1,2,8,11
"8399",41995000,10000,0.00267693,0,0,0,11,11
"8400",42000000,10000,0.00266354,0,0,1,12,13
"8401",42005000,10000,0.00264577,0,0,2,17,19
"8402",42010000,10000,0.00265756,0,0,2,15,17
"8403",42015000,10000,0.00267319,0,0,2,9,11
"8404",42020000,10000,0.00275095,0,3,1,7,11
"8405",42025000,10000,0.00281352,0,4,2,11,17
"8406",42030000,10000,0.00281341,0,1,8,17,26
"8407",42035000,10000,0.00277162,0,0,7,14,21
"8408",42040000,10000,0.00268614,0,0,3,9,12
"8409",42045000,10000,0.00271229,0,0,6,14,20
"8410",42050000,10000,0.00276449,0,1,6,15,22
"8411",42055000,10000,0.00276597,0,3,2,9,14
"8412",42060000,10000,0.00275253,0,3,1,10,14
"8413",42065000,10000,0.00275,0,2,2,10,14
"8414",42070000,10000,0.00273175,0,1,4,10,15
"8415",42075000,10000,0.00270609,0,0,5,13,18
"8416",42080000,10000,0.00271564,0,0,5,14,19
"8417",42085000,10000,0.002698,0,0,4,12,16
"8418",42090000,10000,0.00270922,0,0,6,11,17
"8419",42095000,10000,0.00270026,0,0,7,8,15
"8420",42100000,10000,0.00268113,0,0,4,8,12
"8421",42105000,10000,0.00275027,0,0,5,11,16
"8422",42110000,10000,0.00275857,0,0,4,8,12
"8423",42115000,10000,0.00280904,0,3,1,9,13
"8424",42120000,10000,0.00281423,0,4,2,12,18
"8425",42125000,10000,0.00276766,0,2,5,10,17
"8426",42130000,10000,0.00275269,0,1,3,7,11
"8427",42135000,10000,0.00273596,0,1,2,7,10
"8428",42140000,10000,0.00273862,0,2,3,10,15
"8429",42145000,10000,0.00271029,0,1,4,12,17
"8430",42150000,10000,0.00273888,0,0,6,16,22
"8431",42155000,10000,0.00275338,0,0,6,20,26
"8432",42160000,10000,0.00271251,0,0,5,16,21
"8433",42165000,10000,0.00275552,0,2,3,13,18
"8434",42170000,10000,0.00279155,0,3,2,12,17
"8435",42175000,10000,0.00283324,0,3,4,14,21
"8436",42180000,10000,0.00277287,0,2,3,15,20
"8437",42185000,10000,0.0026861,0,0,3,13,16
"8438",42190000,10000,0.00273665,0,0,4,14,18
"8439",42195000,10000,0.00273496,0,1,3,15,19
"8440",42200000,10000,0.00273536,0,1,3,16,20
"8441",42205000,10000,0.00271846,0,0,3,19,22
"8442",42210000,10000,0.00272213,0,2,3,18,23
"8443",42215000,10000,0.00281829,0,4,2,14,20
"8444",42220000,10000,0.00288612,0,3,2,20,25
"8445",42225000,10000,0.00279379,0,1,3,21,25
"8446",42230000,10000,0.00266904,0,1,3,14,18
"8447",42235000,10000,0.00264317,0,2,1,13,16
"8448",42240000,10000,0.00264159,0,2,1,11,14
"8449",42245000,10000,0.00268057,0,3,2,9,14
"8450",42250000,10000,0.00270004,0,2,3,12,17
"8451",42255000,10000,0.00265447,0,1,3,16,20
"8452",42260000,10000,0.00257929,0,1,1,12,14
"8453",42265000,10000,0.00258067,0,0,2,11,13
"8454",42270000,10000,0.0025738,0,0,2,10,12
"8455",42275000,10000,0.00257987,0,0,2,6,8
"8456",42280000,10000,0.00269415,0,1,5,7,13
"8457",42285000,10000,0.00268909,0,1,3,7,11
"8458",42290000,10000,0.00267479,0,0,1,11,12
"8459",42295000,10000,0.00276599,0,0,3,14,17
"8460",42300000,10000,0.00285101,0,1,3,15,19
"8461",42305000,10000,0.00281364,0,1,3,10,14
"8462",42310000,10000,0.00268207,0,0,2,5,7
"8463",42315000,10000,0.0027087,0,1,3,10,14
"8464",42320000,10000,0.00273764,0,1,4,9,14
"8465",42325000,10000,0.00269873,0,0,2,11,13
"8466",42330000,10000,0.00271308,0,0,3,13,16
"8467",42335000,10000,0.0028236,0,0,11,9,20
"8468",42340000,10000,0.00280783,0,0,10,13,23
"8469",42345000,10000,0.00268456,0,0,3,12,15
"8470",42350000,10000,0.00268532,0,0,4,16,20
"8471",42355000,10000,0.00265563,0,0,4,18,22
"8472",42360000,10000,0.00268355,0,0,3,12,15
"8473",42365000,10000,0.00269214,0,0,2,11,13
"8474",42370000,10000,0.00267876,0,1,5,10,16
"8475",42375000,10000,0.00265961,0,1,4,10,15
"8476",42380000,10000,0.00265194,0,0,2,16,18
"8477",42385000,10000,0.0026401,0,0,2,16,18
"8478",42390000,10000,0.00265904,0,0,2,15,17
"8479",42395000,10000,0.00273862,0,0,4,16,20
"8480",42400000,10000,0.00272313,0,0,3,11,14
"8481",42405000,10000,0.00270288,0,0,2,10,12
"8482",42410000,10000,0.00272304,0,1,3,14,18
"8483",42415000,10000,0.00271003,0,1,4,13,18
"8484",42420000,10000,0.00267441,0,0,4,8,12
"8485",42425000,10000,0.00268969,0,0,3,12,15
"8486",42430000,10000,0.00269298,0,1,2,15,18
"8487",42435000,10000,0.00264332,0,1,2,14,17
"8488",42440000,10000,0.00265505,0,2,2,14,18
"8489",42445000,10000,0.0026862,0,2,3,15,20
"8490",42450000,10000,0.002678,0,1,2,16,19
"8491",42455000,10000,0.00263354,0,1,1,10,12
"8492",42460000,10000,0.00264237,0,1,4,8,13
"8493",42465000,10000,0.00271527,0,1,6,19,26
"8494",42470000,10000,0.00270833,0,0,5,21,26
"8495",42475000,10000,0.00264466,0,0,2,8,10
"8496",42480000,10000,0.00266108,0,0,2,8,10
"8497",42485000,10000,0.00275511,0,2,5,17,24
"8498",42490000,10000,0.00277621,0,2,6,15,23
"8499",42495000,10000,0.00271636,0,0,7,13,20
"8500",42500000,10000,0.0026702,0,0,6,12,18
"8501",42505000,10000,0.00272335,0,0,5,13,18
"8502",42510000,10000,0.00279404,0,1,4,11,16
"8503",42515000,10000,0.00278578,0,2,3,7,12
"8504",42520000,10000,0.00272383,0,1,6,10,17
"8505",42525000,10000,0.00271864,0,0,5,18,23
"8506",42530000,10000,0.00272352,0,1,4,20,25
"8507",42535000,10000,0.0026954,0,1,6,15,22
"8508",42540000,10000,0.00277107,0,1,4,18,23
"8509",42545000,10000,0.00282044,0,3,4,16,23
"8510",42550000,10000,0.00278317,0,3,7,7,17
"8511",42555000,10000,0.00276621,0,1,6,12,19
"8512",42560000,10000,0.00273295,0,0,3,16,19
"8513",42565000,10000,0.0027033,0,0,3,8,11
"8514",42570000,10000,0.00271476,0,0,6,6,12
"8515",42575000,10000,0.00271673,0,0,5,7,12
"8516",42580000,10000,0.0027121,0,0,3,9,12
"8517",42585000,10000,0.00275928,0,1,5,15,21
"8518",42590000,10000,0.00274653,0,1,7,12,20
"8519",42595000,10000,0.00269138,0,1,9,5,15
"8520",42600000,10000,0.00265121,0,1,5,11,17
"8521",42605000,10000,0.00261246,0,0,0,18,18
"8522",42610000,10000,0.00268031,0,0,0,19,19
"8523",42615000,10000,0.00274535,0,0,4,15,19
"8524",42620000,10000,0.00272549,0,1,5,12,18
"8525",42625000,10000,0.00275844,0,2,3,18,23
"8526",42630000,10000,0.00271325,0,1,4,22,27
"8527",42635000,10000,0.00265949,0,0,5,19,24
"8528",42640000,10000,0.00271673,0,1,5,15,21
"8529",42645000,10000,0.00270835,0,1,3,15,19
"8530",42650000,10000,0.00272736,0,1,4,17,22
"8531",42655000,10000,0.00271265,0,1,4,15,20
"8532",42660000,10000,0.00267187,0,0,2,12,14
"8533",42665000,10000,0.00278861,0,0,5,12,17
"8534",42670000,10000,0.00277299,0,0,5,11,16
"8535",42675000,10000,0.00261554,0,0,1,9,10
"8536",42680000,10000,0.00259503,0,0,1,10,11
"8537",42685000,10000,0.00270509,0,2,5,8,15
"8538",42690000,10000,0.00277111,0,3,6,5,14
"8539",42695000,10000,0.00274328,0,1,4,9,14
"8540",42700000,10000,0.00271514,0,0,2,10,12
"8541",42705000,10000,0.00273063,0,1,2,10,13
"8542",42710000,10000,0.00270616,0,1,2,13,16
"8543",42715000,10000,0.00259451,0,0,0,11,11
"8544",42720000,10000,0.00261282,0,1,2,10,13
"8545",42725000,10000,0.00269093,0,1,4,18,23
"8546",42730000,10000,0.00269907,0,0,7,16,23
"8547",42735000,10000,0.00269998,0,0,7,13,20
"8548",42740000,10000,0.002657,0,0,3,12,15
"8549",42745000,10000,0.00263408,0,0,1,11,12
"8550",42750000,10000,0.00265813,0,1,1,13,15
"8551",42755000,10000,0.00267898,0,1,3,10,14
"8552",42760000,10000,0.00268041,0,0,4,8,12
"8553",42765000,10000,0.00269441,0,0,4,14,18
"8554",42770000,10000,0.00271159,0,1,3,20,24
"8555",42775000,10000,0.00270564,0,1,3,17,21
"8556",42780000,10000,0.00268806,0,0,2,11,13
"8557",42785000,10000,0.00275294,0,0,5,12,17
"8558",42790000,10000,0.0028087,0,1,7,14,22
"8559",42795000,10000,0.00275678,0,1,5,10,16
"8560",42800000,10000,0.00273404,0,2,4,8,14
"8561",42805000,10000,0.00269876,0,2,2,11,15
"8562",42810000,10000,0.00266535,0,0,2,15,17
"8563",42815000,10000,0.00273052,0,1,2,14,17
"8564",42820000,10000,0.0027871,0,2,5,15,22
"8565",42825000,10000,0.0027167,0,1,5,13,19
"8566",42830000,10000,0.00263659,0,0,1,9,10
"8567",42835000,10000,0.00270754,0,1,3,13,17
"8568",42840000,10000,0.0027535,0,1,5,13,19
"8569",42845000,10000,0.00270842,0,0,3,8,11
"8570",42850000,10000,0.00278007,0,3,1,8,12
"8571",42855000,10000,0.00281361,0,3,2,11,16
"8572",42860000,10000,0.00291465,1,0,3,19,23
"8573",42865000,10000,0.00288056,1,0,2,17,20
"8574",42870000,10000,0.00271854,0,1,2,11,14
"8575",42875000,10000,0.00272802,0,1,2,13,16
"8576",42880000,10000,0.00276849,0,1,3,15,19
"8577",42885000,10000,0.00279236,0,2,5,18,25
"8578",42890000,10000,0.00272822,0,1,4,19,24
"8579",42895000,10000,0.00270232,0,1,3,13,17
"8580",42900000,10000,0.00275564,0,2,4,14,20
"8581",42905000,10000,0.00272819,0,1,2,17,20
"8582",42910000,10000,0.00270134,0,0,1,15,16
"8583",42915000,10000,0.00269939,0,0,3,15,18
"8584",42920000,10000,0.00265433,0,0,4,12,16
"8585",42925000,10000,0.00265923,0,0,3,16,19
"8586",42930000,10000,0.00269409,0,0,2,18,20
"8587",42935000,10000,0.00271305,0,1,1,17,19
"8588",42940000,10000,0.00272734,0,1,1,19,21
"8589",42945000,10000,0.00276247,0,2,2,12,16
"8590",42950000,10000,0.00278015,0,2,3,9,14
"8591",42955000,10000,0.00280651,0,0,4,18,22
"8592",42960000,10000,0.00275634,0,0,2,21,23
"8593",42965000,10000,0.00264734,0,2,2,16,20
"8594",42970000,10000,0.00266085,0,2,6,11,19
"8595",42975000,10000,0.00274724,0,1,6,12,19
"8596",42980000,10000,0.00273647,0,1,5,15,21
"8597",42985000,10000,0.00269639,0,0,6,12,18
"8598",42990000,10000,0.00271822,0,0,5,10,15
"8599",42995000,10000,0.00271986,0,0,5,10,15
"8600",43000000,10000,0.00276003,0,0,7,15,22
"8601",43005000,10000,0.0027582,0,0,6,20,26
"8602",43010000,10000,0.00274224,0,0,4,15,19
"8603",43015000,10000,0.00277928,0,0,4,11,15
"8604",43020000,10000,0.00272155,0,1,3,9,13
"8605",43025000,10000,0.00270056,0,2,4,11,17
"8606",43030000,10000,0.0027392,0,1,6,12,19
"8607",43035000,10000,0.0027025,0,0,5,7,12
"8608",43040000,10000,0.00267219,0,0,4,7,11
"8609",43045000,10000,0.00271032,0,0,5,11,16
"8610",43050000,10000,0.0027646,0,0,8,12,20
"8611",43055000,10000,0.00274328,0,0,7,9,16
"8612",43060000,10000,0.00271853,0,0,4,11,15
"8613",43065000,10000,0.00273138,0,0,6,15,21
"8614",43070000,10000,0.00270636,0,1,6,16,23
"8615",43075000,10000,0.0026399,0,1,3,14,18
"8616",43080000,10000,0.00264509,0,0,1,15,16
"8617",43085000,10000,0.00266826,0,0,3,12,15
"8618",43090000,10000,0.00264013,0,0,3,6,9
"8619",43095000,10000,0.00262426,0,0,0,9,9
"8620",43100000,10000,0.00264455,0,0,1,17,18
"8621",43105000,10000,0.00265158,0,1,3,17,21
"8622",43110000,10000,0.00266804,0,1,7,11,19
"8623",43115000,10000,0.00269324,0,1,7,12,20
"8624",43120000,10000,0.00271747,0,2,6,15,23
"8625",43125000,10000,0.00273755,0,1,8,10,19
"8626",43130000,10000,0.00265363,0,0,5,7,12
"8627",43135000,10000,0.00265023,0,1,2,11,14
"8628",43140000,10000,0.0027237,0,1,4,13,18
"8629",43145000,10000,0.00270086,0,0,6,12,18
"8630",43150000,10000,0.00270672,0,1,5,15,21
"8631",43155000,10000,0.0027213,0,1,3,20,24
"8632",43160000,10000,0.00268092,0,0,2,14,16
"8633",43165000,10000,0.00265205,0,0,3,12,15
"8634",43170000,10000,0.00265763,0,1,5,15,21
"8635",43175000,10000,0.00263148,0,1,3,10,14
"8636",43180000,10000,0.00264898,0,0,2,12,14
"8637",43185000,10000,0.00270081,0,0,4,15,19
"8638",43190000,10000,0.00268589,0,0,5,8,13
"8639",43195000,10000,0.00268742,0,0,4,9,13
"8640",43200000,10000,0.00270989,0,0,3,14,17
"8641",43205000,10000,0.00270035,0,0,4,17,21
"8642",43210000,10000,0.00266605,0,0,3,15,18
"8643",43215000,10000,0.00275018,0,1,4,12,17
"8644",43220000,10000,0.00278218,0,1,3,9,13
"8645",43225000,10000,0.00273717,0,0,3,13,16
"8646",43230000,10000,0.0027049,0,1,4,16,21
"8647",43235000,10000,0.00268776,0,3,1,6,10
"8648",43240000,10000,0.00267217,0,3,0,1,4
"8649",43245000,10000,0.0026446,0,2,0,2,4
"8650",43250000,10000,0.00265777,0,3,0,2,5
"8651",43255000,10000,0.00268856,0,4,0,2,6
"8652",43260000,10000,0.00271789,0,4,0,5,9
"8653",43265000,10000,0.00267253,0,3,0,4,7
"8654",43270000,10000,0.00263441,0,3,0,2,5
"8655",43275000,10000,0.00265155,0,3,1,4,8
"8656",43280000,10000,0.00268445,0,3,1,5,9
"8657",43285000,10000,0.00270549,0,4,0,4,8
"8658",43290000,10000,0.00267249,0,3,0,4,7
"8659",43295000,10000,0.00265622,0,3,0,2,5
"8660",43300000,10000,0.0026603,0,2,1,7,10
"8661",43305000,10000,0.00267001,0,0,2,19,21
"8662",43310000,10000,0.00270671,0,1,4,19,24
"8663",43315000,10000,0.00268108,0,1,4,11,16
"8664",43320000,10000,0.00268607,0,0,2,10,12
"8665",43325000,10000,0.00268402,0,0,1,9,10
"8666",43330000,10000,0.00269269,0,0,1,6,7
"8667",43335000,10000,0.00271982,0,0,1,7,8
"8668",43340000,10000,0.00268789,0,0,1,6,7
"8669",43345000,10000,0.00267292,0,0,3,5,8
"8670",43350000,10000,0.0026703,0,0,3,10,13
"8671",43355000,10000,0.00269649,0,0,1,15,16
"8672",43360000,10000,0.00270179,0,1,3,10,14
"8673",43365000,10000,0.00265403,0,1,5,5,11
"8674",43370000,10000,0.00268199,0,0,4,12,16
"8675",43375000,10000,0.00273471,0,0,2,19,21
"8676",43380000,10000,0.00274514,0,0,0,17,17
"8677",43385000,10000,0.00272973,0,0,2,12,14
"8678",43390000,10000,0.00271018,0,1,3,12,16
"8679",43395000,10000,0.00272158,0,2,3,12,17
"8680",43400000,10000,0.00274698,0,2,4,9,15
"8681",43405000,10000,0.00272492,0,1,2,8,11
"8682",43410000,10000,0.00268895,0,0,1,10,11
"8683",43415000,10000,0.00273613,0,2,1,12,15
"8684",43420000,10000,0.00275078,0,3,1,19,23
"8685",43425000,10000,0.00271187,0,1,3,20,24
"8686",43430000,10000,0.00272607,0,1,3,13,17
"8687",43435000,10000,0.00272269,0,1,3,14,18
"8688",43440000,10000,0.00271135,0,1,3,14,18
"8689",43445000,10000,0.00268342,0,2,1,13,16
"8690",43450000,10000,0.00261348,0,1,0,12,13
"8691",43455000,10000,0.0026426,0,0,1,11,12
"8692",43460000,10000,0.00269995,0,1,3,12,16
"8693",43465000,10000,0.0027139,0,1,4,11,16
"8694",43470000,10000,0.0027046,0,0,4,14,18
"8695",43475000,10000,0.00270099,0,0,4,16,20
"8696",43480000,10000,0.00270264,0,0,5,15,20
"8697",43485000,10000,0.00270703,0,1,6,17,24
"8698",43490000,10000,0.00267461,0,1,3,15,19
"8699",43495000,10000,0.00261899,0,0,1,9,10
"8700",43500000,10000,0.00264051,0,0,5,10,15
"8701",43505000,10000,0.00270079,0,0,8,14,22
"8702",43510000,10000,0.00266795,0,0,6,13,19
"8703",43515000,10000,0.00259837,0,0,3,10,13
"8704",43520000,10000,0.0026583,0,1,1,10,12
"8705",43525000,10000,0.00274202,0,2,0,8,10
"8706",43530000,10000,0.00270836,0,1,1,8,10
"8707",43535000,10000,0.00270073,0,1,1,13,15
"8708",43540000,10000,0.00269045,0,1,1,10,12
"8709",43545000,10000,0.00268509,0,2,1,8,11
"8710",43550000,10000,0.00272308,0,3,3,11,17
"8711",43555000,10000,0.00274784,0,2,7,15,24
"8712",43560000,10000,0.00273988,0,1,5,15,21
"8713",43565000,10000,0.00270963,0,0,2,14,16
"8714",43570000,10000,0.00276918,0,1,5,16,22
"8715",43575000,10000,0.0027688,0,1,4,11,16
"8716",43580000,10000,0.00268878,0,0,1,7,8
"8717",43585000,10000,0.00269253,0,0,5,12,17
"8718",43590000,10000,0.00272372,0,0,6,19,25
"8719",43595000,10000,0.00274318,0,1,4,16,21
"8720",43600000,10000,0.00274347,0,1,3,13,17
"8721",43605000,10000,0.00273021,0,0,2,18,20
"8722",43610000,10000,0.0027315,0,1,2,16,19
"8723",43615000,10000,0.00272104,0,1,1,11,13
"8724",43620000,10000,0.00270237,0,0,2,12,14
"8725",43625000,10000,0.00270051,0,0,2,14,16
"8726",43630000,10000,0.00271848,0,0,0,11,11
"8727",43635000,10000,0.00272849,0,1,1,11,13
"8728",43640000,10000,0.00276817,0,5,1,13,19
"8729",43645000,10000,0.00272722,0,4,3,10,17
"8730",43650000,10000,0.00270306,0,0,5,13,18
"8731",43655000,10000,0.00270919,0,0,4,11,15
"8732",43660000,10000,0.00264976,0,0,2,6,8
"8733",43665000,10000,0.00266611,0,0,4,10,14
"8734",43670000,10000,0.00270246,0,0,4,15,19
"8735",43675000,10000,0.00273278,0,1,2,14,17
"8736",43680000,10000,0.00271956,0,1,3,10,14
"8737",43685000,10000,0.0027151,0,0,4,11,15
"8738",43690000,10000,0.0027479,0,0,5,11,16
"8739",43695000,10000,0.00275237,0,0,3,12,15
"8740",43700000,10000,0.00269538,0,0,2,11,13
"8741",43705000,10000,0.00273897,0,2,3,12,17
"8742",43710000,10000,0.00272978,0,2,2,10,14
"8743",43715000,10000,0.00268355,0,1,0,10,11
"8744",43720000,10000,0.00271356,0,1,2,14,17
"8745",43725000,10000,0.00269116,0,0,4,15,19
"8746",43730000,10000,0.00271824,0,1,4,12,17
"8747",43735000,10000,0.00267997,0,2,2,7,11
"8748",43740000,10000,0.00268365,0,2,1,7,10
"8749",43745000,10000,0.00270331,0,1,3,9,13
"8750",43750000,10000,0.00267879,0,0,5,8,13
"8751",43755000,10000,0.00267446,0,0,3,6,9
"8752",43760000,10000,0.00268069,0,0,3,11,14
"8753",43765000,10000,0.00266655,0,0,3,8,11
"8754",43770000,10000,0.00271385,0,0,3,9,12
"8755",43775000,10000,0.00273799,0,0,6,13,19
"8756",43780000,10000,0.00265115,0,0,3,7,10
"8757",43785000,10000,0.00262916,0,0,2,7,9
"8758",43790000,10000,0.00266067,0,0,2,11,13
"8759",43795000,10000,0.00271959,0,0,0,14,14
"8760",43800000,10000,0.00267858,0,0,1,11,12
"8761",43805000,10000,0.00265181,0,0,3,10,13
"8762",43810000,10000,0.00269961,0,0,4,10,14
"8763",43815000,10000,0.00273478,0,1,4,9,14
"8764",43820000,10000,0.00273714,0,2,2,9,13
"8765",43825000,10000,0.00269512,0,1,0,8,9
"8766",43830000,10000,0.00268196,0,1,1,10,12
"8767",43835000,10000,0.00270972,0,1,6,9,16
"8768",43840000,10000,0.00267316,0,0,7,9,16
"8769",43845000,10000,0.00263089,0,0,2,10,12
"8770",43850000,10000,0.00276059,0,1,3,14,18
"8771",43855000,10000,0.00276322,0,1,3,11,15
"8772",43860000,10000,0.00270571,0,0,1,13,14
"8773",43865000,10000,0.00271585,0,0,2,14,16
"8774",43870000,10000,0.00268094,0,0,2,7,9
"8775",43875000,10000,0.00273504,0,0,5,8,13
"8776",43880000,10000,0.00273697,0,0,4,6,10
"8777",43885000,10000,0.00264671,0,0,0,7,7
"8778",43890000,10000,0.00264867,0,0,2,10,12
"8779",43895000,10000,0.00275001,0,1,4,8,13
"8780",43900000,10000,0.00274719,0,1,2,7,10
"8781",43905000,10000,0.00267639,0,1,1,9,11
"8782",43910000,10000,0.00267268,0,1,1,8,10
"8783",43915000,10000,0.00267887,0,0,0,8,8
"8784",43920000,10000,0.00277928,0,0,2,13,15
"8785",43925000,10000,0.00282318,0,0,6,11,17
"8786",43930000,10000,0.00276455,0,0,8,7,15
"8787",43935000,10000,0.0027323,0,0,4,14,18
"8788",43940000,10000,0.00271116,0,1,1,15,17
"8789",43945000,10000,0.00274848,0,3,3,12,18
"8790",43950000,10000,0.00276426,0,3,3,9,15
"8791",43955000,10000,0.00272256,0,1,3,7,11
"8792",43960000,10000,0.00267207,0,0,3,10,13
"8793",43965000,10000,0.00269819,0,0,3,18,21
"8794",43970000,10000,0.00270857,0,0,5,18,23
"8795",43975000,10000,0.00269663,0,0,4,13,17
"8796",43980000,10000,0.00271662,0,1,3,16,20
"8797",43985000,10000,0.0026934,0,1,3,16,20
"8798",43990000,10000,0.0026799,0,1,5,13,19
"8799",43995000,10000,0.00269446,0,1,4,12,17
"8800",44000000,10000,0.00272002,0,0,0,15,15
"8801",44005000,10000,0.0027099,0,0,0,12,12
"8802",44010000,10000,0.00267835,0,0,0,6,6
"8803",44015000,10000,0.00266269,0,0,2,7,9
"8804",44020000,10000,0.00267843,0,0,5,7,12
"8805",44025000,10000,0.00273504,0,1,3,8,12
"8806",44030000,10000,0.00272154,0,1,1,11,13
"8807",44035000,10000,0.00269011,0,0,5,12,17
"8808",44040000,10000,0.00270485,0,0,7,11,18
"8809",44045000,10000,0.0027231,0,1,5,13,19
"8810",44050000,10000,0.00276431,0,2,5,18,25
"8811",44055000,10000,0.00276822,0,2,5,21,28
"8812",44060000,10000,0.00270927,0,1,4,18,23
"8813",44065000,10000,0.0026767,0,0,6,15,21
"8814",44070000,10000,0.00269087,0,0,5,17,22
"8815",44075000,10000,0.00269475,0,0,2,11,13
"8816",44080000,10000,0.002735,0,1,2,10,13
"8817",44085000,10000,0.00278842,0,1,3,18,22
"8818",44090000,10000,0.00275877,0,0,4,18,22
"8819",44095000,10000,0.00275043,0,0,6,19,25
"8820",44100000,10000,0.00277997,0,1,7,20,28
"8821",44105000,10000,0.00274053,0,1,4,12,17
"8822",44110000,10000,0.00272196,0,1,1,10,12
"8823",44115000,10000,0.00277857,0,2,0,8,10
"8824",44120000,10000,0.00271452,0,1,2,6,9
"8825",44125000,10000,0.00271379,0,2,6,14,22
"8826",44130000,10000,0.0027951,0,2,7,19,28
"8827",44135000,10000,0.00275301,0,0,6,16,22
"8828",44140000,10000,0.00272461,0,0,7,18,25
"8829",44145000,10000,0.00275743,0,0,6,19,25
"8830",44150000,10000,0.0027996,0,1,7,14,22
"8831",44155000,10000,0.00279078,0,2,9,11,22
"8832",44160000,10000,0.002794,0,2,9,13,24
"8833",44165000,10000,0.00277494,0,1,7,19,27
"8834",44170000,10000,0.00276785,0,0,3,21,24
"8835",44175000,10000,0.00274242,0,0,3,17,20
"8836",44180000,10000,0.00268599,0,1,3,13,17
"8837",44185000,10000,0.00266322,0,1,1,10,12
"8838",44190000,10000,0.00264923,0,0,1,5,6
"8839",44195000,10000,0.00264545,0,0,3,8,11
"8840",44200000,10000,0.0026678,0,1,3,10,14
"8841",44205000,10000,0.00271614,0,3,2,8,13
"8842",44210000,10000,0.00274,0,2,1,9,12
"8843",44215000,10000,0.00265471,0,1,1,5,7
"8844",44220000,10000,0.00251535,0,1,1,1,3
"8845",44225000,10000,0.0026158,0,0,2,8,10
"8846",44230000,10000,0.00272387,0,0,3,19,22
"8847",44235000,10000,0.0026971,0,1,2,15,18
"8848",44240000,10000,0.00272945,0,2,4,11,17
"8849",44245000,10000,0.00272481,0,1,3,15,19
"8850",44250000,10000,0.00276005,0,0,3,17,20
"8851",44255000,10000,0.0028335,0,1,6,15,22
"8852",44260000,10000,0.00278387,0,2,3,9,14
"8853",44265000,10000,0.00272161,0,1,0,5,6
"8854",44270000,10000,0.00275412,0,0,3,13,16
"8855",44275000,10000,0.00276141,0,0,6,21,27
"8856",44280000,10000,0.00275326,0,1,5,13,19
"8857",44285000,10000,0.00275691,0,1,5,12,18
"8858",44290000,10000,0.00275393,0,1,5,15,21
"8859",44295000,10000,0.00275877,0,2,4,11,17
"8860",44300000,10000,0.00271553,0,1,6,13,20
"8861",44305000,10000,0.00267925,0,1,5,14,20
"8862",44310000,10000,0.00271529,0,2,2,10,14
"8863",44315000,10000,0.00275564,0,1,3,10,14
"8864",44320000,10000,0.00276377,0,1,6,9,16
"8865",44325000,10000,0.0027646,0,2,8,12,22
"8866",44330000,10000,0.00275856,0,2,5,16,23
"8867",44335000,10000,0.00269612,0,1,2,12,15
"8868",44340000,10000,0.00268541,0,2,2,6,10
"8869",44345000,10000,0.0027534,0,4,1,7,12
"8870",44350000,10000,0.00271189,0,2,1,9,12
"8871",44355000,10000,0.00272454,0,0,4,11,15
"8872",44360000,10000,0.00267977,0,0,4,11,15
"8873",44365000,10000,0.00264936,0,0,3,7,10
"8874",44370000,10000,0.00278476,0,0,7,11,18
"8875",44375000,10000,0.00279735,0,0,7,16,23
"8876",44380000,10000,0.00271419,0,0,3,11,14
"8877",44385000,10000,0.00268132,0,0,1,10,11
"8878",44390000,10000,0.00268286,0,0,0,14,14
"8879",44395000,10000,0.00267711,0,1,0,11,12
"8880",44400000,10000,0.00267918,0,1,2,9,12
"8881",44405000,10000,0.00263139,0,0,3,9,12
"8882",44410000,10000,0.00264912,0,1,1,11,13
"8883",44415000,10000,0.00264828,0,1,2,7,10
"8884",44420000,10000,0.00261628,0,0,3,8,11
"8885",44425000,10000,0.00266482,0,0,3,13,16
"8886",44430000,10000,0.00265845,0,0,4,16,20
"8887",44435000,10000,0.00263151,0,0,2,14,16
"8888",44440000,10000,0.00265259,0,1,2,10,13
"8889",44445000,10000,0.00269072,0,1,6,14,21
"8890",44450000,10000,0.00267332,0,0,5,15,20
"8891",44455000,10000,0.00262432,0,0,2,15,17
"8892",44460000,10000,0.0026019,0,0,2,10,12
"8893",44465000,10000,0.00257115,0,0,1,7,8
"8894",44470000,10000,0.00257339,0,1,3,8,12
"8895",44475000,10000,0.00262413,0,2,3,8,13
"8896",44480000,10000,0.00266036,0,1,3,11,15
"8897",44485000,10000,0.00264341,0,0,4,12,16
"8898",44490000,10000,0.00263479,0,0,2,17,19
"8899",44495000,10000,0.00264505,0,0,2,15,17
"8900",44500000,10000,0.00262552,0,1,3,9,13
"8901",44505000,10000,0.00274892,0,3,7,16,26
"8902",44510000,10000,0.00279052,0,2,9,20,31
"8903",44515000,10000,0.00271686,0,0,5,16,21
"8904",44520000,10000,0.00268911,0,0,2,13,15
"8905",44525000,10000,0.00265191,0,0,1,11,12
"8906",44530000,10000,0.00285989,1,0,2,12,15
"8907",44535000,10000,0.00288651,1,0,5,12,18
"8908",44540000,10000,0.00271936,0,1,5,8,14
"8909",44545000,10000,0.00268953,0,1,3,8,12
"8910",44550000,10000,0.00272058,0,0,4,16,20
"8911",44555000,10000,0.00270142,0,0,3,13,16
"8912",44560000,10000,0.00263722,0,0,3,9,12
"8913",44565000,10000,0.00266853,0,0,5,10,15
"8914",44570000,10000,0.00272017,0,1,4,13,18
"8915",44575000,10000,0.00271218,0,1,3,14,18
"8916",44580000,10000,0.00269768,0,0,2,12,14
"8917",44585000,10000,0.00271557,0,0,2,16,18
"8918",44590000,10000,0.0026929,0,0,2,10,12
"8919",44595000,10000,0.00266817,0,0,1,8,9
"8920",44600000,10000,0.00266262,0,0,1,8,9
"8921",44605000,10000,0.0027622,0,1,3,9,13
"8922",44610000,10000,0.00277536,0,2,2,11,15
"8923",44615000,10000,0.00275392,0,2,4,14,20
"8924",44620000,10000,0.00279302,0,4,5,16,25
"8925",44625000,10000,0.00274518,0,4,1,16,21
"8926",44630000,10000,0.00269285,0,1,2,18,21
"8927",44635000,10000,0.00265526,0,0,4,12,16
"8928",44640000,10000,0.00262754,0,0,3,12,15
"8929",44645000,10000,0.00263398,0,0,3,14,17
"8930",44650000,10000,0.00266475,0,1,4,11,16
"8931",44655000,10000,0.00261984,0,1,5,8,14
"8932",44660000,10000,0.00255706,0,0,4,8,12
"8933",44665000,10000,0.00258538,0,1,2,7,10
"8934",44670000,10000,0.0025887,0,1,2,9,12
"8935",44675000,10000,0.00257891,0,1,3,11,15
"8936",44680000,10000,0.00264969,0,1,5,10,16
"8937",44685000,10000,0.00265904,0,1,4,8,13
"8938",44690000,10000,0.00265232,0,1,4,9,14
"8939",44695000,10000,0.0027037,0,0,6,20,26
"8940",44700000,10000,0.00270007,0,1,4,24,29
"8941",44705000,10000,0.00269682,0,1,3,20,24
"8942",44710000,10000,0.00270417,0,1,2,18,21
"8943",44715000,10000,0.00266116,0,1,0,15,16
"8944",44720000,10000,0.00267999,0,0,0,15,15
"8945",44725000,10000,0.00271336,0,0,2,16,18
"8946",44730000,10000,0.0027871,0,2,4,12,18
"8947",44735000,10000,0.00281466,0,4,2,9,15
"8948",44740000,10000,0.0026946,0,2,1,14,17
"8949",44745000,10000,0.00272535,0,1,1,20,22
"8950",44750000,10000,0.00280918,0,3,2,16,21
"8951",44755000,10000,0.00275948,0,3,4,13,20
"8952",44760000,10000,0.00274403,0,1,3,14,18
"8953",44765000,10000,0.00274131,0,0,2,12,14
"8954",44770000,10000,0.00270993,0,0,2,9,11
"8955",44775000,10000,0.00271063,0,1,2,7,10
"8956",44780000,10000,0.00269563,0,1,3,12,16
"8957",44785000,10000,0.00270383,0,1,4,16,21
"8958",44790000,10000,0.00268383,0,1,3,12,16
"8959",44795000,10000,0.00268844,0,1,3,14,18
"8960",44800000,10000,0.00270178,0,2,2,14,18
"8961",44805000,10000,0.0026765,0,1,1,12,14
"8962",44810000,10000,0.0027472,0,0,5,22,27
"8963",44815000,10000,0.00274037,0,0,6,22,28
"8964",44820000,10000,0.00269785,0,0,5,21,26
"8965",44825000,10000,0.00269397,0,1,4,20,25
"8966",44830000,10000,0.00266649,0,1,5,14,20
"8967",44835000,10000,0.00272254,0,0,9,22,31
"8968",44840000,10000,0.00272148,0,0,7,20,27
"8969",44845000,10000,0.0027134,0,1,4,13,18
"8970",44850000,10000,0.00274793,0,2,3,8,13
"8971",44855000,10000,0.00277066,0,2,4,5,11
"8972",44860000,10000,0.00277286,0,1,4,11,16
"8973",44865000,10000,0.00273686,0,1,2,10,13
"8974",44870000,10000,0.00273796,0,2,3,9,14
"8975",44875000,10000,0.00276159,0,1,5,15,21
"8976",44880000,10000,0.00280982,0,1,7,19,27
"8977",44885000,10000,0.00278966,0,2,5,18,25
"8978",44890000,10000,0.00271561,0,1,3,15,19
"8979",44895000,10000,0.00267924,0,0,6,15,21
"8980",44900000,10000,0.00270622,0,0,4,9,13
"8981",44905000,10000,0.00276976,0,1,2,7,10
"8982",44910000,10000,0.00278835,0,2,3,11,16
"8983",44915000,10000,0.00284149,0,3,6,9,18
"8984",44920000,10000,0.00282513,0,3,6,6,15
"8985",44925000,10000,0.00276314,0,2,1,9,12
"8986",44930000,10000,0.00277173,0,1,2,14,17
"8987",44935000,10000,0.00272392,0,0,4,14,18
"8988",44940000,10000,0.00268255,0,1,4,13,18
"8989",44945000,10000,0.0026416,0,1,2,11,14
"8990",44950000,10000,0.00267089,0,0,1,16,17
"8991",44955000,10000,0.00269991,0,0,1,20,21
"8992",44960000,10000,0.00271029,0,0,3,18,21
"8993",44965000,10000,0.00267832,0,0,3,14,17
"8994",44970000,10000,0.00262293,0,0,2,11,13
"8995",44975000,10000,0.00269665,0,0,5,8,13
"8996",44980000,10000,0.00275366,0,0,4,4,8
"8997",44985000,10000,0.00272948,0,0,2,9,11
"8998",44990000,10000,0.00274318,0,0,3,15,18
"8999",44995000,10000,0.00273256,0,0,2,14,16
"9000",45000000,10000,0.00269233,0,0,1,12,13
"9001",45005000,10000,0.00271489,0,0,4,13,17
"9002",45010000,10000,0.00272414,0,1,4,17,22
"9003",45015000,10000,0.00270529,0,2,3,15,20
"9004",45020000,10000,0.00266465,0,1,4,6,11
"9005",45025000,10000,0.00273969,0,1,6,9,16
"9006",45030000,10000,0.00281857,0,2,6,17,25
"9007",45035000,10000,0.00280291,0,2,4,19,25
"9008",45040000,10000,0.00278719,0,2,3,16,21
"9009",45045000,10000,0.00273185,0,1,3,15,19
"9010",45050000,10000,0.00266364,0,1,2,18,21
"9011",45055000,10000,0.00272878,0,3,5,19,27
"9012",45060000,10000,0.00272204,0,2,7,18,27
"9013",45065000,10000,0.00265973,0,1,4,17,22
"9014",45070000,10000,0.00271213,0,1,3,17,21
"9015",45075000,10000,0.00273339,0,1,3,20,24
"9016",45080000,10000,0.00271168,0,1,5,18,24
"9017",45085000,10000,0.00269688,0,0,5,13,18
"9018",45090000,10000,0.00273132,0,1,4,12,17
"9019",45095000,10000,0.00273137,0,1,3,10,14
"9020",45100000,10000,0.00275252,0,0,4,12,16
"9021",45105000,10000,0.00280067,0,1,4,12,17
"9022",45110000,10000,0.00278073,0,2,5,6,13
"9023",45115000,10000,0.0027684,0,1,5,9,15
"9024",45120000,10000,0.00277578,0,1,4,12,17
"9025",45125000,10000,0.00273596,0,1,6,11,18
"9026",45130000,10000,0.00264457,0,0,5,13,18
"9027",45135000,10000,0.00266864,0,0,3,13,16
"9028",45140000,10000,0.00269368,0,0,4,13,17
"9029",45145000,10000,0.00263657,0,1,4,10,15
"9030",45150000,10000,0.00263756,0,1,4,9,14
"9031",45155000,10000,0.00266229,0,0,6,9,15
"9032",45160000,10000,0.00272062,0,2,5,9,16
"9033",45165000,10000,0.00274239,0,2,5,13,20
"9034",45170000,10000,0.00270417,0,0,5,13,18
"9035",45175000,10000,0.00271577,0,0,4,13,17
"9036",45180000,10000,0.00277475,0,0,7,17,24
"9037",45185000,10000,0.00276265,0,0,6,20,26
"9038",45190000,10000,0.00270851,0,0,2,25,27
"9039",45195000,10000,0.00276481,0,1,5,18,24
"9040",45200000,10000,0.00280772,0,3,7,10,20
"9041",45205000,10000,0.00278153,0,2,4,22,28
"9042",45210000,10000,0.00275298,0,1,5,26,32
"9043",45215000,10000,0.00270724,0,1,7,19,27
"9044",45220000,10000,0.00266129,0,0,5,14,19
"9045",45225000,10000,0.00268403,0,0,4,7,11
"9046",45230000,10000,0.00272776,0,0,2,5,7
"9047",45235000,10000,0.00275437,0,3,0,6,9
"9048",45240000,10000,0.00273945,0,3,0,8,11
"9049",45245000,10000,0.00267861,0,0,1,10,11
"9050",45250000,10000,0.00268547,0,0,2,10,12
"9051",45255000,10000,0.00268198,0,0,2,8,10
"9052",45260000,10000,0.00270254,0,0,1,8,9
"9053",45265000,10000,0.00271884,0,0,1,9,10
"9054",45270000,10000,0.00266847,0,0,3,7,10
"9055",45275000,10000,0.0026334,0,0,3,9,12
"9056",45280000,10000,0.00271439,0,1,3,11,15
"9057",45285000,10000,0.00278355,0,2,3,12,17
"9058",45290000,10000,0.0028278,0,3,5,9,17
"9059",45295000,10000,0.00278231,0,2,5,6,13
"9060",45300000,10000,0.00267519,0,0,2,17,19
"9061",45305000,10000,0.00269502,0,0,3,16,19
"9062",45310000,10000,0.0027357,0,1,2,8,11
"9063",45315000,10000,0.00268495,0,1,0,6,7
"9064",45320000,10000,0.00272128,0,1,3,6,10
"9065",45325000,10000,0.00277279,0,1,5,13,19
"9066",45330000,10000,0.0026887,0,0,2,13,15
"9067",45335000,10000,0.00274505,0,3,0,14,17
"9068",45340000,10000,0.00276412,0,3,1,16,20
"9069",45345000,10000,0.00266512,0,1,1,12,14
"9070",45350000,10000,0.00261134,0,1,2,9,12
"9071",45355000,10000,0.00263326,0,0,5,8,13
"9072",45360000,10000,0.00267805,0,0,5,7,12
"9073",45365000,10000,0.00268709,0,0,4,10,14
"9074",45370000,10000,0.00270723,0,1,5,17,23
"9075",45375000,10000,0.00274953,0,2,4,13,19
"9076",45380000,10000,0.00272363,0,1,3,8,12
"9077",45385000,10000,0.00268704,0,0,3,8,11
"9078",45390000,10000,0.00273945,0,3,1,6,10
"9079",45395000,10000,0.00276586,0,4,1,10,15
"9080",45400000,10000,0.00276263,0,2,3,9,14
"9081",45405000,10000,0.00272687,0,1,2,6,9
"9082",45410000,10000,0.00274915,0,2,1,11,14
"9083",45415000,10000,0.00274291,0,2,3,16,21
"9084",45420000,10000,0.00266051,0,0,4,16,20
"9085",45425000,10000,0.00264613,0,0,3,7,10
"9086",45430000,10000,0.0026261,0,0,3,3,6
"9087",45435000,10000,0.0026818,0,0,4,7,11
"9088",45440000,10000,0.00272633,0,0,4,7,11
"9089",45445000,10000,0.00269191,0,0,2,6,8
"9090",45450000,10000,0.00273477,0,1,1,8,10
"9091",45455000,10000,0.00276608,0,3,3,8,14
"9092",45460000,10000,0.00276513,0,3,4,7,14
"9093",45465000,10000,0.00276435,0,1,3,10,14
"9094",45470000,10000,0.00269587,0,0,2,14,16
"9095",45475000,10000,0.00274628,0,3,2,10,15
"9096",45480000,10000,0.0027596,0,4,2,9,15
"9097",45485000,10000,0.00271368,0,1,3,13,17
"9098",45490000,10000,0.00268062,0,0,5,11,16
"9099",45495000,10000,0.00264793,0,0,5,8,13
"9100",45500000,10000,0.00270262,0,0,3,10,13
"9101",45505000,10000,0.00268961,0,0,1,10,11
"9102",45510000,10000,0.00267245,0,0,2,8,10
"9103",45515000,10000,0.00269281,0,0,4,8,12
"9104",45520000,10000,0.00266558,0,0,3,10,13
"9105",45525000,10000,0.00265111,0,0,3,12,15
"9106",45530000,10000,0.00265969,0,0,2,11,13
"9107",45535000,10000,0.00265562,0,0,3,13,16
"9108",45540000,10000,0.00262343,0,1,4,10,15
"9109",45545000,10000,0.00270696,0,1,3,12,16
"9110",45550000,10000,0.00274242,0,0,3,15,18
"9111",45555000,10000,0.00266483,0,1,3,13,17
"9112",45560000,10000,0.00267791,0,1,5,13,19
"9113",45565000,10000,0.00263461,0,0,6,12,18
"9114",45570000,10000,0.00261639,0,1,3,12,16
"9115",45575000,10000,0.0026773,0,2,1,11,14
"9116",45580000,10000,0.00264434,0,1,2,8,11
"9117",45585000,10000,0.00262409,0,1,3,9,13
"9118",45590000,10000,0.00267096,0,1,3,12,16
"9119",45595000,10000,0.00266575,0,0,2,10,12
"9120",45600000,10000,0.00265919,0,0,1,11,12
"9121",45605000,10000,0.00268503,0,0,2,19,21
"9122",45610000,10000,0.00273052,0,1,5,17,23
"9123",45615000,10000,0.00270758,0,1,4,14,19
"9124",45620000,10000,0.00263599,0,1,1,13,15
"9125",45625000,10000,0.00268285,0,1,2,12,15
"9126",45630000,10000,0.00276198,0,1,5,14,20
"9127",45635000,10000,0.00272012,0,1,3,12,16
"9128",45640000,10000,0.00273827,0,1,3,16,20
"9129",45645000,10000,0.00272395,0,1,3,13,17
"9130",45650000,10000,0.00270484,0,1,2,8,11
"9131",45655000,10000,0.00270828,0,1,3,9,13
"9132",45660000,10000,0.00266306,0,0,1,9,10
"9133",45665000,10000,0.00274645,0,0,1,12,13
"9134",45670000,10000,0.00276534,0,0,3,11,14
"9135",45675000,10000,0.00267546,0,0,3,7,10
"9136",45680000,10000,0.00267515,0,0,3,9,12
"9137",45685000,10000,0.00270616,0,1,2,9,12
"9138",45690000,10000,0.00263739,0,1,0,6,7
"9139",45695000,10000,0.00264654,0,0,2,6,8
"9140",45700000,10000,0.00271438,0,0,3,6,9
"9141",45705000,10000,0.00268705,0,0,2,5,7
"9142",45710000,10000,0.0026792,0,1,2,7,10
"9143",45715000,10000,0.00267924,0,2,2,10,14
"9144",45720000,10000,0.00270566,0,1,2,12,15
"9145",45725000,10000,0.00274437,0,0,1,11,12
"9146",45730000,10000,0.00270044,0,0,2,5,7
"9147",45735000,10000,0.00262532,0,0,2,2,4
"9148",45740000,10000,0.0026852,0,2,1,5,8
"9149",45745000,10000,0.00275661,0,2,3,7,12
"9150",45750000,10000,0.00269821,0,1,2,4,7
"9151",45755000,10000,0.00267593,0,1,1,5,7
"9152",45760000,10000,0.00267567,0,0,2,9,11
"9153",45765000,10000,0.00266745,0,0,2,8,10
"9154",45770000,10000,0.00267207,0,1,1,9,11
"9155",45775000,10000,0.00271343,0,3,0,17,20
"9156",45780000,10000,0.00266744,0,2,0,12,14
"9157",45785000,10000,0.00260514,0,0,1,6,7
"9158",45790000,10000,0.0026887,0,0,2,8,10
"9159",45795000,10000,0.00273582,0,1,3,9,13
"9160",45800000,10000,0.00270694,0,1,2,8,11
"9161",45805000,10000,0.00268558,0,0,0,5,5
"9162",45810000,10000,0.00267271,0,0,2,6,8
"9163",45815000,10000,0.00270969,0,1,3,6,10
"9164",45820000,10000,0.00276794,0,1,3,13,17
"9165",45825000,10000,0.00275506,0,0,2,15,17
"9166",45830000,10000,0.00278645,0,0,0,13,13
"9167",45835000,10000,0.00277991,0,0,1,13,14
"9168",45840000,10000,0.00273719,0,0,2,11,13
"9169",45845000,10000,0.00278193,0,2,1,10,13
"9170",45850000,10000,0.00279931,0,3,3,13,19
"9171",45855000,10000,0.00273722,0,1,4,17,22
"9172",45860000,10000,0.00267695,0,0,2,11,13
"9173",45865000,10000,0.00267826,0,0,3,6,9
"9174",45870000,10000,0.00269127,0,0,3,4,7
"9175",45875000,10000,0.00269316,0,0,2,8,10
"9176",45880000,10000,0.00274924,0,0,3,17,20
"9177",45885000,10000,0.0027675,0,0,2,16,18
"9178",45890000,10000,0.00268717,0,0,2,9,11
"9179",45895000,10000,0.00259012,0,0,2,4,6
"9180",45900000,10000,0.00253133,0,1,1,5,7
"9181",45905000,10000,0.00258219,0,1,3,9,13
"9182",45910000,10000,0.00265199,0,0,2,8,10
"9183",45915000,10000,0.00271377,0,0,2,9,11
"9184",45920000,10000,0.00272106,0,0,2,10,12
"9185",45925000,10000,0.00264907,0,0,2,7,9
"9186",45930000,10000,0.00266852,0,1,2,12,15
"9187",45935000,10000,0.00273658,0,2,0,16,18
"9188",45940000,10000,0.00272373,0,2,1,8,11
"9189",45945000,10000,0.00270807,0,2,4,6,12
"9190",45950000,10000,0.00272252,0,2,4,10,16
"9191",45955000,10000,0.00271141,0,2,2,9,13
"9192",45960000,10000,0.00266699,0,1,2,8,11
"9193",45965000,10000,0.00265205,0,0,2,9,11
"9194",45970000,10000,0.00267402,0,0,2,10,12
"9195",45975000,10000,0.00270469,0,0,2,10,12
"9196",45980000,10000,0.00273371,0,1,3,8,12
"9197",45985000,10000,0.00274359,0,3,3,7,13
"9198",45990000,10000,0.00273242,0,3,5,8,16
"9199",45995000,10000,0.00273518,0,2,5,6,13
"9200",46000000,10000,0.00271312,0,1,1,11,13
"9201",46005000,10000,0.00267253,0,1,3,15,19
"9202",46010000,10000,0.00269939,0,1,5,12,18
"9203",46015000,10000,0.00273476,0,0,3,18,21
"9204",46020000,10000,0.0027517,0,1,2,15,18
"9205",46025000,10000,0.00273213,0,1,2,6,9
"9206",46030000,10000,0.00267419,0,0,1,4,5
"9207",46035000,10000,0.00267507,0,0,1,5,6
"9208",46040000,10000,0.00267916,0,0,1,9,10
"9209",46045000,10000,0.00267691,0,0,3,11,14
"9210",46050000,10000,0.00271325,0,0,4,17,21
"9211",46055000,10000,0.0026899,0,1,3,16,20
"9212",46060000,10000,0.00261863,0,1,3,9,13
"9213",46065000,10000,0.00263446,0,0,3,8,11
"9214",46070000,10000,0.00257203,0,0,2,5,7
"9215",46075000,10000,0.00252957,0,1,0,4,5
"9216",46080000,10000,0.00259976,0,1,1,5,7
"9217",46085000,10000,0.00262554,0,0,3,6,9
"9218",46090000,10000,0.00261565,0,0,3,10,13
"9219",46095000,10000,0.0025913,0,0,3,11,14
"9220",46100000,10000,0.00261101,0,0,4,8,12
"9221",46105000,10000,0.00266943,0,0,2,15,17
"9222",46110000,10000,0.00266992,0,1,1,19,21
"9223",46115000,10000,0.00260337,0,1,1,14,16
"9224",46120000,10000,0.00260874,0,0,0,10,10
"9225",46125000,10000,0.00263155,0,0,1,7,8
"9226",46130000,10000,0.00264966,0,0,1,12,13
"9227",46135000,10000,0.00263413,0,0,1,8,9
"9228",46140000,10000,0.0025919,0,0,2,4,6
"9229",46145000,10000,0.00266241,0,1,7,8,16
"9230",46150000,10000,0.00268481,0,1,7,7,15
"9231",46155000,10000,0.0025966,0,0,2,7,9
"9232",46160000,10000,0.00258004,0,0,4,8,12
"9233",46165000,10000,0.00260966,0,0,5,10,15
"9234",46170000,10000,0.00263424,0,0,2,9,11
"9235",46175000,10000,0.00265015,0,0,2,12,14
"9236",46180000,10000,0.00266261,0,0,4,14,18
"9237",46185000,10000,0.00264395,0,0,4,10,14
"9238",46190000,10000,0.00254864,0,0,3,6,9
"9239",46195000,10000,0.00250752,0,0,1,4,5
"9240",46200000,10000,0.00256461,0,0,2,5,7
"9241",46205000,10000,0.00265174,0,0,5,11,16
"9242",46210000,10000,0.00266394,0,0,5,16,21
"9243",46215000,10000,0.00272671,0,0,6,18,24
"9244",46220000,10000,0.0027264,0,1,5,14,20
"9245",46225000,10000,0.00263382,0,1,2,14,17
"9246",46230000,10000,0.00269114,0,1,3,16,20
"9247",46235000,10000,0.00272935,0,1,4,15,20
"9248",46240000,10000,0.00271108,0,0,2,21,23
"9249",46245000,10000,0.00266158,0,1,1,12,14
"9250",46250000,10000,0.00265021,0,1,1,6,8
"9251",46255000,10000,0.00269371,0,1,2,13,16
"9252",46260000,10000,0.00270302,0,2,2,18,22
"9253",46265000,10000,0.00268574,0,1,1,16,18
"9254",46270000,10000,0.00268691,0,0,4,11,15
"9255",46275000,10000,0.00264982,0,0,5,12,17
"9256",46280000,10000,0.00263493,0,1,2,14,17
"9257",46285000,10000,0.00267785,0,1,4,12,17
"9258",46290000,10000,0.0026701,0,0,6,11,17
"9259",46295000,10000,0.00273964,0,0,4,14,18
"9260",46300000,10000,0.00269581,0,0,3,12,15
"9261",46305000,10000,0.0026194,0,1,4,11,16
"9262",46310000,10000,0.00265866,0,1,3,12,16
"9263",46315000,10000,0.00266049,0,0,2,9,11
"9264",46320000,10000,0.00264225,0,0,4,8,12
"9265",46325000,10000,0.00262146,0,0,4,11,15
"9266",46330000,10000,0.00267453,0,0,4,10,14
"9267",46335000,10000,0.00269363,0,0,2,7,9
"9268",46340000,10000,0.00269022,0,0,2,12,14
"9269",46345000,10000,0.00268618,0,0,4,11,15
"9270",46350000,10000,0.00265657,0,0,4,7,11
"9271",46355000,10000,0.00267373,0,0,6,10,16
"9272",46360000,10000,0.00264655,0,0,5,9,14
"9273",46365000,10000,0.00268086,0,2,5,7,14
"9274",46370000,10000,0.00273325,0,3,6,12,21
"9275",46375000,10000,0.00267149,0,1,3,12,16
"9276",46380000,10000,0.00263517,0,0,3,9,12
"9277",46385000,10000,0.00263981,0,2,2,10,14
"9278",46390000,10000,0.00263755,0,2,3,9,14
"9279",46395000,10000,0.00263881,0,1,6,8,15
"9280",46400000,10000,0.00266103,0,1,6,12,19
"9281",46405000,10000,0.00262654,0,0,3,10,13
"9282",46410000,10000,0.00262329,0,0,2,4,6
"9283",46415000,10000,0.00264016,0,0,4,7,11
"9284",46420000,10000,0.00260376,0,0,3,7,10
"9285",46425000,10000,0.00255139,0,0,3,5,8
"9286",46430000,10000,0.00259323,0,0,3,9,12
"9287",46435000,10000,0.00259995,0,0,2,7,9
"9288",46440000,10000,0.00258929,0,0,3,8,11
"9289",46445000,10000,0.00262031,0,0,3,9,12
"9290",46450000,10000,0.00265638,0,1,3,10,14
"9291",46455000,10000,0.00265131,0,1,2,9,12
"9292",46460000,10000,0.00257717,0,0,2,2,4
"9293",46465000,10000,0.00257128,0,0,2,6,8
"9294",46470000,10000,0.00258525,0,0,3,12,15
"9295",46475000,10000,0.00263745,0,0,6,11,17
"9296",46480000,10000,0.00266332,0,0,8,11,19
"9297",46485000,10000,0.00264309,0,0,7,13,20
"9298",46490000,10000,0.00261939,0,1,3,12,16
"9299",46495000,10000,0.00260659,0,1,4,12,17
"9300",46500000,10000,0.00265598,0,1,5,12,18
"9301",46505000,10000,0.00269516,0,1,4,15,20
"9302",46510000,10000,0.00275081,0,0,5,15,20
"9303",46515000,10000,0.00271331,0,0,3,14,17
"9304",46520000,10000,0.00264535,0,1,4,13,18
"9305",46525000,10000,0.00265766,0,1,4,8,13
"9306",46530000,10000,0.00262688,0,0,1,7,8
"9307",46535000,10000,0.00263701,0,0,3,10,13
"9308",46540000,10000,0.00264962,0,0,5,9,14
"9309",46545000,10000,0.00265124,0,0,5,9,14
"9310",46550000,10000,0.00265384,0,0,2,10,12
"9311",46555000,10000,0.00267494,0,0,1,9,10
"9312",46560000,10000,0.00270046,0,0,2,12,14
"9313",46565000,10000,0.00266128,0,0,4,10,14
"9314",46570000,10000,0.00266505,0,0,7,8,15
"9315",46575000,10000,0.00266774,0,0,6,9,15
"9316",46580000,10000,0.00262951,0,0,4,8,12
"9317",46585000,10000,0.00274538,0,3,6,11,20
"9318",46590000,10000,0.00274857,0,3,5,13,21
"9319",46595000,10000,0.00261899,0,0,2,9,11
"9320",46600000,10000,0.00263032,0,2,1,6,9
"9321",46605000,10000,0.00264166,0,2,2,9,13
"9322",46610000,10000,0.00265536,0,1,5,10,16
"9323",46615000,10000,0.00264946,0,1,5,9,15
"9324",46620000,10000,0.00260503,0,0,4,12,16
"9325",46625000,10000,0.00262458,0,0,2,8,10
"9326",46630000,10000,0.00265682,0,0,4,5,9
"9327",46635000,10000,0.0026305,0,0,5,7,12
"9328",46640000,10000,0.00256609,0,0,2,5,7
"9329",46645000,10000,0.00254885,0,0,2,8,10
"9330",46650000,10000,0.00259485,0,0,3,9,12
"9331",46655000,10000,0.00258457,0,0,2,4,6
"9332",46660000,10000,0.00261267,0,0,2,10,12
"9333",46665000,10000,0.00268712,0,1,5,13,19
"9334",46670000,10000,0.00265733,0,1,3,8,12
"9335",46675000,10000,0.00258827,0,0,2,4,6
"9336",46680000,10000,0.00257415,0,0,2,2,4
"9337",46685000,10000,0.00256026,0,0,0,9,9
"9338",46690000,10000,0.00261909,0,0,5,13,18
"9339",46695000,10000,0.00267438,0,0,9,11,20
"9340",46700000,10000,0.00262422,0,0,6,11,17
"9341",46705000,10000,0.00261237,0,0,4,13,17
"9342",46710000,10000,0.00260365,0,0,2,7,9
"9343",46715000,10000,0.0025789,0,0,1,4,5
"9344",46720000,10000,0.00265055,0,1,1,8,10
"9345",46725000,10000,0.00263524,0,1,0,6,7
"9346",46730000,10000,0.0025885,0,1,0,3,4
"9347",46735000,10000,0.00263514,0,1,1,11,13
"9348",46740000,10000,0.00263565,0,0,4,13,17
"9349",46745000,10000,0.00261155,0,1,3,7,11
"9350",46750000,10000,0.00258954,0,1,2,8,11
"9351",46755000,10000,0.00262002,0,0,3,11,14
"9352",46760000,10000,0.00270434,0,2,2,12,16
"9353",46765000,10000,0.00275262,0,2,2,11,15
"9354",46770000,10000,0.002636,0,0,2,8,10
"9355",46775000,10000,0.00262208,0,0,3,7,10
"9356",46780000,10000,0.00273488,0,1,5,10,16
"9357",46785000,10000,0.00272611,0,1,3,7,11
"9358",46790000,10000,0.00273917,0,2,0,6,8
"9359",46795000,10000,0.00275663,0,2,4,7,13
"9360",46800000,10000,0.00276205,0,2,6,12,20
"9361",46805000,10000,0.00278246,0,3,3,16,22
"9362",46810000,10000,0.00274657,0,2,2,11,15
"9363",46815000,10000,0.00269801,0,1,3,8,12
"9364",46820000,10000,0.00266901,0,0,4,12,16
"9365",46825000,10000,0.00269663,0,0,4,16,20
"9366",46830000,10000,0.00270747,0,0,2,9,11
"9367",46835000,10000,0.00267781,0,0,3,8,11
"9368",46840000,10000,0.00265361,0,0,4,11,15
"9369",46845000,10000,0.0027346,0,2,3,12,17
"9370",46850000,10000,0.00274206,0,3,2,13,18
"9371",46855000,10000,0.00269731,0,3,1,14,18
"9372",46860000,10000,0.00272546,0,2,2,15,19
"9373",46865000,10000,0.00274524,0,0,3,12,15
"9374",46870000,10000,0.0027713,0,0,4,12,16
"9375",46875000,10000,0.00278779,0,0,4,13,17
"9376",46880000,10000,0.00276475,0,0,2,14,16
"9377",46885000,10000,0.00270692,0,0,0,15,15
"9378",46890000,10000,0.0027351,0,2,1,12,15
"9379",46895000,10000,0.00276765,0,4,2,9,15
"9380",46900000,10000,0.00269471,0,2,2,8,12
"9381",46905000,10000,0.00267264,0,0,3,7,10
"9382",46910000,10000,0.00269429,0,0,3,9,12
"9383",46915000,10000,0.00265873,0,0,2,8,10
"9384",46920000,10000,0.00261478,0,0,2,5,7
"9385",46925000,10000,0.00261356,0,0,2,3,5
"9386",46930000,10000,0.00269961,0,1,2,7,10
"9387",46935000,10000,0.00274109,0,2,2,10,14
"9388",46940000,10000,0.00271187,0,1,2,10,13
"9389",46945000,10000,0.00275175,0,0,3,14,17
"9390",46950000,10000,0.00275194,0,0,3,10,13
"9391",46955000,10000,0.00268707,0,0,1,6,7
"9392",46960000,10000,0.00267991,0,0,0,7,7
"9393",46965000,10000,0.00273379,0,1,1,7,9
"9394",46970000,10000,0.002805,0,2,3,14,19
"9395",46975000,10000,0.00271276,0,1,4,12,17
"9396",46980000,10000,0.00262838,0,0,4,7,11
"9397",46985000,10000,0.00271678,0,3,3,6,12
"9398",46990000,10000,0.00276052,0,3,2,7,12
"9399",46995000,10000,0.00273437,0,0,3,13,16
"9400",47000000,10000,0.00268692,0,0,3,14,17
"9401",47005000,10000,0.00261033,0,0,1,11,12
"9402",47010000,10000,0.0026122,0,0,0,9,9
"9403",47015000,10000,0.00276897,0,1,3,12,16
"9404",47020000,10000,0.00273834,0,1,3,14,18
"9405",47025000,10000,0.00262952,0,0,5,14,19
"9406",47030000,10000,0.00265191,0,0,5,9,14
"9407",47035000,10000,0.00264304,0,0,1,6,7
"9408",47040000,10000,0.00265514,0,0,3,10,13
"9409",47045000,10000,0.00265251,0,0,3,12,15
"9410",47050000,10000,0.00265177,0,0,2,8,10
"9411",47055000,10000,0.00267851,0,0,2,5,7
"9412",47060000,10000,0.00272587,0,1,2,11,14
"9413",47065000,10000,0.00262984,0,1,2,11,14
"9414",47070000,10000,0.00259808,0,0,2,9,11
"9415",47075000,10000,0.00264181,0,0,4,9,13
"9416",47080000,10000,0.00261034,0,0,4,10,14
"9417",47085000,10000,0.00263517,0,0,3,14,17
"9418",47090000,10000,0.00263529,0,0,3,13,16
"9419",47095000,10000,0.00266342,0,0,4,16,20
"9420",47100000,10000,0.00271402,0,2,4,17,23
"9421",47105000,10000,0.00270732,0,2,3,13,18
"9422",47110000,10000,0.00266313,0,0,2,21,23
"9423",47115000,10000,0.00260899,0,2,1,16,19
"9424",47120000,10000,0.00261816,0,3,2,6,11
"9425",47125000,10000,0.00264915,0,1,3,12,16
"9426",47130000,10000,0.0026526,0,0,5,14,19
"9427",47135000,10000,0.00265796,0,1,5,11,17
"9428",47140000,10000,0.00258699,0,1,3,8,12
"9429",47145000,10000,0.00261941,0,1,4,10,15
"9430",47150000,10000,0.00263199,0,1,3,7,11
"9431",47155000,10000,0.00260368,0,0,1,3,4
"9432",47160000,10000,0.00263799,0,0,3,5,8
"9433",47165000,10000,0.00258917,0,0,2,7,9
"9434",47170000,10000,0.00254043,0,0,1,6,7
"9435",47175000,10000,0.00253675,0,0,1,3,4
"9436",47180000,10000,0.00254705,0,0,0,1,1
"9437",47185000,10000,0.00254541,0,0,2,4,6
"9438",47190000,10000,0.00264433,0,1,5,8,14
"9439",47195000,10000,0.00268726,0,1,3,11,15
"9440",47200000,10000,0.00263399,0,0,0,16,16
"9441",47205000,10000,0.0026494,0,1,0,11,12
"9442",47210000,10000,0.00265769,0,1,1,7,9
"9443",47215000,10000,0.00265036,0,0,3,9,12
"9444",47220000,10000,0.00269873,0,0,5,6,11
"9445",47225000,10000,0.00272603,0,0,6,7,13
"9446",47230000,10000,0.00270765,0,0,5,10,15
"9447",47235000,10000,0.00269068,0,1,2,7,10
"9448",47240000,10000,0.00272895,0,2,2,9,13
"9449",47245000,10000,0.00272459,0,1,4,12,17
"9450",47250000,10000,0.00264943,0,1,3,9,13
"9451",47255000,10000,0.00264695,0,1,1,12,14
"9452",47260000,10000,0.00267623,0,0,1,14,15
"9453",47265000,10000,0.00267962,0,0,5,12,17
"9454",47270000,10000,0.00271667,0,2,4,11,17
"9455",47275000,10000,0.00275604,0,4,0,9,13
"9456",47280000,10000,0.00272835,0,3,2,8,13
"9457",47285000,10000,0.00271469,0,2,2,8,12
"9458",47290000,10000,0.0027354,0,1,2,6,9
"9459",47295000,10000,0.00279553,0,3,4,6,13
"9460",47300000,10000,0.00277762,0,3,2,7,12
"9461",47305000,10000,0.0027147,0,1,1,10,12
"9462",47310000,10000,0.00269523,0,1,3,12,16
"9463",47315000,10000,0.00265999,0,2,3,10,15
"9464",47320000,10000,0.00260122,0,2,1,13,16
"9465",47325000,10000,0.00257794,0,0,1,12,13
"9466",47330000,10000,0.00256051,0,0,1,7,8
"9467",47335000,10000,0.00255798,0,0,1,8,9
"9468",47340000,10000,0.00258397,0,0,2,8,10
"9469",47345000,10000,0.00257284,0,1,2,6,9
"9470",47350000,10000,0.00261271,0,2,4,5,11
"9471",47355000,10000,0.00266209,0,2,3,7,12
"9472",47360000,10000,0.00264385,0,1,1,9,11
"9473",47365000,10000,0.00260968,0,1,1,7,9
"9474",47370000,10000,0.00256127,0,1,0,6,7
"9475",47375000,10000,0.00253688,0,0,0,8,8
"9476",47380000,10000,0.00260483,0,0,1,9,10
"9477",47385000,10000,0.00267302,0,1,2,7,10
"9478",47390000,10000,0.0026048,0,2,1,5,8
"9479",47395000,10000,0.00252957,0,1,1,3,5
"9480",47400000,10000,0.00258019,0,0,3,5,8
"9481",47405000,10000,0.00254977,0,0,2,8,10
"9482",47410000,10000,0.00253523,0,0,2,7,9
"9483",47415000,10000,0.0025997,0,0,2,7,9
"9484",47420000,10000,0.00255775,0,0,0,5,5
"9485",47425000,10000,0.00254977,0,2,2,4,8
"9486",47430000,10000,0.00253154,0,2,2,3,7
"9487",47435000,10000,0.00254492,0,0,1,1,2
"9488",47440000,10000,0.00255409,0,0,2,3,5
"9489",47445000,10000,0.00254696,0,0,3,6,9
"9490",47450000,10000,0.00262006,0,0,2,11,13
"9491",47455000,10000,0.00263136,0,0,4,13,17
"9492",47460000,10000,0.00262573,0,0,5,14,19
"9493",47465000,10000,0.00257944,0,1,1,10,12
"9494",47470000,10000,0.0025858,0,1,1,11,13
"9495",47475000,10000,0.00267938,0,1,3,17,21
"9496",47480000,10000,0.00276299,0,2,7,19,28
"9497",47485000,10000,0.00276188,0,1,7,20,28
"9498",47490000,10000,0.00267228,0,0,2,15,17
"9499",47495000,10000,0.00266752,0,0,4,15,19
"9500",47500000,10000,0.00271244,0,0,5,17,22
"9501",47505000,10000,0.00270642,0,0,4,16,20
"9502",47510000,10000,0.00274126,0,0,5,20,25
"9503",47515000,10000,0.00274934,0,0,7,22,29
"9504",47520000,10000,0.00268798,0,0,7,13,20
"9505",47525000,10000,0.00264155,0,0,4,11,15
"9506",47530000,10000,0.00260105,0,1,4,13,18
"9507",47535000,10000,0.00263303,0,1,5,16,22
"9508",47540000,10000,0.00267416,0,0,5,17,22
"9509",47545000,10000,0.00266119,0,0,5,11,16
"9510",47550000,10000,0.00262565,0,0,4,14,18
"9511",47555000,10000,0.00263087,0,0,4,15,19
"9512",47560000,10000,0.00269242,0,2,5,12,19
"9513",47565000,10000,0.00266058,0,2,3,9,14
"9514",47570000,10000,0.00257189,0,0,2,10,12
"9515",47575000,10000,0.00252466,0,0,1,11,12
"9516",47580000,10000,0.00252559,0,0,0,12,12
"9517",47585000,10000,0.00256514,0,0,1,15,16
"9518",47590000,10000,0.00260096,0,0,4,9,13
"9519",47595000,10000,0.00261471,0,0,4,6,10
"9520",47600000,10000,0.00262967,0,0,4,11,15
"9521",47605000,10000,0.00263275,0,0,3,11,14
"9522",47610000,10000,0.00266492,0,1,5,10,16
"9523",47615000,10000,0.00269163,0,1,8,10,19
"9524",47620000,10000,0.00265343,0,0,4,10,14
"9525",47625000,10000,0.00265187,0,1,2,13,16
"9526",47630000,10000,0.0027209,0,2,4,14,20
"9527",47635000,10000,0.00275233,0,2,5,16,23
"9528",47640000,10000,0.00270341,0,2,4,15,21
"9529",47645000,10000,0.00265614,0,1,2,13,16
"9530",47650000,10000,0.00261442,0,0,1,14,15
"9531",47655000,10000,0.00260092,0,0,1,11,12
"9532",47660000,10000,0.00263629,0,0,2,10,12
"9533",47665000,10000,0.00266083,0,1,4,13,18
"9534",47670000,10000,0.00270059,0,1,4,15,20
"9535",47675000,10000,0.00267801,0,0,3,13,16
"9536",47680000,10000,0.00265397,0,0,4,11,15
"9537",47685000,10000,0.0027077,0,1,4,12,17
"9538",47690000,10000,0.00270093,0,2,4,13,19
"9539",47695000,10000,0.00277252,0,2,6,11,19
"9540",47700000,10000,0.00278158,0,3,5,8,16
"9541",47705000,10000,0.00269626,0,3,2,7,12
"9542",47710000,10000,0.00269533,0,1,0,5,6
"9543",47715000,10000,0.00272126,0,1,2,5,8
"9544",47720000,10000,0.00274046,0,2,3,10,15
"9545",47725000,10000,0.00273921,0,2,4,9,15
"9546",47730000,10000,0.00273355,0,2,4,5,11
"9547",47735000,10000,0.00269209,0,1,3,8,12
"9548",47740000,10000,0.0027153,0,1,4,10,15
"9549",47745000,10000,0.0026973,0,1,3,10,14
"9550",47750000,10000,0.00262347,0,0,2,11,13
"9551",47755000,10000,0.00264881,0,0,2,10,12
"9552",47760000,10000,0.00264019,0,0,1,10,11
"9553",47765000,10000,0.00262485,0,0,0,11,11
"9554",47770000,10000,0.00268427,0,0,2,8,10
"9555",47775000,10000,0.00269601,0,0,3,7,10
"9556",47780000,10000,0.0027152,0,0,2,13,15
"9557",47785000,10000,0.00269008,0,0,3,13,16
"9558",47790000,10000,0.00261622,0,0,3,8,11
"9559",47795000,10000,0.00263341,0,0,2,10,12
"9560",47800000,10000,0.00272031,0,1,2,13,16
"9561",47805000,10000,0.00278551,0,1,4,14,19
"9562",47810000,10000,0.00278511,0,2,4,10,16
"9563",47815000,10000,0.00278414,0,2,2,7,11
"9564",47820000,10000,0.00278014,0,1,3,9,13
"9565",47825000,10000,0.00278068,0,1,6,15,22
"9566",47830000,10000,0.00280625,0,2,5,16,23
"9567",47835000,10000,0.00277223,0,3,1,7,11
"9568",47840000,10000,0.00268765,0,2,0,2,4
"9569",47845000,10000,0.00269565,0,3,2,2,7
"9570",47850000,10000,0.0026779,0,2,3,2,7
"9571",47855000,10000,0.00261353,0,0,1,3,4
"9572",47860000,10000,0.00266315,0,0,4,6,10
"9573",47865000,10000,0.00273276,0,1,5,7,13
"9574",47870000,10000,0.0027076,0,1,1,5,7
"9575",47875000,10000,0.00267406,0,0,0,8,8
"9576",47880000,10000,0.00271236,0,1,1,10,12
"9577",47885000,10000,0.00274991,0,2,3,15,20
"9578",47890000,10000,0.00277028,0,2,4,19,25
"9579",47895000,10000,0.00268737,0,1,2,10,13
"9580",47900000,10000,0.0026796,0,0,6,8,14
"9581",47905000,10000,0.00272541,0,0,7,7,14
"9582",47910000,10000,0.00269666,0,2,1,6,9
"9583",47915000,10000,0.00269301,0,3,1,9,13
"9584",47920000,10000,0.00267596,0,1,4,9,14
"9585",47925000,10000,0.00273383,0,0,7,13,20
"9586",47930000,10000,0.00279821,0,1,8,12,21
"9587",47935000,10000,0.00275856,0,1,6,9,16
"9588",47940000,10000,0.00271716,0,1,4,9,14
"9589",47945000,10000,0.00273191,0,1,4,11,16
"9590",47950000,10000,0.00271445,0,0,3,13,16
"9591",47955000,10000,0.00269431,0,0,2,9,11
"9592",47960000,10000,0.0027247,0,1,3,7,11
"9593",47965000,10000,0.00277623,0,3,3,11,17
"9594",47970000,10000,0.00275071,0,2,3,11,16
"9595",47975000,10000,0.00279226,0,2,4,9,15
"9596",47980000,10000,0.00284617,0,3,3,11,17
"9597",47985000,10000,0.00278114,0,1,4,12,17
"9598",47990000,10000,0.00270145,0,0,4,11,15
"9599",47995000,10000,0.00268519,0,1,2,12,15
"9600",48000000,10000,0.00269961,0,2,1,17,20
"9601",48005000,10000,0.00267242,0,2,2,17,21
"9602",48010000,10000,0.00264695,0,1,2,12,15
"9603",48015000,10000,0.00264311,0,0,1,11,12
"9604",48020000,10000,0.00260546,0,0,2,12,14
"9605",48025000,10000,0.00263002,0,1,3,9,13
"9606",48030000,10000,0.00274661,0,1,5,4,10
"9607",48035000,10000,0.00273257,0,0,5,6,11
"9608",48040000,10000,0.00272228,0,0,4,12,16
"9609",48045000,10000,0.00266941,0,0,2,12,14
"9610",48050000,10000,0.00265787,0,0,3,9,12
"9611",48055000,10000,0.00275052,0,1,3,6,10
"9612",48060000,10000,0.00272029,0,1,1,9,11
"9613",48065000,10000,0.00271741,0,1,3,15,19
"9614",48070000,10000,0.00271144,0,2,2,12,16
"9615",48075000,10000,0.00270522,0,1,3,16,20
"9616",48080000,10000,0.00277127,0,0,10,21,31
"9617",48085000,10000,0.00276025,0,0,9,22,31
"9618",48090000,10000,0.00275581,0,0,6,25,31
"9619",48095000,10000,0.00275595,0,0,7,17,24
"9620",48100000,10000,0.00267509,0,1,5,9,15
"9621",48105000,10000,0.00261776,0,1,3,9,13
"9622",48110000,10000,0.00267083,0,0,2,12,14
"9623",48115000,10000,0.00273607,0,1,2,15,18
"9624",48120000,10000,0.00275206,0,1,4,14,19
"9625",48125000,10000,0.00274448,0,0,3,15,18
"9626",48130000,10000,0.00273887,0,0,3,18,21
"9627",48135000,10000,0.00273101,0,0,5,17,22
"9628",48140000,10000,0.00269833,0,0,4,12,16
"9629",48145000,10000,0.00268424,0,0,4,7,11
"9630",48150000,10000,0.00264298,0,0,2,6,8
"9631",48155000,10000,0.0026692,0,0,4,12,16
"9632",48160000,10000,0.00265522,0,0,4,13,17
"9633",48165000,10000,0.00261583,0,0,3,8,11
"9634",48170000,10000,0.00263817,0,0,4,8,12
"9635",48175000,10000,0.00262928,0,0,2,9,11
"9636",48180000,10000,0.00264148,0,0,3,7,10
"9637",48185000,10000,0.00268254,0,0,4,9,13
"9638",48190000,10000,0.00265859,0,0,3,12,15
"9639",48195000,10000,0.00260355,0,0,2,8,10
"9640",48200000,10000,0.00264235,0,0,3,10,13
"9641",48205000,10000,0.00266725,0,1,3,11,15
"9642",48210000,10000,0.00273356,0,3,3,10,16
"9643",48215000,10000,0.00274833,0,2,3,11,16
"9644",48220000,10000,0.00270661,0,1,3,11,15
"9645",48225000,10000,0.00267157,0,1,2,9,12
"9646",48230000,10000,0.00260284,0,0,2,6,8
"9647",48235000,10000,0.00264777,0,1,3,7,11
"9648",48240000,10000,0.00268012,0,3,1,5,9
"9649",48245000,10000,0.00266049,0,2,2,7,11
"9650",48250000,10000,0.0026157,0,0,4,8,12
"9651",48255000,10000,0.0025613,0,0,2,4,6
"9652",48260000,10000,0.00257472,0,0,2,3,5
"9653",48265000,10000,0.00262901,0,2,3,5,10
"9654",48270000,10000,0.0026743,0,2,4,11,17
"9655",48275000,10000,0.00267133,0,1,5,12,18
"9656",48280000,10000,0.00263414,0,1,3,10,14
"9657",48285000,10000,0.00259895,0,1,2,7,10
"9658",48290000,10000,0.00257672,0,1,1,5,7
"9659",48295000,10000,0.00262969,0,2,3,4,9
"9660",48300000,10000,0.00266667,0,2,3,5,10
"9661",48305000,10000,0.00259858,0,0,1,5,6
"9662",48310000,10000,0.00256389,0,1,2,4,7
"9663",48315000,10000,0.00259608,0,2,2,5,9
"9664",48320000,10000,0.00261383,0,2,2,11,15
"9665",48325000,10000,0.00262584,0,2,2,15,19
"9666",48330000,10000,0.00254929,0,1,1,8,10
"9667",48335000,10000,0.00250746,0,0,3,4,7
"9668",48340000,10000,0.00252807,0,0,3,6,9
"9669",48345000,10000,0.00252229,0,0,0,8,8
"9670",48350000,10000,0.00256145,0,0,1,5,6
"9671",48355000,10000,0.00254097,0,0,2,4,6
"9672",48360000,10000,0.0025596,0,0,3,7,10
"9673",48365000,10000,0.00263568,0,1,2,8,11
"9674",48370000,10000,0.00267013,0,1,2,9,12
"9675",48375000,10000,0.00269734,0,2,4,9,15
"9676",48380000,10000,0.00267782,0,2,2,6,10
"9677",48385000,10000,0.0026174,0,0,1,4,5
"9678",48390000,10000,0.00258909,0,0,1,4,5
"9679",48395000,10000,0.00256099,0,0,0,4,4
"9680",48400000,10000,0.00255753,0,0,0,9,9
"9681",48405000,10000,0.00254696,0,0,0,13,13
"9682",48410000,10000,0.00256505,0,0,0,12,12
"9683",48415000,10000,0.00260914,0,0,2,11,13
"9684",48420000,10000,0.00262454,0,0,4,12,16
"9685",48425000,10000,0.00264082,0,1,3,11,15
"9686",48430000,10000,0.00267364,0,2,1,10,13
"9687",48435000,10000,0.00267618,0,1,0,10,11
"9688",48440000,10000,0.00268837,0,1,3,8,12
"9689",48445000,10000,0.00266983,0,1,3,7,11
"9690",48450000,10000,0.002657,0,0,3,8,11
"9691",48455000,10000,0.00268224,0,0,3,8,11
"9692",48460000,10000,0.00267557,0,0,0,9,9
"9693",48465000,10000,0.0027057,0,1,3,13,17
"9694",48470000,10000,0.00270916,0,1,3,15,19
"9695",48475000,10000,0.00268513,0,0,0,14,14
"9696",48480000,10000,0.00270071,0,1,1,9,11
"9697",48485000,10000,0.00273576,0,2,5,7,14
"9698",48490000,10000,0.00269063,0,1,5,9,15
"9699",48495000,10000,0.00263096,0,0,1,9,10
"9700",48500000,10000,0.00268169,0,0,3,8,11
"9701",48505000,10000,0.00275963,0,1,6,11,18
"9702",48510000,10000,0.0027212,0,1,3,14,18
"9703",48515000,10000,0.00272439,0,1,3,15,19
"9704",48520000,10000,0.00271761,0,1,5,12,18
"9705",48525000,10000,0.00265233,0,1,3,7,11
"9706",48530000,10000,0.00265229,0,1,2,5,8
"9707",48535000,10000,0.00264195,0,0,5,6,11
"9708",48540000,10000,0.00261755,0,1,4,4,9
"9709",48545000,10000,0.00259322,0,1,1,3,5
"9710",48550000,10000,0.00260454,0,1,2,6,9
"9711",48555000,10000,0.00263275,0,1,2,4,7
"9712",48560000,10000,0.00262934,0,0,1,3,4
"9713",48565000,10000,0.00268097,0,1,0,7,8
"9714",48570000,10000,0.00270435,0,2,0,6,8
"9715",48575000,10000,0.00262362,0,2,0,2,4
"9716",48580000,10000,0.00259074,0,1,1,4,6
"9717",48585000,10000,0.00260848,0,1,1,5,7
"9718",48590000,10000,0.00260744,0,1,0,4,5
"9719",48595000,10000,0.0025809,0,0,0,2,2
"9720",48600000,10000,0.00258543,0,0,0,4,4
"9721",48605000,10000,0.00260092,0,0,2,8,10
"9722",48610000,10000,0.00256955,0,1,2,5,8
"9723",48615000,10000,0.00255805,0,1,1,2,4
"9724",48620000,10000,0.00261275,0,1,2,5,8
"9725",48625000,10000,0.00261453,0,1,1,8,10
"9726",48630000,10000,0.00263791,0,0,1,11,12
"9727",48635000,10000,0.00266968,0,0,1,11,12
"9728",48640000,10000,0.00264353,0,0,2,7,9
"9729",48645000,10000,0.00264539,0,0,3,7,10
"9730",48650000,10000,0.00263595,0,0,3,10,13
"9731",48655000,10000,0.00262997,0,0,5,8,13
"9732",48660000,10000,0.00267157,0,1,5,10,16
"9733",48665000,10000,0.00275008,0,2,4,20,26
"9734",48670000,10000,0.00272109,0,1,3,16,20
"9735",48675000,10000,0.0026132,0,0,1,6,7
"9736",48680000,10000,0.00264249,0,0,2,6,8
"9737",48685000,10000,0.00267111,0,0,4,9,13
"9738",48690000,10000,0.00263295,0,0,4,9,13
"9739",48695000,10000,0.002632,0,0,4,12,16
"9740",48700000,10000,0.00264196,0,0,2,13,15
"9741",48705000,10000,0.0027034,0,0,0,11,11
"9742",48710000,10000,0.00275281,0,1,3,12,16
"9743",48715000,10000,0.00263581,0,1,4,9,14
"9744",48720000,10000,0.00255509,0,0,1,7,8
"9745",48725000,10000,0.0026559,0,2,1,5,8
"9746",48730000,10000,0.00271452,0,2,4,7,13
"9747",48735000,10000,0.00269538,0,0,3,10,13
"9748",48740000,10000,0.00266583,0,0,1,12,13
"9749",48745000,10000,0.00261562,0,1,2,9,12
"9750",48750000,10000,0.00260226,0,1,2,2,5
"9751",48755000,10000,0.00262951,0,0,2,5,7
"9752",48760000,10000,0.0026951,0,0,2,9,11
"9753",48765000,10000,0.00277039,0,1,1,13,15
"9754",48770000,10000,0.00272205,0,1,2,15,18
"9755",48775000,10000,0.00268475,0,0,7,12,19
"9756",48780000,10000,0.00267653,0,0,6,14,20
"9757",48785000,10000,0.00269334,0,0,2,14,16
"9758",48790000,10000,0.00278613,0,1,2,9,12
"9759",48795000,10000,0.00282064,0,3,2,13,18
"9760",48800000,10000,0.00280357,0,3,3,16,22
"9761",48805000,10000,0.00275715,0,2,4,14,20
"9762",48810000,10000,0.00268448,0,1,4,10,15
"9763",48815000,10000,0.00263761,0,0,2,5,7
"9764",48820000,10000,0.00270616,0,2,2,11,15
"9765",48825000,10000,0.00275741,0,3,5,21,29
"9766",48830000,10000,0.00269319,0,2,4,20,26
"9767",48835000,10000,0.00264821,0,1,2,16,19
"9768",48840000,10000,0.00268452,0,0,5,17,22
"9769",48845000,10000,0.00269426,0,0,5,16,21
"9770",48850000,10000,0.00271026,0,2,4,14,20
"9771",48855000,10000,0.00274896,0,3,6,15,24
"9772",48860000,10000,0.00267525,0,1,4,14,19
"9773",48865000,10000,0.00266923,0,0,3,17,20
"9774",48870000,10000,0.00269904,0,0,4,14,18
"9775",48875000,10000,0.00274306,0,1,5,12,18
"9776",48880000,10000,0.00279534,0,1,8,16,25
"9777",48885000,10000,0.00273533,0,0,6,20,26
"9778",48890000,10000,0.00267263,0,0,4,18,22
"9779",48895000,10000,0.00269594,0,1,5,11,17
"9780",48900000,10000,0.00271029,0,1,5,14,20
"9781",48905000,10000,0.00263511,0,0,3,15,18
"9782",48910000,10000,0.00266755,0,0,3,9,12
"9783",48915000,10000,0.00274044,0,2,3,9,14
"9784",48920000,10000,0.0027499,0,3,2,13,18
"9785",48925000,10000,0.00274307,0,2,2,9,13
"9786",48930000,10000,0.00269904,0,1,1,8,10
"9787",48935000,10000,0.00269354,0,0,3,13,16
"9788",48940000,10000,0.00272339,0,0,6,11,17
"9789",48945000,10000,0.00272881,0,0,7,16,23
"9790",48950000,10000,0.00269982,0,0,7,20,27
"9791",48955000,10000,0.00270179,0,0,8,15,23
"9792",48960000,10000,0.00277193,0,0,9,14,23
"9793",48965000,10000,0.00277426,0,0,9,15,24
"9794",48970000,10000,0.00277123,0,0,7,16,23
"9795",48975000,10000,0.00280035,0,0,8,15,23
"9796",48980000,10000,0.00274598,0,0,6,21,27
"9797",48985000,10000,0.00265058,0,0,3,19,22
"9798",48990000,10000,0.00256943,0,1,3,9,13
"9799",48995000,10000,0.00250843,0,1,1,6,8
"9800",49000000,10000,0.00251713,0,0,1,6,7
"9801",49005000,10000,0.00265292,0,0,5,8,13
"9802",49010000,10000,0.00273834,0,1,8,10,19
"9803",49015000,10000,0.00272839,0,2,7,6,15
"9804",49020000,10000,0.00271215,0,2,6,7,15
"9805",49025000,10000,0.00268977,0,1,7,13,21
"9806",49030000,10000,0.00266698,0,0,5,14,19
"9807",49035000,10000,0.00263569,0,0,2,10,12
"9808",49040000,10000,0.00264826,0,0,1,8,9
"9809",49045000,10000,0.00273456,0,1,6,12,19
"9810",49050000,10000,0.00267566,0,1,6,8,15
"9811",49055000,10000,0.00264183,0,0,3,12,15
"9812",49060000,10000,0.00270886,0,0,5,17,22
"9813",49065000,10000,0.00269722,0,0,3,16,19
"9814",49070000,10000,0.0027222,0,0,6,18,24
"9815",49075000,10000,0.00271614,0,1,8,12,21
"9816",49080000,10000,0.00266967,0,1,5,12,18
"9817",49085000,10000,0.00267024,0,0,4,14,18
"9818",49090000,10000,0.0026803,0,1,4,9,14
"9819",49095000,10000,0.00266075,0,1,4,10,15
"9820",49100000,10000,0.00264744,0,1,4,10,15
"9821",49105000,10000,0.00266167,0,1,2,7,10
"9822",49110000,10000,0.00266555,0,1,1,10,12
"9823",49115000,10000,0.00263827,0,1,2,8,11
"9824",49120000,10000,0.0026259,0,1,2,6,9
"9825",49125000,10000,0.00265024,0,2,2,5,9
"9826",49130000,10000,0.00265207,0,1,1,8,10
"9827",49135000,10000,0.00259524,0,1,0,11,12
"9828",49140000,10000,0.00264361,0,1,3,13,17
"9829",49145000,10000,0.00269267,0,0,4,12,16
"9830",49150000,10000,0.00269822,0,1,3,11,15
"9831",49155000,10000,0.00277701,0,1,6,17,24
"9832",49160000,10000,0.0027446,0,0,4,15,19
"9833",49165000,10000,0.00271586,0,0,1,16,17
"9834",49170000,10000,0.00273666,0,0,1,15,16
"9835",49175000,10000,0.00267205,0,0,1,8,9
"9836",49180000,10000,0.00267397,0,1,2,9,12
"9837",49185000,10000,0.0026773,0,1,2,9,12
"9838",49190000,10000,0.00264292,0,1,3,8,12
"9839",49195000,10000,0.00267534,0,1,3,16,20
"9840",49200000,10000,0.00271985,0,1,2,14,17
"9841",49205000,10000,0.0027436,0,1,2,7,10
"9842",49210000,10000,0.00271577,0,1,1,9,11
"9843",49215000,10000,0.00270309,0,3,0,6,9
"9844",49220000,10000,0.00273983,0,2,2,10,14
"9845",49225000,10000,0.0027412,0,0,5,15,20
"9846",49230000,10000,0.0026833,0,0,3,13,16
"9847",49235000,10000,0.00269556,0,0,2,15,17
"9848",49240000,10000,0.00271631,0,0,3,17,20
"9849",49245000,10000,0.00272124,0,0,4,19,23
"9850",49250000,10000,0.00277886,0,0,6,22,28
"9851",49255000,10000,0.00276389,0,0,5,20,25
"9852",49260000,10000,0.00268345,0,0,3,12,15
"9853",49265000,10000,0.00268399,0,2,3,8,13
"9854",49270000,10000,0.00273408,0,2,6,14,22
"9855",49275000,10000,0.00281278,0,2,8,17,27
"9856",49280000,10000,0.00279247,0,2,5,16,23
"9857",49285000,10000,0.0026889,0,0,3,13,16
"9858",49290000,10000,0.00263128,0,0,3,6,9
"9859",49295000,10000,0.00261094,0,0,2,7,9
"9860",49300000,10000,0.00265489,0,0,2,13,15
"9861",49305000,10000,0.00266597,0,0,3,16,19
"9862",49310000,10000,0.00264876,0,0,4,14,18
"9863",49315000,10000,0.00265338,0,1,5,11,17
"9864",49320000,10000,0.00267399,0,1,6,10,17
"9865",49325000,10000,0.00265582,0,0,4,10,14
"9866",49330000,10000,0.00264757,0,1,3,12,16
"9867",49335000,10000,0.00264971,0,1,3,14,18
"9868",49340000,10000,0.00263855,0,0,3,12,15
"9869",49345000,10000,0.00262639,0,1,3,8,12
"9870",49350000,10000,0.00259046,0,1,1,9,11
"9871",49355000,10000,0.00257134,0,0,0,10,10
"9872",49360000,10000,0.00259187,0,1,1,7,9
"9873",49365000,10000,0.00267982,0,1,4,10,15
"9874",49370000,10000,0.00269644,0,0,4,10,14
"9875",49375000,10000,0.00268331,0,0,3,11,14
"9876",49380000,10000,0.00271052,0,0,2,15,17
"9877",49385000,10000,0.00272997,0,0,2,14,16
"9878",49390000,10000,0.00277525,0,1,4,17,22
"9879",49395000,10000,0.00274885,0,1,2,20,23
"9880",49400000,10000,0.00275773,0,2,0,20,22
"9881",49405000,10000,0.00277658,0,2,3,15,20
"9882",49410000,10000,0.00272619,0,0,3,11,14
"9883",49415000,10000,0.00265653,0,0,0,7,7
"9884",49420000,10000,0.00262521,0,1,0,6,7
"9885",49425000,10000,0.00262446,0,1,2,11,14
"9886",49430000,10000,0.0026851,0,0,6,14,20
"9887",49435000,10000,0.00274609,0,0,5,11,16
"9888",49440000,10000,0.00271803,0,0,1,6,7
"9889",49445000,10000,0.00270079,0,0,2,8,10
"9890",49450000,10000,0.0027354,0,0,4,10,14
"9891",49455000,10000,0.00275062,0,1,2,7,10
"9892",49460000,10000,0.00272047,0,1,0,10,11
"9893",49465000,10000,0.00271892,0,0,1,11,12
"9894",49470000,10000,0.00272347,0,1,1,6,8
"9895",49475000,10000,0.00273683,0,2,2,7,11
"9896",49480000,10000,0.00278313,0,1,5,8,14
"9897",49485000,10000,0.00277565,0,1,4,6,11
"9898",49490000,10000,0.00271357,0,1,1,3,5
"9899",49495000,10000,0.00261954,0,1,1,2,4
"9900",49500000,10000,0.00260286,0,1,3,4,8
"9901",49505000,10000,0.00270799,0,1,2,7,10
"9902",49510000,10000,0.00275957,0,2,2,11,15
"9903",49515000,10000,0.00273293,0,1,4,14,19
"9904",49520000,10000,0.00266858,0,0,2,10,12
"9905",49525000,10000,0.0026535,0,0,1,9,10
"9906",49530000,10000,0.00267616,0,0,3,15,18
"9907",49535000,10000,0.00265868,0,0,4,12,16
"9908",49540000,10000,0.00263681,0,1,2,6,9
"9909",49545000,10000,0.00268059,0,2,2,6,10
"9910",49550000,10000,0.00271456,0,1,2,7,10
"9911",49555000,10000,0.00271362,0,0,4,9,13
"9912",49560000,10000,0.00272084,0,1,6,9,16
"9913",49565000,10000,0.00264864,0,1,4,9,14
"9914",49570000,10000,0.00269272,0,1,6,11,18
"9915",49575000,10000,0.00274543,0,3,4,9,16
"9916",49580000,10000,0.0026865,0,2,1,8,11
"9917",49585000,10000,0.00266712,0,0,2,6,8
"9918",49590000,10000,0.00266286,0,0,3,7,10
"9919",49595000,10000,0.00268787,0,0,3,12,15
"9920",49600000,10000,0.00268114,0,0,1,7,8
"9921",49605000,10000,0.00268955,0,1,2,7,10
"9922",49610000,10000,0.00268732,0,1,3,10,14
"9923",49615000,10000,0.00266154,0,0,3,7,10
"9924",49620000,10000,0.00265566,0,0,4,5,9
"9925",49625000,10000,0.00265064,0,0,5,5,10
"9926",49630000,10000,0.00263092,0,1,3,5,9
"9927",49635000,10000,0.00261677,0,1,1,9,11
"9928",49640000,10000,0.00262242,0,0,1,14,15
"9929",49645000,10000,0.00266127,0,0,3,16,19
"9930",49650000,10000,0.00265298,0,0,4,13,17
"9931",49655000,10000,0.00262947,0,0,4,11,15
"9932",49660000,10000,0.00265258,0,0,4,10,14
"9933",49665000,10000,0.00263414,0,0,4,10,14
"9934",49670000,10000,0.00263043,0,1,4,13,18
"9935",49675000,10000,0.00261966,0,1,5,10,16
"9936",49680000,10000,0.00265755,0,0,6,10,16
"9937",49685000,10000,0.00269446,0,1,4,13,18
"9938",49690000,10000,0.00267929,0,1,4,16,21
"9939",49695000,10000,0.0026697,0,0,3,12,15
"9940",49700000,10000,0.00269669,0,1,1,8,10
"9941",49705000,10000,0.00269842,0,1,0,10,11
"9942",49710000,10000,0.00270443,0,1,2,11,14
"9943",49715000,10000,0.00272653,0,1,3,10,14
"9944",49720000,10000,0.00269935,0,0,1,7,8
"9945",49725000,10000,0.00276193,0,2,1,10,13
"9946",49730000,10000,0.00271059,0,2,1,11,14
"9947",49735000,10000,0.00260299,0,0,1,9,10
"9948",49740000,10000,0.00267077,0,0,2,15,17
"9949",49745000,10000,0.00269898,0,0,2,15,17
"9950",49750000,10000,0.00271674,0,0,4,14,18
"9951",49755000,10000,0.0027568,0,0,8,13,21
"9952",49760000,10000,0.00267749,0,0,5,6,11
"9953",49765000,10000,0.00263738,0,0,2,5,7
"9954",49770000,10000,0.00269668,0,0,6,14,20
"9955",49775000,10000,0.00267121,0,1,4,12,17
"9956",49780000,10000,0.00264706,0,1,2,5,8
"9957",49785000,10000,0.00264686,0,0,2,8,10
"9958",49790000,10000,0.00264851,0,0,1,8,9
"9959",49795000,10000,0.00274122,0,2,3,9,14
"9960",49800000,10000,0.00274391,0,4,6,13,23
"9961",49805000,10000,0.00266985,0,2,5,11,18
"9962",49810000,10000,0.0026429,0,0,2,11,13
"9963",49815000,10000,0.00261508,0,0,1,12,13
"9964",49820000,10000,0.00261903,0,0,1,8,9
"9965",49825000,10000,0.0026442,0,0,1,8,9
"9966",49830000,10000,0.00267406,0,0,2,10,12
"9967",49835000,10000,0.00271341,0,0,4,7,11
"9968",49840000,10000,0.00275957,0,1,6,9,16
"9969",49845000,10000,0.00278213,0,1,5,12,18
"9970",49850000,10000,0.00268684,0,0,1,6,7
"9971",49855000,10000,0.00265214,0,0,1,9,10
"9972",49860000,10000,0.00268198,0,1,1,9,11
"9973",49865000,10000,0.00271489,0,2,1,3,6
"9974",49870000,10000,0.00272865,0,1,2,7,10
"9975",49875000,10000,0.00271677,0,1,4,13,18
"9976",49880000,10000,0.00271592,0,1,5,10,16
"9977",49885000,10000,0.00271234,0,0,2,9,11
"9978",49890000,10000,0.00269302,0,1,0,9,10
"9979",49895000,10000,0.0026581,0,1,1,7,9
"9980",49900000,10000,0.00266841,0,0,2,7,9
"9981",49905000,10000,0.0027097,0,0,2,8,10
"9982",49910000,10000,0.00271412,0,0,2,7,9
"9983",49915000,10000,0.00268392,0,0,2,9,11
"9984",49920000,10000,0.00270954,0,0,4,11,15
"9985",49925000,10000,0.00272761,0,1,3,9,13
"9986",49930000,10000,0.00269044,0,2,0,5,7
"9987",49935000,10000,0.00271339,0,2,2,4,8
"9988",49940000,10000,0.00275572,0,1,3,9,13
"9989",49945000,10000,0.00276207,0,1,2,7,10
"9990",49950000,10000,0.00276168,0,2,4,7,13
"9991",49955000,10000,0.00272135,0,1,4,9,14
"9992",49960000,10000,0.00269244,0,0,4,11,15
"9993",49965000,10000,0.00265238,0,1,3,9,13
"9994",49970000,10000,0.00263399,0,1,0,7,8
"9995",49975000,10000,0.00268027,0,1,0,10,11
"9996",49980000,10000,0.00277072,0,3,3,12,18
"9997",49985000,10000,0.00279984,0,3,4,13,20
"9998",49990000,10000,0.0027159,0,2,2,11,15
"9999",49995000,10000,0.00266875,0,1,1,8,10
