"","genome_position","N","mean_Kd_inverse","N_over_1.5","N_0.15_to_1.5","N_0.09_to_0.15","N_0.04_to_0.09","Total_over_0.04"
"80000",40000000,1000,0.00281967,0,0,2,1,3
"80001",40000500,1000,0.00259445,0,0,0,0,0
"80002",40001000,1000,0.00261796,0,0,0,2,2
"80003",40001500,1000,0.0026773,0,0,0,3,3
"80004",40002000,1000,0.00271728,0,0,0,1,1
"80005",40002500,1000,0.00282292,0,0,1,2,3
"80006",40003000,1000,0.00279225,0,0,2,3,5
"80007",40003500,1000,0.00272861,0,0,2,2,4
"80008",40004000,1000,0.00282634,0,0,1,1,2
"80009",40004500,1000,0.00281317,0,0,1,1,2
"80010",40005000,1000,0.0027503,0,0,1,1,2
"80011",40005500,1000,0.00268047,0,0,0,0,0
"80012",40006000,1000,0.00279126,0,0,1,2,3
"80013",40006500,1000,0.00263573,0,0,1,2,3
"80014",40007000,1000,0.00266267,0,0,1,3,4
"80015",40007500,1000,0.00277204,0,0,1,3,4
"80016",40008000,1000,0.00248887,0,0,0,0,0
"80017",40008500,1000,0.00258442,0,0,0,0,0
"80018",40009000,1000,0.00276594,0,0,1,0,1
"80019",40009500,1000,0.00266442,0,0,1,0,1
"80020",40010000,1000,0.00267301,0,0,0,0,0
"80021",40010500,1000,0.00271992,0,0,0,0,0
"80022",40011000,1000,0.00262161,0,0,0,0,0
"80023",40011500,1000,0.00252592,0,0,0,0,0
"80024",40012000,1000,0.00256312,0,0,0,0,0
"80025",40012500,1000,0.00269517,0,0,0,0,0
"80026",40013000,1000,0.00272062,0,0,0,1,1
"80027",40013500,1000,0.00289673,0,0,1,2,3
"80028",40014000,1000,0.00307144,0,0,2,3,5
"80029",40014500,1000,0.00291038,0,0,1,4,5
"80030",40015000,1000,0.00266831,0,0,0,2,2
"80031",40015500,1000,0.00268724,0,0,0,0,0
"80032",40016000,1000,0.00272474,0,0,0,1,1
"80033",40016500,1000,0.00265038,0,0,0,1,1
"80034",40017000,1000,0.00263544,0,0,0,1,1
"80035",40017500,1000,0.00270787,0,0,0,1,1
"80036",40018000,1000,0.00272338,0,0,0,1,1
"80037",40018500,1000,0.00264556,0,0,0,1,1
"80038",40019000,1000,0.00264601,0,0,0,1,1
"80039",40019500,1000,0.00291629,0,1,0,1,2
"80040",40020000,1000,0.00301857,0,1,0,0,1
"80041",40020500,1000,0.00281182,0,0,0,2,2
"80042",40021000,1000,0.00273856,0,0,1,2,3
"80043",40021500,1000,0.00269678,0,0,1,0,1
"80044",40022000,1000,0.00271626,0,0,1,0,1
"80045",40022500,1000,0.00281002,0,0,1,1,2
"80046",40023000,1000,0.0028975,0,0,0,2,2
"80047",40023500,1000,0.00283568,0,0,1,2,3
"80048",40024000,1000,0.00272297,0,0,1,2,3
"80049",40024500,1000,0.00270158,0,0,0,2,2
"80050",40025000,1000,0.00274433,0,0,0,2,2
"80051",40025500,1000,0.00273013,0,0,0,1,1
"80052",40026000,1000,0.00266776,0,0,0,1,1
"80053",40026500,1000,0.00273879,0,0,0,2,2
"80054",40027000,1000,0.00280788,0,0,0,1,1
"80055",40027500,1000,0.00278459,0,0,0,0,0
"80056",40028000,1000,0.00272998,0,0,0,1,1
"80057",40028500,1000,0.00269555,0,0,0,1,1
"80058",40029000,1000,0.00283667,0,0,1,2,3
"80059",40029500,1000,0.00285711,0,0,1,2,3
"80060",40030000,1000,0.00279437,0,0,0,2,2
"80061",40030500,1000,0.00281768,0,0,0,5,5
"80062",40031000,1000,0.00277294,0,0,0,4,4
"80063",40031500,1000,0.00281046,0,0,0,1,1
"80064",40032000,1000,0.00283218,0,0,0,1,1
"80065",40032500,1000,0.00280521,0,0,0,1,1
"80066",40033000,1000,0.00281931,0,0,0,0,0
"80067",40033500,1000,0.00280195,0,0,0,0,0
"80068",40034000,1000,0.00262051,0,0,0,0,0
"80069",40034500,1000,0.00252476,0,0,0,0,0
"80070",40035000,1000,0.00261152,0,0,0,0,0
"80071",40035500,1000,0.00274886,0,0,0,1,1
"80072",40036000,1000,0.00290665,0,0,0,3,3
"80073",40036500,1000,0.00284044,0,0,0,3,3
"80074",40037000,1000,0.00262891,0,0,0,1,1
"80075",40037500,1000,0.00262857,0,0,0,1,1
"80076",40038000,1000,0.00269665,0,0,0,1,1
"80077",40038500,1000,0.0026876,0,0,0,0,0
"80078",40039000,1000,0.00270187,0,0,0,0,0
"80079",40039500,1000,0.00269847,0,0,0,1,1
"80080",40040000,1000,0.0028563,0,0,2,2,4
"80081",40040500,1000,0.00290116,0,0,2,3,5
"80082",40041000,1000,0.00276853,0,0,0,3,3
"80083",40041500,1000,0.00267765,0,0,0,1,1
"80084",40042000,1000,0.00257262,0,0,0,0,0
"80085",40042500,1000,0.00247916,0,0,0,0,0
"80086",40043000,1000,0.00255777,0,0,0,0,0
"80087",40043500,1000,0.00271957,0,0,1,1,2
"80088",40044000,1000,0.00270973,0,0,2,1,3
"80089",40044500,1000,0.00272549,0,0,2,1,3
"80090",40045000,1000,0.00275754,0,0,1,3,4
"80091",40045500,1000,0.00285318,0,0,0,4,4
"80092",40046000,1000,0.00278111,0,0,1,3,4
"80093",40046500,1000,0.00266173,0,0,2,2,4
"80094",40047000,1000,0.00270597,0,0,2,2,4
"80095",40047500,1000,0.00274752,0,0,1,2,3
"80096",40048000,1000,0.00260779,0,0,0,1,1
"80097",40048500,1000,0.00261708,0,0,1,0,1
"80098",40049000,1000,0.00278244,0,0,1,1,2
"80099",40049500,1000,0.00286325,0,0,1,3,4
"80100",40050000,1000,0.00314773,0,1,2,4,7
"80101",40050500,1000,0.00296126,0,1,1,2,4
"80102",40051000,1000,0.00266161,0,0,0,1,1
"80103",40051500,1000,0.00267883,0,0,0,2,2
"80104",40052000,1000,0.00273632,0,0,0,3,3
"80105",40052500,1000,0.00277498,0,0,0,2,2
"80106",40053000,1000,0.00266844,0,0,0,1,1
"80107",40053500,1000,0.00271005,0,0,1,1,2
"80108",40054000,1000,0.00273528,0,0,1,0,1
"80109",40054500,1000,0.00266183,0,0,0,0,0
"80110",40055000,1000,0.00254982,0,0,0,0,0
"80111",40055500,1000,0.00265736,0,0,1,0,1
"80112",40056000,1000,0.00275813,0,0,1,0,1
"80113",40056500,1000,0.00265491,0,0,0,1,1
"80114",40057000,1000,0.00266324,0,0,0,2,2
"80115",40057500,1000,0.00266159,0,0,0,1,1
"80116",40058000,1000,0.00266571,0,0,0,0,0
"80117",40058500,1000,0.00270494,0,0,1,1,2
"80118",40059000,1000,0.00278472,0,0,1,2,3
"80119",40059500,1000,0.00309253,0,2,0,1,3
"80120",40060000,1000,0.00298087,0,2,0,0,2
"80121",40060500,1000,0.00256787,0,0,0,0,0
"80122",40061000,1000,0.00263654,0,0,0,1,1
"80123",40061500,1000,0.00270596,0,0,0,1,1
"80124",40062000,1000,0.00264371,0,0,1,0,1
"80125",40062500,1000,0.00243488,0,0,1,0,1
"80126",40063000,1000,0.0022481,0,0,0,0,0
"80127",40063500,1000,0.00240358,0,0,0,0,0
"80128",40064000,1000,0.00267437,0,0,0,0,0
"80129",40064500,1000,0.00286512,0,0,0,1,1
"80130",40065000,1000,0.00277036,0,0,0,1,1
"80131",40065500,1000,0.00260584,0,0,0,0,0
"80132",40066000,1000,0.00271035,0,0,0,2,2
"80133",40066500,1000,0.00275069,0,0,0,3,3
"80134",40067000,1000,0.00265523,0,0,0,1,1
"80135",40067500,1000,0.00266431,0,0,0,0,0
"80136",40068000,1000,0.0026395,0,0,0,0,0
"80137",40068500,1000,0.00266686,0,0,0,0,0
"80138",40069000,1000,0.00271314,0,0,0,0,0
"80139",40069500,1000,0.00280303,0,1,0,1,2
"80140",40070000,1000,0.00281503,0,1,0,1,2
"80141",40070500,1000,0.00262976,0,0,0,0,0
"80142",40071000,1000,0.00252983,0,0,0,0,0
"80143",40071500,1000,0.00258808,0,0,0,0,0
"80144",40072000,1000,0.00265383,0,0,0,0,0
"80145",40072500,1000,0.00272198,0,0,1,0,1
"80146",40073000,1000,0.00277008,0,0,1,0,1
"80147",40073500,1000,0.00270365,0,0,0,0,0
"80148",40074000,1000,0.0025794,0,0,0,0,0
"80149",40074500,1000,0.00261646,0,0,0,0,0
"80150",40075000,1000,0.00263046,0,0,0,0,0
"80151",40075500,1000,0.00277048,0,0,1,1,2
"80152",40076000,1000,0.00296907,0,1,1,1,3
"80153",40076500,1000,0.00293915,0,1,1,0,2
"80154",40077000,1000,0.0029278,0,0,2,1,3
"80155",40077500,1000,0.00289461,0,0,2,2,4
"80156",40078000,1000,0.00276916,0,0,1,2,3
"80157",40078500,1000,0.00270514,0,0,0,2,2
"80158",40079000,1000,0.00280642,0,0,1,2,3
"80159",40079500,1000,0.00280191,0,0,2,1,3
"80160",40080000,1000,0.00273368,0,0,1,0,1
"80161",40080500,1000,0.0027573,0,0,0,2,2
"80162",40081000,1000,0.00281206,0,0,0,2,2
"80163",40081500,1000,0.00275448,0,0,1,1,2
"80164",40082000,1000,0.00267287,0,0,1,1,2
"80165",40082500,1000,0.00256888,0,0,0,1,1
"80166",40083000,1000,0.00274531,0,0,1,3,4
"80167",40083500,1000,0.00282925,0,0,1,2,3
"80168",40084000,1000,0.00284308,0,1,0,0,1
"80169",40084500,1000,0.00286148,0,1,0,0,1
"80170",40085000,1000,0.00266155,0,0,0,1,1
"80171",40085500,1000,0.00275777,0,0,1,2,3
"80172",40086000,1000,0.00274145,0,0,1,1,2
"80173",40086500,1000,0.00283002,0,0,0,2,2
"80174",40087000,1000,0.00298057,0,0,0,2,2
"80175",40087500,1000,0.0029197,0,0,1,1,2
"80176",40088000,1000,0.00288718,0,0,1,1,2
"80177",40088500,1000,0.00272831,0,0,0,1,1
"80178",40089000,1000,0.00278345,0,0,0,1,1
"80179",40089500,1000,0.00277616,0,0,0,0,0
"80180",40090000,1000,0.00259983,0,0,0,0,0
"80181",40090500,1000,0.00264776,0,0,0,0,0
"80182",40091000,1000,0.00275224,0,0,0,1,1
"80183",40091500,1000,0.00291397,0,1,0,1,2
"80184",40092000,1000,0.00285777,0,1,0,1,2
"80185",40092500,1000,0.00259667,0,0,0,2,2
"80186",40093000,1000,0.00266548,0,0,0,1,1
"80187",40093500,1000,0.00286906,0,1,0,0,1
"80188",40094000,1000,0.00276302,0,1,0,0,1
"80189",40094500,1000,0.00280035,0,1,0,2,3
"80190",40095000,1000,0.00281792,0,1,0,2,3
"80191",40095500,1000,0.00265266,0,0,0,1,1
"80192",40096000,1000,0.00268927,0,0,0,1,1
"80193",40096500,1000,0.00273729,0,0,0,0,0
"80194",40097000,1000,0.00270415,0,0,0,0,0
"80195",40097500,1000,0.00265376,0,0,0,0,0
"80196",40098000,1000,0.00288661,0,1,1,0,2
"80197",40098500,1000,0.00313234,0,1,3,0,4
"80198",40099000,1000,0.00281994,0,0,2,0,2
"80199",40099500,1000,0.00260911,0,0,0,1,1
"80200",40100000,1000,0.00272196,0,0,0,1,1
"80201",40100500,1000,0.00261437,0,0,0,0,0
"80202",40101000,1000,0.00262519,0,0,0,0,0
"80203",40101500,1000,0.00281468,0,0,0,2,2
"80204",40102000,1000,0.00289221,0,0,1,3,4
"80205",40102500,1000,0.00296289,0,0,2,3,5
"80206",40103000,1000,0.00312314,0,1,1,2,4
"80207",40103500,1000,0.00296215,0,1,0,1,2
"80208",40104000,1000,0.00279119,0,0,0,3,3
"80209",40104500,1000,0.00283115,0,0,0,4,4
"80210",40105000,1000,0.00268335,0,0,0,2,2
"80211",40105500,1000,0.00261023,0,0,0,0,0
"80212",40106000,1000,0.00273136,0,0,0,1,1
"80213",40106500,1000,0.00278248,0,0,0,3,3
"80214",40107000,1000,0.00264517,0,0,0,3,3
"80215",40107500,1000,0.00264915,0,0,0,1,1
"80216",40108000,1000,0.00266315,0,0,0,0,0
"80217",40108500,1000,0.00262532,0,0,1,1,2
"80218",40109000,1000,0.00267139,0,0,1,1,2
"80219",40109500,1000,0.00263237,0,0,0,0,0
"80220",40110000,1000,0.00269726,0,0,0,0,0
"80221",40110500,1000,0.00276728,0,0,0,0,0
"80222",40111000,1000,0.00270764,0,0,0,0,0
"80223",40111500,1000,0.00275988,0,0,0,0,0
"80224",40112000,1000,0.00273918,0,0,0,1,1
"80225",40112500,1000,0.00262967,0,0,0,2,2
"80226",40113000,1000,0.00263985,0,0,0,1,1
"80227",40113500,1000,0.00265802,0,0,0,0,0
"80228",40114000,1000,0.00275661,0,0,1,2,3
"80229",40114500,1000,0.00286214,0,1,1,3,5
"80230",40115000,1000,0.0028885,0,1,0,1,2
"80231",40115500,1000,0.00280438,0,0,0,2,2
"80232",40116000,1000,0.00268015,0,0,0,4,4
"80233",40116500,1000,0.00261053,0,0,0,2,2
"80234",40117000,1000,0.00274487,0,0,0,3,3
"80235",40117500,1000,0.0029074,0,0,1,4,5
"80236",40118000,1000,0.00276102,0,0,1,1,2
"80237",40118500,1000,0.00260494,0,0,0,0,0
"80238",40119000,1000,0.00282003,0,0,1,3,4
"80239",40119500,1000,0.00288915,0,0,1,3,4
"80240",40120000,1000,0.00268154,0,0,0,0,0
"80241",40120500,1000,0.00267168,0,0,0,1,1
"80242",40121000,1000,0.00266565,0,0,0,1,1
"80243",40121500,1000,0.00243351,0,0,0,0,0
"80244",40122000,1000,0.00228226,0,0,0,0,0
"80245",40122500,1000,0.00232243,0,0,0,0,0
"80246",40123000,1000,0.00243442,0,0,0,0,0
"80247",40123500,1000,0.00260008,0,0,0,0,0
"80248",40124000,1000,0.00256152,0,0,0,0,0
"80249",40124500,1000,0.00260139,0,0,0,0,0
"80250",40125000,1000,0.00262878,0,0,0,0,0
"80251",40125500,1000,0.00264455,0,0,0,1,1
"80252",40126000,1000,0.00268205,0,0,0,1,1
"80253",40126500,1000,0.00266232,0,0,0,1,1
"80254",40127000,1000,0.00272915,0,0,0,2,2
"80255",40127500,1000,0.00282912,0,0,1,2,3
"80256",40128000,1000,0.00273169,0,0,1,1,2
"80257",40128500,1000,0.00279322,0,0,2,1,3
"80258",40129000,1000,0.00279534,0,0,2,1,3
"80259",40129500,1000,0.00259418,0,0,0,0,0
"80260",40130000,1000,0.00259058,0,0,0,0,0
"80261",40130500,1000,0.00260515,0,0,0,0,0
"80262",40131000,1000,0.00262059,0,0,0,0,0
"80263",40131500,1000,0.00263829,0,0,0,0,0
"80264",40132000,1000,0.0027076,0,0,0,0,0
"80265",40132500,1000,0.002595,0,0,0,0,0
"80266",40133000,1000,0.0027608,0,0,1,1,2
"80267",40133500,1000,0.00280416,0,0,1,1,2
"80268",40134000,1000,0.00261642,0,0,0,1,1
"80269",40134500,1000,0.00264221,0,0,0,2,2
"80270",40135000,1000,0.00257326,0,0,0,1,1
"80271",40135500,1000,0.00265114,0,0,0,1,1
"80272",40136000,1000,0.00270703,0,0,0,1,1
"80273",40136500,1000,0.00256423,0,0,0,0,0
"80274",40137000,1000,0.00262403,0,0,1,0,1
"80275",40137500,1000,0.0026791,0,0,2,0,2
"80276",40138000,1000,0.00262788,0,0,1,2,3
"80277",40138500,1000,0.00277208,0,0,1,5,6
"80278",40139000,1000,0.00266107,0,0,1,3,4
"80279",40139500,1000,0.00253916,0,0,0,1,1
"80280",40140000,1000,0.00262231,0,0,0,1,1
"80281",40140500,1000,0.00249096,0,0,0,0,0
"80282",40141000,1000,0.00256357,0,0,0,2,2
"80283",40141500,1000,0.0027843,0,0,0,3,3
"80284",40142000,1000,0.00262174,0,0,0,1,1
"80285",40142500,1000,0.00260194,0,0,1,1,2
"80286",40143000,1000,0.0027874,0,0,2,1,3
"80287",40143500,1000,0.00268737,0,0,1,1,2
"80288",40144000,1000,0.00263799,0,0,0,1,1
"80289",40144500,1000,0.00269808,0,0,0,1,1
"80290",40145000,1000,0.00278269,0,0,1,2,3
"80291",40145500,1000,0.00278649,0,0,2,2,4
"80292",40146000,1000,0.00270521,0,0,1,1,2
"80293",40146500,1000,0.00289904,0,1,0,2,3
"80294",40147000,1000,0.00282359,0,1,0,2,3
"80295",40147500,1000,0.00254715,0,0,0,0,0
"80296",40148000,1000,0.00262953,0,0,1,0,1
"80297",40148500,1000,0.00270117,0,0,1,1,2
"80298",40149000,1000,0.00274735,0,0,0,2,2
"80299",40149500,1000,0.00286355,0,0,2,2,4
"80300",40150000,1000,0.00277789,0,0,2,1,3
"80301",40150500,1000,0.00272211,0,0,1,0,1
"80302",40151000,1000,0.00278586,0,0,1,1,2
"80303",40151500,1000,0.00266711,0,0,0,1,1
"80304",40152000,1000,0.00259523,0,0,0,0,0
"80305",40152500,1000,0.00274178,0,0,1,1,2
"80306",40153000,1000,0.0027493,0,0,1,1,2
"80307",40153500,1000,0.00273332,0,0,0,2,2
"80308",40154000,1000,0.00271129,0,0,0,5,5
"80309",40154500,1000,0.00253438,0,0,0,3,3
"80310",40155000,1000,0.00262301,0,0,1,0,1
"80311",40155500,1000,0.00270548,0,0,1,0,1
"80312",40156000,1000,0.00273154,0,0,1,1,2
"80313",40156500,1000,0.00272868,0,0,1,2,3
"80314",40157000,1000,0.00272472,0,0,1,3,4
"80315",40157500,1000,0.00272626,0,0,1,2,3
"80316",40158000,1000,0.00277124,0,0,0,1,1
"80317",40158500,1000,0.00287487,0,0,1,1,2
"80318",40159000,1000,0.00276214,0,0,1,0,1
"80319",40159500,1000,0.0026427,0,0,0,0,0
"80320",40160000,1000,0.00261582,0,0,0,0,0
"80321",40160500,1000,0.00263235,0,0,1,1,2
"80322",40161000,1000,0.00262785,0,0,1,3,4
"80323",40161500,1000,0.00265988,0,0,0,4,4
"80324",40162000,1000,0.00273998,0,0,0,2,2
"80325",40162500,1000,0.00273279,0,0,0,0,0
"80326",40163000,1000,0.00269544,0,0,0,2,2
"80327",40163500,1000,0.00277375,0,0,0,2,2
"80328",40164000,1000,0.00276425,0,0,0,0,0
"80329",40164500,1000,0.00270721,0,0,0,1,1
"80330",40165000,1000,0.00290331,0,0,2,3,5
"80331",40165500,1000,0.00288707,0,0,2,3,5
"80332",40166000,1000,0.00268493,0,0,0,1,1
"80333",40166500,1000,0.00262207,0,0,0,1,1
"80334",40167000,1000,0.00255008,0,0,0,1,1
"80335",40167500,1000,0.0026365,0,0,0,2,2
"80336",40168000,1000,0.00274195,0,0,0,2,2
"80337",40168500,1000,0.00280785,0,0,0,2,2
"80338",40169000,1000,0.00270488,0,0,0,2,2
"80339",40169500,1000,0.00258942,0,0,0,2,2
"80340",40170000,1000,0.00261057,0,0,0,2,2
"80341",40170500,1000,0.00255876,0,0,0,0,0
"80342",40171000,1000,0.00265434,0,0,0,1,1
"80343",40171500,1000,0.00269926,0,0,0,1,1
"80344",40172000,1000,0.00264776,0,0,0,1,1
"80345",40172500,1000,0.0026323,0,0,0,1,1
"80346",40173000,1000,0.00269559,0,0,0,2,2
"80347",40173500,1000,0.00266983,0,0,0,2,2
"80348",40174000,1000,0.0025991,0,0,0,0,0
"80349",40174500,1000,0.00269853,0,0,0,0,0
"80350",40175000,1000,0.0027068,0,0,1,0,1
"80351",40175500,1000,0.00275838,0,0,1,2,3
"80352",40176000,1000,0.00276668,0,0,0,3,3
"80353",40176500,1000,0.00274773,0,0,0,1,1
"80354",40177000,1000,0.0027125,0,0,0,0,0
"80355",40177500,1000,0.00250589,0,0,0,0,0
"80356",40178000,1000,0.00238369,0,0,0,0,0
"80357",40178500,1000,0.00249841,0,0,0,0,0
"80358",40179000,1000,0.00283336,0,0,1,3,4
"80359",40179500,1000,0.00283964,0,0,1,3,4
"80360",40180000,1000,0.00270748,0,0,0,0,0
"80361",40180500,1000,0.00272094,0,0,0,0,0
"80362",40181000,1000,0.00266893,0,0,0,0,0
"80363",40181500,1000,0.00276439,0,0,0,2,2
"80364",40182000,1000,0.00274622,0,0,0,2,2
"80365",40182500,1000,0.00276835,0,0,1,1,2
"80366",40183000,1000,0.002797,0,0,1,1,2
"80367",40183500,1000,0.00278161,0,0,1,0,1
"80368",40184000,1000,0.00284342,0,0,2,1,3
"80369",40184500,1000,0.00276843,0,0,1,1,2
"80370",40185000,1000,0.00287144,0,0,0,3,3
"80371",40185500,1000,0.00284425,0,0,0,5,5
"80372",40186000,1000,0.00282297,0,0,1,4,5
"80373",40186500,1000,0.0028488,0,0,2,2,4
"80374",40187000,1000,0.00265352,0,0,1,0,1
"80375",40187500,1000,0.00265399,0,0,0,2,2
"80376",40188000,1000,0.00282324,0,0,1,3,4
"80377",40188500,1000,0.00293227,0,1,1,1,3
"80378",40189000,1000,0.00290007,0,1,0,1,2
"80379",40189500,1000,0.00286132,0,0,0,1,1
"80380",40190000,1000,0.00279219,0,0,0,0,0
"80381",40190500,1000,0.00264257,0,0,0,0,0
"80382",40191000,1000,0.00277515,0,1,0,0,1
"80383",40191500,1000,0.00279823,0,1,0,1,2
"80384",40192000,1000,0.00260125,0,0,0,1,1
"80385",40192500,1000,0.00268509,0,0,0,0,0
"80386",40193000,1000,0.00278542,0,0,0,0,0
"80387",40193500,1000,0.00293684,0,0,1,0,1
"80388",40194000,1000,0.00293773,0,0,1,1,2
"80389",40194500,1000,0.00264479,0,0,0,1,1
"80390",40195000,1000,0.00254085,0,0,0,0,0
"80391",40195500,1000,0.00265803,0,0,0,0,0
"80392",40196000,1000,0.00267457,0,0,0,0,0
"80393",40196500,1000,0.00282419,0,0,1,2,3
"80394",40197000,1000,0.00292301,0,0,1,4,5
"80395",40197500,1000,0.00267936,0,0,0,2,2
"80396",40198000,1000,0.0025707,0,0,0,0,0
"80397",40198500,1000,0.00274093,0,0,0,2,2
"80398",40199000,1000,0.00287856,0,0,0,3,3
"80399",40199500,1000,0.00273057,0,0,0,2,2
"80400",40200000,1000,0.00271007,0,0,1,2,3
"80401",40200500,1000,0.00276359,0,0,1,1,2
"80402",40201000,1000,0.00279018,0,1,0,0,1
"80403",40201500,1000,0.0028294,0,1,0,2,3
"80404",40202000,1000,0.00272051,0,0,0,3,3
"80405",40202500,1000,0.00277307,0,0,1,2,3
"80406",40203000,1000,0.0027336,0,0,1,2,3
"80407",40203500,1000,0.00268947,0,0,0,3,3
"80408",40204000,1000,0.00275837,0,0,0,3,3
"80409",40204500,1000,0.00268272,0,0,0,2,2
"80410",40205000,1000,0.00279019,0,0,1,4,5
"80411",40205500,1000,0.00286963,0,0,1,5,6
"80412",40206000,1000,0.00286773,0,0,1,2,3
"80413",40206500,1000,0.00281633,0,0,1,1,2
"80414",40207000,1000,0.00263817,0,0,0,1,1
"80415",40207500,1000,0.00274707,0,0,1,1,2
"80416",40208000,1000,0.00285454,0,0,1,2,3
"80417",40208500,1000,0.00270636,0,0,0,2,2
"80418",40209000,1000,0.00267098,0,0,0,3,3
"80419",40209500,1000,0.00279411,0,0,0,3,3
"80420",40210000,1000,0.00275922,0,0,0,1,1
"80421",40210500,1000,0.00270331,0,0,0,1,1
"80422",40211000,1000,0.002697,0,0,0,1,1
"80423",40211500,1000,0.00262519,0,0,0,1,1
"80424",40212000,1000,0.00266456,0,0,0,3,3
"80425",40212500,1000,0.0026913,0,0,0,3,3
"80426",40213000,1000,0.00270957,0,0,1,2,3
"80427",40213500,1000,0.00297794,0,0,3,3,6
"80428",40214000,1000,0.00300844,0,0,2,6,8
"80429",40214500,1000,0.00284025,0,0,1,4,5
"80430",40215000,1000,0.00298135,0,0,2,2,4
"80431",40215500,1000,0.00286032,0,0,1,3,4
"80432",40216000,1000,0.00262127,0,0,0,2,2
"80433",40216500,1000,0.00268261,0,0,1,1,2
"80434",40217000,1000,0.00268834,0,0,1,0,1
"80435",40217500,1000,0.00270284,0,0,0,0,0
"80436",40218000,1000,0.00270129,0,0,0,0,0
"80437",40218500,1000,0.00262768,0,0,0,0,0
"80438",40219000,1000,0.00248781,0,0,0,0,0
"80439",40219500,1000,0.00246506,0,0,0,2,2
"80440",40220000,1000,0.00261344,0,0,0,2,2
"80441",40220500,1000,0.00262395,0,0,0,1,1
"80442",40221000,1000,0.00260578,0,0,1,1,2
"80443",40221500,1000,0.00265827,0,0,1,1,2
"80444",40222000,1000,0.00278157,0,0,1,2,3
"80445",40222500,1000,0.00283202,0,0,1,2,3
"80446",40223000,1000,0.00267968,0,0,0,1,1
"80447",40223500,1000,0.00267211,0,0,1,0,1
"80448",40224000,1000,0.00274308,0,0,1,1,2
"80449",40224500,1000,0.00266976,0,0,0,1,1
"80450",40225000,1000,0.00256517,0,0,0,0,0
"80451",40225500,1000,0.0025194,0,0,0,0,0
"80452",40226000,1000,0.00264694,0,0,1,1,2
"80453",40226500,1000,0.0027979,0,0,1,3,4
"80454",40227000,1000,0.00277168,0,0,0,4,4
"80455",40227500,1000,0.00272289,0,0,1,2,3
"80456",40228000,1000,0.00273511,0,0,2,1,3
"80457",40228500,1000,0.00272816,0,0,1,1,2
"80458",40229000,1000,0.00280993,0,0,1,1,2
"80459",40229500,1000,0.00285582,0,0,2,1,3
"80460",40230000,1000,0.0029034,0,0,2,0,2
"80461",40230500,1000,0.00266902,0,0,1,0,1
"80462",40231000,1000,0.00251163,0,0,0,0,0
"80463",40231500,1000,0.0026528,0,0,0,2,2
"80464",40232000,1000,0.00270399,0,0,0,5,5
"80465",40232500,1000,0.00275927,0,0,0,4,4
"80466",40233000,1000,0.00276526,0,0,1,2,3
"80467",40233500,1000,0.00275344,0,0,1,1,2
"80468",40234000,1000,0.00270859,0,0,0,1,1
"80469",40234500,1000,0.00263725,0,0,0,1,1
"80470",40235000,1000,0.00250096,0,0,0,0,0
"80471",40235500,1000,0.00261233,0,0,0,0,0
"80472",40236000,1000,0.00278564,0,0,1,1,2
"80473",40236500,1000,0.00269323,0,0,1,3,4
"80474",40237000,1000,0.00265059,0,0,0,4,4
"80475",40237500,1000,0.00259387,0,0,0,3,3
"80476",40238000,1000,0.0026539,0,0,0,3,3
"80477",40238500,1000,0.00285168,0,0,0,6,6
"80478",40239000,1000,0.00282071,0,0,1,6,7
"80479",40239500,1000,0.00272901,0,0,1,4,5
"80480",40240000,1000,0.00273014,0,0,0,2,2
"80481",40240500,1000,0.00278822,0,0,1,1,2
"80482",40241000,1000,0.00272817,0,0,1,1,2
"80483",40241500,1000,0.00258016,0,0,0,0,0
"80484",40242000,1000,0.00274583,0,0,0,1,1
"80485",40242500,1000,0.00286433,0,0,0,3,3
"80486",40243000,1000,0.00262834,0,0,0,2,2
"80487",40243500,1000,0.0025729,0,0,0,1,1
"80488",40244000,1000,0.00277141,0,0,0,3,3
"80489",40244500,1000,0.00279619,0,0,0,2,2
"80490",40245000,1000,0.0027027,0,0,0,0,0
"80491",40245500,1000,0.00267726,0,0,0,2,2
"80492",40246000,1000,0.00268254,0,0,0,3,3
"80493",40246500,1000,0.00269576,0,0,0,3,3
"80494",40247000,1000,0.00272288,0,0,1,2,3
"80495",40247500,1000,0.00276836,0,0,1,3,4
"80496",40248000,1000,0.00267001,0,0,0,4,4
"80497",40248500,1000,0.0025325,0,0,0,1,1
"80498",40249000,1000,0.00251495,0,0,0,0,0
"80499",40249500,1000,0.00268436,0,0,0,2,2
"80500",40250000,1000,0.00294718,0,0,1,6,7
"80501",40250500,1000,0.00282866,0,0,1,4,5
"80502",40251000,1000,0.00267927,0,0,0,3,3
"80503",40251500,1000,0.00269386,0,0,0,3,3
"80504",40252000,1000,0.00272116,0,0,0,2,2
"80505",40252500,1000,0.00271441,0,0,0,3,3
"80506",40253000,1000,0.00269321,0,0,1,2,3
"80507",40253500,1000,0.00265714,0,0,1,1,2
"80508",40254000,1000,0.00256514,0,0,0,1,1
"80509",40254500,1000,0.0027579,0,0,1,2,3
"80510",40255000,1000,0.00277209,0,0,1,1,2
"80511",40255500,1000,0.00263924,0,0,0,1,1
"80512",40256000,1000,0.00268348,0,0,0,1,1
"80513",40256500,1000,0.00261679,0,0,0,0,0
"80514",40257000,1000,0.00269526,0,0,0,2,2
"80515",40257500,1000,0.00272039,0,0,0,2,2
"80516",40258000,1000,0.00273427,0,0,0,2,2
"80517",40258500,1000,0.00273718,0,0,0,2,2
"80518",40259000,1000,0.00259387,0,0,0,0,0
"80519",40259500,1000,0.00256255,0,0,0,0,0
"80520",40260000,1000,0.0026085,0,0,0,1,1
"80521",40260500,1000,0.00271764,0,0,0,2,2
"80522",40261000,1000,0.00267284,0,0,0,2,2
"80523",40261500,1000,0.00290458,0,0,3,2,5
"80524",40262000,1000,0.00292948,0,0,3,2,5
"80525",40262500,1000,0.00263896,0,0,0,1,1
"80526",40263000,1000,0.00266871,0,0,0,1,1
"80527",40263500,1000,0.00261206,0,0,0,2,2
"80528",40264000,1000,0.00261454,0,0,0,1,1
"80529",40264500,1000,0.00274671,0,0,0,0,0
"80530",40265000,1000,0.00272147,0,0,0,0,0
"80531",40265500,1000,0.00267697,0,0,0,0,0
"80532",40266000,1000,0.00267412,0,0,0,0,0
"80533",40266500,1000,0.0026222,0,0,0,0,0
"80534",40267000,1000,0.00262684,0,0,0,0,0
"80535",40267500,1000,0.00269485,0,0,0,3,3
"80536",40268000,1000,0.00278062,0,0,1,3,4
"80537",40268500,1000,0.00271966,0,0,1,0,1
"80538",40269000,1000,0.00264059,0,0,0,2,2
"80539",40269500,1000,0.00262584,0,0,0,4,4
"80540",40270000,1000,0.00271371,0,0,0,4,4
"80541",40270500,1000,0.00280883,0,0,0,3,3
"80542",40271000,1000,0.00267627,0,0,0,1,1
"80543",40271500,1000,0.00253797,0,0,0,0,0
"80544",40272000,1000,0.00260862,0,0,0,1,1
"80545",40272500,1000,0.00273978,0,0,0,3,3
"80546",40273000,1000,0.00276304,0,0,0,3,3
"80547",40273500,1000,0.00273343,0,0,0,1,1
"80548",40274000,1000,0.00273296,0,0,1,0,1
"80549",40274500,1000,0.00260786,0,0,1,0,1
"80550",40275000,1000,0.00255239,0,0,0,2,2
"80551",40275500,1000,0.00261474,0,0,0,3,3
"80552",40276000,1000,0.00268221,0,0,0,3,3
"80553",40276500,1000,0.00270689,0,0,0,2,2
"80554",40277000,1000,0.00282841,0,1,0,0,1
"80555",40277500,1000,0.00285555,0,1,0,2,3
"80556",40278000,1000,0.00284011,0,0,1,2,3
"80557",40278500,1000,0.00273587,0,0,1,0,1
"80558",40279000,1000,0.00254305,0,0,0,0,0
"80559",40279500,1000,0.00262271,0,0,0,0,0
"80560",40280000,1000,0.0027124,0,0,1,0,1
"80561",40280500,1000,0.0027007,0,0,1,0,1
"80562",40281000,1000,0.00266433,0,0,0,1,1
"80563",40281500,1000,0.00270401,0,0,0,1,1
"80564",40282000,1000,0.00260109,0,0,0,0,0
"80565",40282500,1000,0.00261183,0,0,0,2,2
"80566",40283000,1000,0.00261281,0,0,0,2,2
"80567",40283500,1000,0.00259933,0,0,0,0,0
"80568",40284000,1000,0.00274699,0,0,1,0,1
"80569",40284500,1000,0.0028478,0,0,1,2,3
"80570",40285000,1000,0.00279721,0,0,0,3,3
"80571",40285500,1000,0.00280254,0,1,0,2,3
"80572",40286000,1000,0.00271839,0,1,0,2,3
"80573",40286500,1000,0.0025838,0,0,0,1,1
"80574",40287000,1000,0.00264855,0,0,0,1,1
"80575",40287500,1000,0.00263716,0,0,0,1,1
"80576",40288000,1000,0.00259852,0,0,0,0,0
"80577",40288500,1000,0.00265948,0,0,1,1,2
"80578",40289000,1000,0.00260932,0,0,1,1,2
"80579",40289500,1000,0.002721,0,1,0,0,1
"80580",40290000,1000,0.00288653,0,2,0,0,2
"80581",40290500,1000,0.00268602,0,1,0,0,1
"80582",40291000,1000,0.00272024,0,0,1,0,1
"80583",40291500,1000,0.00277337,0,0,1,1,2
"80584",40292000,1000,0.00266397,0,0,0,3,3
"80585",40292500,1000,0.00275281,0,0,0,3,3
"80586",40293000,1000,0.0028024,0,0,0,3,3
"80587",40293500,1000,0.00277829,0,0,0,4,4
"80588",40294000,1000,0.00267424,0,0,0,3,3
"80589",40294500,1000,0.00269312,0,0,1,2,3
"80590",40295000,1000,0.00271333,0,0,1,1,2
"80591",40295500,1000,0.00270021,0,0,0,0,0
"80592",40296000,1000,0.00267125,0,0,0,0,0
"80593",40296500,1000,0.00259352,0,0,0,1,1
"80594",40297000,1000,0.00263781,0,0,0,1,1
"80595",40297500,1000,0.00270367,0,0,0,0,0
"80596",40298000,1000,0.00261353,0,0,0,0,0
"80597",40298500,1000,0.00255189,0,0,0,1,1
"80598",40299000,1000,0.00260324,0,0,0,1,1
"80599",40299500,1000,0.00263075,0,0,0,2,2
"80600",40300000,1000,0.00278959,0,0,1,3,4
"80601",40300500,1000,0.00279477,0,0,1,2,3
"80602",40301000,1000,0.00277055,0,1,0,1,2
"80603",40301500,1000,0.00267244,0,1,0,0,1
"80604",40302000,1000,0.00262377,0,0,0,0,0
"80605",40302500,1000,0.00269787,0,0,0,1,1
"80606",40303000,1000,0.0025549,0,0,0,1,1
"80607",40303500,1000,0.00254505,0,0,0,0,0
"80608",40304000,1000,0.0026682,0,0,0,1,1
"80609",40304500,1000,0.00276859,0,0,0,3,3
"80610",40305000,1000,0.00271846,0,0,0,3,3
"80611",40305500,1000,0.00253896,0,0,0,1,1
"80612",40306000,1000,0.00255467,0,0,1,0,1
"80613",40306500,1000,0.0025913,0,0,1,0,1
"80614",40307000,1000,0.00257464,0,0,0,0,0
"80615",40307500,1000,0.00276251,0,0,0,1,1
"80616",40308000,1000,0.00300272,0,1,0,2,3
"80617",40308500,1000,0.00303225,0,2,0,2,4
"80618",40309000,1000,0.00279214,0,1,0,1,2
"80619",40309500,1000,0.00264316,0,0,0,0,0
"80620",40310000,1000,0.00279517,0,0,1,0,1
"80621",40310500,1000,0.00285126,0,1,1,0,2
"80622",40311000,1000,0.00277264,0,1,0,0,1
"80623",40311500,1000,0.00275947,0,0,0,1,1
"80624",40312000,1000,0.0028224,0,1,0,1,2
"80625",40312500,1000,0.00272996,0,1,0,0,1
"80626",40313000,1000,0.0027269,0,0,1,0,1
"80627",40313500,1000,0.00279456,0,0,1,0,1
"80628",40314000,1000,0.0027765,0,0,0,0,0
"80629",40314500,1000,0.00270797,0,0,0,0,0
"80630",40315000,1000,0.00260343,0,0,0,1,1
"80631",40315500,1000,0.00270677,0,0,0,2,2
"80632",40316000,1000,0.00283934,0,0,0,2,2
"80633",40316500,1000,0.00263431,0,0,0,1,1
"80634",40317000,1000,0.0025899,0,0,0,0,0
"80635",40317500,1000,0.00286306,0,0,1,0,1
"80636",40318000,1000,0.0027213,0,0,1,0,1
"80637",40318500,1000,0.0025015,0,0,0,0,0
"80638",40319000,1000,0.00252032,0,0,0,0,0
"80639",40319500,1000,0.00256142,0,0,0,0,0
"80640",40320000,1000,0.00266253,0,0,0,2,2
"80641",40320500,1000,0.0026898,0,0,0,2,2
"80642",40321000,1000,0.00262608,0,0,0,0,0
"80643",40321500,1000,0.00269094,0,0,0,1,1
"80644",40322000,1000,0.00273969,0,0,1,1,2
"80645",40322500,1000,0.00267435,0,0,1,0,1
"80646",40323000,1000,0.00266451,0,0,0,0,0
"80647",40323500,1000,0.00264946,0,0,0,1,1
"80648",40324000,1000,0.00262119,0,0,0,1,1
"80649",40324500,1000,0.00266263,0,0,0,0,0
"80650",40325000,1000,0.00260606,0,0,0,1,1
"80651",40325500,1000,0.00267693,0,0,1,1,2
"80652",40326000,1000,0.00282807,0,0,2,0,2
"80653",40326500,1000,0.00277117,0,0,1,0,1
"80654",40327000,1000,0.00263636,0,0,0,0,0
"80655",40327500,1000,0.0026764,0,0,0,1,1
"80656",40328000,1000,0.0027172,0,0,0,1,1
"80657",40328500,1000,0.00265021,0,0,0,0,0
"80658",40329000,1000,0.00268363,0,0,0,0,0
"80659",40329500,1000,0.00277936,0,0,0,3,3
"80660",40330000,1000,0.00287731,0,0,1,3,4
"80661",40330500,1000,0.00287368,0,0,1,1,2
"80662",40331000,1000,0.00276596,0,0,0,1,1
"80663",40331500,1000,0.00263514,0,0,0,0,0
"80664",40332000,1000,0.00263258,0,0,0,2,2
"80665",40332500,1000,0.00270568,0,0,0,2,2
"80666",40333000,1000,0.00269171,0,0,0,2,2
"80667",40333500,1000,0.00276158,0,0,0,5,5
"80668",40334000,1000,0.0028325,0,0,1,3,4
"80669",40334500,1000,0.00285022,0,1,1,0,2
"80670",40335000,1000,0.00285619,0,1,0,3,4
"80671",40335500,1000,0.00265716,0,0,0,3,3
"80672",40336000,1000,0.00267044,0,0,0,2,2
"80673",40336500,1000,0.00289711,0,0,2,3,5
"80674",40337000,1000,0.00279312,0,0,2,1,3
"80675",40337500,1000,0.00266155,0,0,0,0,0
"80676",40338000,1000,0.00270285,0,0,0,0,0
"80677",40338500,1000,0.00270212,0,0,0,1,1
"80678",40339000,1000,0.00269318,0,0,0,2,2
"80679",40339500,1000,0.00266064,0,0,0,1,1
"80680",40340000,1000,0.00256295,0,0,0,0,0
"80681",40340500,1000,0.00260047,0,0,0,0,0
"80682",40341000,1000,0.00262423,0,0,0,0,0
"80683",40341500,1000,0.00257938,0,0,0,0,0
"80684",40342000,1000,0.00253404,0,0,0,0,0
"80685",40342500,1000,0.0024928,0,0,0,0,0
"80686",40343000,1000,0.0026056,0,0,0,1,1
"80687",40343500,1000,0.00263847,0,0,0,1,1
"80688",40344000,1000,0.00270287,0,0,0,0,0
"80689",40344500,1000,0.00280691,0,0,0,0,0
"80690",40345000,1000,0.00270006,0,0,0,0,0
"80691",40345500,1000,0.00266882,0,0,0,0,0
"80692",40346000,1000,0.00275364,0,0,1,0,1
"80693",40346500,1000,0.00272541,0,0,1,1,2
"80694",40347000,1000,0.00264517,0,0,0,1,1
"80695",40347500,1000,0.0025675,0,0,0,0,0
"80696",40348000,1000,0.00266978,0,0,0,0,0
"80697",40348500,1000,0.00287222,0,0,1,0,1
"80698",40349000,1000,0.00284535,0,0,1,0,1
"80699",40349500,1000,0.00282549,0,0,0,0,0
"80700",40350000,1000,0.00268712,0,0,0,0,0
"80701",40350500,1000,0.00249758,0,0,0,0,0
"80702",40351000,1000,0.0024745,0,0,0,0,0
"80703",40351500,1000,0.00271589,0,0,1,0,1
"80704",40352000,1000,0.0030059,0,0,2,1,3
"80705",40352500,1000,0.00291316,0,0,1,3,4
"80706",40353000,1000,0.00277438,0,0,0,2,2
"80707",40353500,1000,0.00286181,0,0,2,0,2
"80708",40354000,1000,0.00309924,0,1,2,0,3
"80709",40354500,1000,0.00298182,0,1,0,0,1
"80710",40355000,1000,0.00277556,0,0,0,0,0
"80711",40355500,1000,0.00273556,0,0,0,0,0
"80712",40356000,1000,0.00266166,0,0,0,0,0
"80713",40356500,1000,0.00261448,0,0,0,0,0
"80714",40357000,1000,0.00256288,0,0,0,1,1
"80715",40357500,1000,0.00257632,0,0,0,1,1
"80716",40358000,1000,0.00262841,0,0,0,1,1
"80717",40358500,1000,0.0025547,0,0,0,1,1
"80718",40359000,1000,0.00260819,0,0,1,1,2
"80719",40359500,1000,0.00278023,0,0,1,3,4
"80720",40360000,1000,0.00274875,0,0,0,2,2
"80721",40360500,1000,0.00262973,0,0,0,0,0
"80722",40361000,1000,0.00262436,0,0,0,0,0
"80723",40361500,1000,0.00260631,0,0,0,0,0
"80724",40362000,1000,0.00268474,0,0,0,1,1
"80725",40362500,1000,0.00269726,0,0,0,1,1
"80726",40363000,1000,0.00260821,0,0,1,0,1
"80727",40363500,1000,0.0027392,0,0,1,1,2
"80728",40364000,1000,0.00275438,0,0,0,1,1
"80729",40364500,1000,0.00258163,0,0,0,0,0
"80730",40365000,1000,0.00248082,0,0,0,0,0
"80731",40365500,1000,0.00264398,0,0,1,0,1
"80732",40366000,1000,0.00287565,0,1,1,0,2
"80733",40366500,1000,0.00289104,0,1,0,0,1
"80734",40367000,1000,0.00273659,0,0,0,0,0
"80735",40367500,1000,0.00277416,0,0,1,1,2
"80736",40368000,1000,0.00276044,0,0,1,1,2
"80737",40368500,1000,0.00274698,0,0,1,1,2
"80738",40369000,1000,0.00271058,0,0,1,1,2
"80739",40369500,1000,0.00276677,0,0,1,2,3
"80740",40370000,1000,0.00285392,0,0,2,2,4
"80741",40370500,1000,0.0026883,0,0,1,2,3
"80742",40371000,1000,0.00273483,0,0,1,3,4
"80743",40371500,1000,0.00269161,0,0,1,1,2
"80744",40372000,1000,0.00280387,0,0,0,2,2
"80745",40372500,1000,0.00294086,0,0,0,2,2
"80746",40373000,1000,0.00273302,0,0,0,1,1
"80747",40373500,1000,0.00272158,0,0,0,3,3
"80748",40374000,1000,0.00276044,0,0,0,3,3
"80749",40374500,1000,0.00277916,0,0,0,2,2
"80750",40375000,1000,0.0027321,0,0,0,1,1
"80751",40375500,1000,0.00264216,0,0,0,2,2
"80752",40376000,1000,0.00266077,0,0,0,2,2
"80753",40376500,1000,0.00266565,0,0,0,0,0
"80754",40377000,1000,0.00272726,0,0,0,0,0
"80755",40377500,1000,0.00268226,0,0,0,1,1
"80756",40378000,1000,0.00264632,0,0,1,1,2
"80757",40378500,1000,0.00268697,0,0,1,1,2
"80758",40379000,1000,0.00267417,0,0,0,1,1
"80759",40379500,1000,0.00279847,0,1,0,1,2
"80760",40380000,1000,0.00279904,0,1,0,2,3
"80761",40380500,1000,0.00280567,0,0,0,3,3
"80762",40381000,1000,0.00288169,0,0,0,3,3
"80763",40381500,1000,0.00281547,0,0,0,2,2
"80764",40382000,1000,0.00283745,0,0,1,1,2
"80765",40382500,1000,0.00290067,0,0,1,2,3
"80766",40383000,1000,0.00283385,0,0,0,4,4
"80767",40383500,1000,0.00269785,0,0,0,2,2
"80768",40384000,1000,0.00275641,0,1,0,0,1
"80769",40384500,1000,0.00268803,0,1,0,0,1
"80770",40385000,1000,0.00270141,0,0,1,1,2
"80771",40385500,1000,0.00284767,0,1,1,1,3
"80772",40386000,1000,0.00271309,0,1,1,0,2
"80773",40386500,1000,0.00268118,0,0,1,1,2
"80774",40387000,1000,0.0029328,0,0,1,4,5
"80775",40387500,1000,0.00283077,0,0,1,3,4
"80776",40388000,1000,0.00259891,0,0,0,0,0
"80777",40388500,1000,0.00263645,0,0,1,0,1
"80778",40389000,1000,0.00265734,0,0,1,0,1
"80779",40389500,1000,0.00261357,0,0,0,0,0
"80780",40390000,1000,0.0027471,0,0,0,3,3
"80781",40390500,1000,0.00283517,0,0,1,3,4
"80782",40391000,1000,0.00264417,0,0,1,0,1
"80783",40391500,1000,0.00255588,0,0,0,0,0
"80784",40392000,1000,0.00250225,0,0,0,0,0
"80785",40392500,1000,0.00250677,0,0,0,0,0
"80786",40393000,1000,0.00258334,0,0,0,0,0
"80787",40393500,1000,0.00268942,0,0,0,3,3
"80788",40394000,1000,0.00269156,0,0,0,4,4
"80789",40394500,1000,0.00261418,0,0,0,3,3
"80790",40395000,1000,0.00278608,0,0,0,4,4
"80791",40395500,1000,0.00292156,0,0,1,3,4
"80792",40396000,1000,0.00278619,0,0,1,2,3
"80793",40396500,1000,0.00257406,0,0,0,1,1
"80794",40397000,1000,0.00253368,0,0,0,1,1
"80795",40397500,1000,0.00269841,0,0,1,1,2
"80796",40398000,1000,0.00275129,0,0,1,2,3
"80797",40398500,1000,0.00257215,0,0,0,2,2
"80798",40399000,1000,0.00246155,0,0,0,0,0
"80799",40399500,1000,0.00249738,0,0,0,0,0
"80800",40400000,1000,0.00253706,0,0,0,0,0
"80801",40400500,1000,0.00250065,0,0,0,0,0
"80802",40401000,1000,0.00260511,0,0,0,2,2
"80803",40401500,1000,0.00273417,0,0,0,2,2
"80804",40402000,1000,0.00268052,0,0,0,0,0
"80805",40402500,1000,0.00265254,0,0,0,1,1
"80806",40403000,1000,0.00254476,0,0,0,1,1
"80807",40403500,1000,0.00246068,0,0,0,0,0
"80808",40404000,1000,0.00265117,0,1,0,0,1
"80809",40404500,1000,0.00269767,0,1,1,0,2
"80810",40405000,1000,0.002602,0,0,1,0,1
"80811",40405500,1000,0.00276382,0,0,0,2,2
"80812",40406000,1000,0.0027151,0,0,0,2,2
"80813",40406500,1000,0.00256877,0,0,0,0,0
"80814",40407000,1000,0.00263145,0,0,1,1,2
"80815",40407500,1000,0.00260036,0,0,1,1,2
"80816",40408000,1000,0.00258789,0,0,1,0,1
"80817",40408500,1000,0.00270791,0,0,1,2,3
"80818",40409000,1000,0.00263671,0,0,0,2,2
"80819",40409500,1000,0.00264916,0,0,0,3,3
"80820",40410000,1000,0.00262687,0,0,0,3,3
"80821",40410500,1000,0.00246026,0,0,0,0,0
"80822",40411000,1000,0.00259012,0,0,0,0,0
"80823",40411500,1000,0.0026148,0,0,0,1,1
"80824",40412000,1000,0.00255632,0,0,0,3,3
"80825",40412500,1000,0.00254975,0,0,0,2,2
"80826",40413000,1000,0.00246235,0,0,0,0,0
"80827",40413500,1000,0.00253855,0,0,0,0,0
"80828",40414000,1000,0.00272296,0,0,0,2,2
"80829",40414500,1000,0.00279,0,0,1,3,4
"80830",40415000,1000,0.00272252,0,0,1,3,4
"80831",40415500,1000,0.00257764,0,0,0,2,2
"80832",40416000,1000,0.00250807,0,0,0,0,0
"80833",40416500,1000,0.0027032,0,1,0,0,1
"80834",40417000,1000,0.0026745,0,1,0,0,1
"80835",40417500,1000,0.00254894,0,0,0,0,0
"80836",40418000,1000,0.00255713,0,0,0,0,0
"80837",40418500,1000,0.00256578,0,0,0,2,2
"80838",40419000,1000,0.0026378,0,0,0,3,3
"80839",40419500,1000,0.00265423,0,0,1,1,2
"80840",40420000,1000,0.00273666,0,0,1,1,2
"80841",40420500,1000,0.00275264,0,0,0,1,1
"80842",40421000,1000,0.00274762,0,0,1,1,2
"80843",40421500,1000,0.00270827,0,0,1,1,2
"80844",40422000,1000,0.00271388,0,0,0,2,2
"80845",40422500,1000,0.00283589,0,0,1,2,3
"80846",40423000,1000,0.00270603,0,0,1,0,1
"80847",40423500,1000,0.00254532,0,0,0,0,0
"80848",40424000,1000,0.00259211,0,0,1,0,1
"80849",40424500,1000,0.0026439,0,0,1,2,3
"80850",40425000,1000,0.00280868,0,0,1,3,4
"80851",40425500,1000,0.00280454,0,0,1,1,2
"80852",40426000,1000,0.00264203,0,0,0,0,0
"80853",40426500,1000,0.00261702,0,0,0,1,1
"80854",40427000,1000,0.00266836,0,0,0,2,2
"80855",40427500,1000,0.00280319,0,1,0,1,2
"80856",40428000,1000,0.00277893,0,1,0,0,1
"80857",40428500,1000,0.00280635,0,0,1,3,4
"80858",40429000,1000,0.00283298,0,0,1,3,4
"80859",40429500,1000,0.00266508,0,0,0,0,0
"80860",40430000,1000,0.00273594,0,0,1,0,1
"80861",40430500,1000,0.00284636,0,0,1,0,1
"80862",40431000,1000,0.0027776,0,0,0,0,0
"80863",40431500,1000,0.00277781,0,0,0,0,0
"80864",40432000,1000,0.00305905,0,1,1,0,2
"80865",40432500,1000,0.00297751,0,1,1,0,2
"80866",40433000,1000,0.00268371,0,0,0,0,0
"80867",40433500,1000,0.00275392,0,0,1,0,1
"80868",40434000,1000,0.00262088,0,0,1,0,1
"80869",40434500,1000,0.00247958,0,0,0,0,0
"80870",40435000,1000,0.0027914,0,0,1,2,3
"80871",40435500,1000,0.00283133,0,0,1,2,3
"80872",40436000,1000,0.00253197,0,0,0,0,0
"80873",40436500,1000,0.00261045,0,0,0,0,0
"80874",40437000,1000,0.0026785,0,0,0,0,0
"80875",40437500,1000,0.00270065,0,0,0,0,0
"80876",40438000,1000,0.00282172,0,0,1,0,1
"80877",40438500,1000,0.00275801,0,0,1,1,2
"80878",40439000,1000,0.00271868,0,0,1,1,2
"80879",40439500,1000,0.00290466,0,0,2,1,3
"80880",40440000,1000,0.00288696,0,0,1,1,2
"80881",40440500,1000,0.0028315,0,0,1,2,3
"80882",40441000,1000,0.00277089,0,0,1,2,3
"80883",40441500,1000,0.00262617,0,0,0,2,2
"80884",40442000,1000,0.00283147,0,1,0,3,4
"80885",40442500,1000,0.00283506,0,1,0,1,2
"80886",40443000,1000,0.00250102,0,0,0,0,0
"80887",40443500,1000,0.00235505,0,0,0,0,0
"80888",40444000,1000,0.00247116,0,0,0,0,0
"80889",40444500,1000,0.00281919,0,1,0,0,1
"80890",40445000,1000,0.00296643,0,1,0,0,1
"80891",40445500,1000,0.00282348,0,0,0,1,1
"80892",40446000,1000,0.00279495,0,0,0,4,4
"80893",40446500,1000,0.00275846,0,0,0,4,4
"80894",40447000,1000,0.00266417,0,0,0,1,1
"80895",40447500,1000,0.0026364,0,0,0,0,0
"80896",40448000,1000,0.002762,0,0,1,0,1
"80897",40448500,1000,0.00285356,0,0,1,0,1
"80898",40449000,1000,0.00271443,0,0,0,1,1
"80899",40449500,1000,0.00272032,0,0,1,2,3
"80900",40450000,1000,0.00280161,0,0,1,4,5
"80901",40450500,1000,0.00273182,0,0,0,3,3
"80902",40451000,1000,0.00262326,0,0,0,0,0
"80903",40451500,1000,0.00251421,0,0,0,0,0
"80904",40452000,1000,0.00262727,0,0,0,1,1
"80905",40452500,1000,0.00284997,0,0,0,4,4
"80906",40453000,1000,0.00283616,0,0,0,4,4
"80907",40453500,1000,0.00273097,0,0,0,1,1
"80908",40454000,1000,0.00273895,0,0,0,0,0
"80909",40454500,1000,0.00279042,0,0,0,1,1
"80910",40455000,1000,0.00263661,0,0,0,1,1
"80911",40455500,1000,0.00273363,0,1,1,0,2
"80912",40456000,1000,0.00284365,0,1,1,0,2
"80913",40456500,1000,0.00276574,0,0,0,0,0
"80914",40457000,1000,0.00279625,0,0,0,0,0
"80915",40457500,1000,0.00273665,0,0,0,0,0
"80916",40458000,1000,0.00270626,0,0,0,0,0
"80917",40458500,1000,0.00267887,0,0,0,0,0
"80918",40459000,1000,0.00267527,0,0,0,0,0
"80919",40459500,1000,0.00263478,0,0,0,0,0
"80920",40460000,1000,0.00278339,0,1,0,0,1
"80921",40460500,1000,0.00275401,0,1,0,0,1
"80922",40461000,1000,0.00265034,0,0,0,1,1
"80923",40461500,1000,0.00269856,0,0,0,1,1
"80924",40462000,1000,0.00278767,0,0,0,1,1
"80925",40462500,1000,0.00269414,0,0,0,1,1
"80926",40463000,1000,0.00250152,0,0,0,0,0
"80927",40463500,1000,0.00257477,0,0,0,1,1
"80928",40464000,1000,0.00271016,0,0,1,1,2
"80929",40464500,1000,0.00277555,0,0,1,0,1
"80930",40465000,1000,0.00269875,0,0,0,0,0
"80931",40465500,1000,0.00270809,0,0,0,1,1
"80932",40466000,1000,0.0028877,0,1,0,1,2
"80933",40466500,1000,0.00287745,0,1,0,0,1
"80934",40467000,1000,0.00273492,0,0,0,2,2
"80935",40467500,1000,0.00273901,0,0,1,2,3
"80936",40468000,1000,0.00294938,0,0,3,2,5
"80937",40468500,1000,0.00287021,0,0,2,2,4
"80938",40469000,1000,0.00273849,0,0,1,2,3
"80939",40469500,1000,0.00289606,0,1,1,2,4
"80940",40470000,1000,0.00307442,0,2,0,1,3
"80941",40470500,1000,0.00299294,0,1,0,2,3
"80942",40471000,1000,0.00266021,0,0,0,1,1
"80943",40471500,1000,0.00262743,0,0,0,0,0
"80944",40472000,1000,0.00260933,0,0,0,1,1
"80945",40472500,1000,0.00266212,0,0,0,1,1
"80946",40473000,1000,0.00275482,0,0,0,0,0
"80947",40473500,1000,0.00265537,0,0,0,0,0
"80948",40474000,1000,0.00260295,0,0,0,0,0
"80949",40474500,1000,0.00277358,0,0,0,3,3
"80950",40475000,1000,0.00278415,0,0,0,4,4
"80951",40475500,1000,0.00278074,0,0,1,1,2
"80952",40476000,1000,0.00273844,0,0,1,0,1
"80953",40476500,1000,0.00261286,0,0,0,1,1
"80954",40477000,1000,0.00267231,0,0,0,1,1
"80955",40477500,1000,0.00281701,0,0,0,0,0
"80956",40478000,1000,0.00279639,0,0,0,0,0
"80957",40478500,1000,0.00265182,0,0,0,0,0
"80958",40479000,1000,0.00270946,0,0,1,1,2
"80959",40479500,1000,0.00300783,0,1,1,2,4
"80960",40480000,1000,0.00293889,0,1,0,1,2
"80961",40480500,1000,0.0026319,0,0,0,0,0
"80962",40481000,1000,0.00279221,0,0,0,1,1
"80963",40481500,1000,0.0030011,0,0,1,2,3
"80964",40482000,1000,0.00292562,0,0,1,2,3
"80965",40482500,1000,0.00284917,0,0,1,1,2
"80966",40483000,1000,0.00288421,0,0,1,1,2
"80967",40483500,1000,0.00286396,0,0,1,1,2
"80968",40484000,1000,0.00270585,0,0,1,1,2
"80969",40484500,1000,0.00278965,0,0,1,2,3
"80970",40485000,1000,0.00276445,0,0,1,2,3
"80971",40485500,1000,0.00256153,0,0,0,1,1
"80972",40486000,1000,0.00271663,0,0,0,0,0
"80973",40486500,1000,0.00274155,0,0,0,0,0
"80974",40487000,1000,0.00264753,0,0,0,0,0
"80975",40487500,1000,0.00275005,0,0,0,0,0
"80976",40488000,1000,0.00273291,0,0,0,1,1
"80977",40488500,1000,0.00272444,0,0,1,1,2
"80978",40489000,1000,0.00292095,0,1,1,0,2
"80979",40489500,1000,0.00302338,0,1,0,3,4
"80980",40490000,1000,0.00299852,0,0,0,4,4
"80981",40490500,1000,0.00280246,0,0,0,1,1
"80982",40491000,1000,0.00261973,0,0,0,0,0
"80983",40491500,1000,0.00256042,0,0,0,0,0
"80984",40492000,1000,0.00252406,0,0,0,0,0
"80985",40492500,1000,0.00262207,0,0,0,1,1
"80986",40493000,1000,0.00263223,0,0,0,1,1
"80987",40493500,1000,0.00267565,0,0,0,1,1
"80988",40494000,1000,0.00270609,0,0,0,2,2
"80989",40494500,1000,0.00275783,0,0,0,5,5
"80990",40495000,1000,0.00287362,0,0,0,4,4
"80991",40495500,1000,0.0026793,0,0,0,0,0
"80992",40496000,1000,0.00270193,0,0,1,0,1
"80993",40496500,1000,0.0026656,0,0,1,0,1
"80994",40497000,1000,0.00271741,0,0,1,1,2
"80995",40497500,1000,0.00278037,0,0,1,1,2
"80996",40498000,1000,0.00266969,0,0,0,0,0
"80997",40498500,1000,0.0027834,0,0,0,1,1
"80998",40499000,1000,0.00271102,0,0,0,2,2
"80999",40499500,1000,0.00260759,0,0,0,1,1
"81000",40500000,1000,0.00266141,0,0,0,2,2
"81001",40500500,1000,0.00285339,0,0,2,2,4
"81002",40501000,1000,0.00291578,0,0,2,2,4
"81003",40501500,1000,0.00274869,0,0,0,3,3
"81004",40502000,1000,0.00270932,0,0,0,2,2
"81005",40502500,1000,0.0027811,0,0,0,2,2
"81006",40503000,1000,0.00267064,0,0,0,1,1
"81007",40503500,1000,0.00255952,0,0,0,0,0
"81008",40504000,1000,0.0027209,0,0,1,1,2
"81009",40504500,1000,0.00268493,0,0,1,1,2
"81010",40505000,1000,0.00257637,0,0,0,1,1
"81011",40505500,1000,0.00268568,0,0,0,1,1
"81012",40506000,1000,0.00279676,0,0,1,1,2
"81013",40506500,1000,0.00283295,0,0,2,2,4
"81014",40507000,1000,0.00278194,0,0,1,2,3
"81015",40507500,1000,0.00284736,0,1,0,2,3
"81016",40508000,1000,0.00260349,0,1,0,1,2
"81017",40508500,1000,0.00241898,0,0,0,0,0
"81018",40509000,1000,0.00258071,0,0,0,2,2
"81019",40509500,1000,0.00288456,0,0,1,4,5
"81020",40510000,1000,0.00311983,0,0,1,5,6
"81021",40510500,1000,0.00280445,0,0,0,3,3
"81022",40511000,1000,0.00260601,0,0,0,0,0
"81023",40511500,1000,0.00267897,0,0,0,1,1
"81024",40512000,1000,0.00264668,0,0,0,1,1
"81025",40512500,1000,0.00276887,0,0,0,2,2
"81026",40513000,1000,0.00277016,0,0,0,2,2
"81027",40513500,1000,0.00273345,0,0,0,0,0
"81028",40514000,1000,0.00291636,0,0,1,0,1
"81029",40514500,1000,0.00280981,0,0,1,0,1
"81030",40515000,1000,0.00265913,0,0,0,0,0
"81031",40515500,1000,0.00275362,0,0,0,0,0
"81032",40516000,1000,0.00279634,0,0,1,0,1
"81033",40516500,1000,0.00268732,0,0,1,0,1
"81034",40517000,1000,0.00265482,0,0,0,0,0
"81035",40517500,1000,0.00279731,0,0,0,2,2
"81036",40518000,1000,0.00290317,0,0,0,4,4
"81037",40518500,1000,0.00285975,0,0,0,3,3
"81038",40519000,1000,0.00297044,0,1,0,1,2
"81039",40519500,1000,0.00299756,0,1,0,1,2
"81040",40520000,1000,0.00282615,0,0,1,2,3
"81041",40520500,1000,0.00276192,0,0,1,1,2
"81042",40521000,1000,0.00280423,0,0,0,1,1
"81043",40521500,1000,0.00285369,0,0,0,2,2
"81044",40522000,1000,0.0027352,0,0,0,1,1
"81045",40522500,1000,0.00265728,0,0,0,1,1
"81046",40523000,1000,0.00271682,0,0,0,2,2
"81047",40523500,1000,0.00265417,0,0,0,1,1
"81048",40524000,1000,0.00266941,0,0,1,0,1
"81049",40524500,1000,0.00263013,0,0,1,0,1
"81050",40525000,1000,0.00250627,0,0,1,0,1
"81051",40525500,1000,0.0025894,0,0,1,0,1
"81052",40526000,1000,0.00263834,0,0,0,0,0
"81053",40526500,1000,0.0027841,0,0,0,2,2
"81054",40527000,1000,0.00270777,0,0,0,2,2
"81055",40527500,1000,0.00249544,0,0,0,0,0
"81056",40528000,1000,0.00272947,0,0,2,1,3
"81057",40528500,1000,0.00279597,0,0,2,1,3
"81058",40529000,1000,0.00257413,0,0,0,0,0
"81059",40529500,1000,0.00267208,0,0,0,2,2
"81060",40530000,1000,0.00274911,0,0,0,2,2
"81061",40530500,1000,0.00273016,0,0,0,1,1
"81062",40531000,1000,0.00273439,0,0,0,2,2
"81063",40531500,1000,0.00272392,0,0,0,1,1
"81064",40532000,1000,0.00270112,0,0,0,0,0
"81065",40532500,1000,0.0027618,0,1,0,0,1
"81066",40533000,1000,0.00294152,0,1,1,0,2
"81067",40533500,1000,0.00287103,0,0,1,0,1
"81068",40534000,1000,0.00277608,0,0,0,0,0
"81069",40534500,1000,0.00295966,0,1,1,0,2
"81070",40535000,1000,0.00290614,0,1,1,2,4
"81071",40535500,1000,0.00265828,0,0,0,2,2
"81072",40536000,1000,0.00294703,0,1,0,0,1
"81073",40536500,1000,0.00298823,0,1,0,0,1
"81074",40537000,1000,0.0027366,0,0,0,2,2
"81075",40537500,1000,0.00272386,0,0,0,3,3
"81076",40538000,1000,0.00273571,0,0,0,3,3
"81077",40538500,1000,0.00284436,0,0,1,2,3
"81078",40539000,1000,0.00270965,0,0,1,1,2
"81079",40539500,1000,0.00256827,0,0,0,1,1
"81080",40540000,1000,0.00270654,0,0,0,0,0
"81081",40540500,1000,0.00304113,0,1,1,1,3
"81082",40541000,1000,0.00310882,0,1,1,4,6
"81083",40541500,1000,0.00282794,0,0,0,3,3
"81084",40542000,1000,0.0026989,0,0,0,1,1
"81085",40542500,1000,0.00282471,0,0,0,3,3
"81086",40543000,1000,0.00297999,0,0,1,3,4
"81087",40543500,1000,0.0028632,0,0,2,1,3
"81088",40544000,1000,0.00273576,0,0,1,2,3
"81089",40544500,1000,0.00273344,0,0,1,3,4
"81090",40545000,1000,0.00281053,0,0,2,2,4
"81091",40545500,1000,0.00277159,0,0,1,1,2
"81092",40546000,1000,0.00268045,0,0,0,0,0
"81093",40546500,1000,0.00265364,0,0,0,0,0
"81094",40547000,1000,0.00269442,0,0,0,1,1
"81095",40547500,1000,0.00274446,0,0,0,1,1
"81096",40548000,1000,0.00263757,0,0,0,0,0
"81097",40548500,1000,0.00266725,0,0,0,0,0
"81098",40549000,1000,0.00273254,0,0,0,0,0
"81099",40549500,1000,0.00291105,0,0,1,1,2
"81100",40550000,1000,0.00288741,0,0,1,1,2
"81101",40550500,1000,0.00258705,0,0,0,0,0
"81102",40551000,1000,0.00272699,0,0,0,2,2
"81103",40551500,1000,0.00280738,0,0,0,2,2
"81104",40552000,1000,0.00266125,0,0,0,0,0
"81105",40552500,1000,0.0027934,0,0,1,1,2
"81106",40553000,1000,0.00286943,0,0,1,2,3
"81107",40553500,1000,0.00270337,0,0,0,2,2
"81108",40554000,1000,0.00264215,0,0,0,1,1
"81109",40554500,1000,0.00284967,0,0,0,0,0
"81110",40555000,1000,0.00306699,0,0,0,0,0
"81111",40555500,1000,0.00312999,0,1,0,2,3
"81112",40556000,1000,0.00290847,0,1,0,2,3
"81113",40556500,1000,0.0026798,0,0,0,1,1
"81114",40557000,1000,0.00267873,0,0,0,1,1
"81115",40557500,1000,0.00263672,0,0,0,0,0
"81116",40558000,1000,0.00262513,0,0,0,0,0
"81117",40558500,1000,0.00267608,0,0,0,0,0
"81118",40559000,1000,0.00282954,0,0,0,0,0
"81119",40559500,1000,0.00284841,0,0,0,0,0
"81120",40560000,1000,0.00279902,0,0,0,2,2
"81121",40560500,1000,0.00270745,0,0,0,2,2
"81122",40561000,1000,0.00295604,0,1,0,0,1
"81123",40561500,1000,0.0029372,0,1,0,0,1
"81124",40562000,1000,0.00254505,0,0,0,0,0
"81125",40562500,1000,0.0026124,0,0,0,0,0
"81126",40563000,1000,0.00258175,0,0,0,0,0
"81127",40563500,1000,0.00268575,0,0,0,0,0
"81128",40564000,1000,0.00274058,0,0,0,0,0
"81129",40564500,1000,0.00264815,0,0,0,0,0
"81130",40565000,1000,0.00271899,0,0,0,0,0
"81131",40565500,1000,0.00267208,0,0,0,1,1
"81132",40566000,1000,0.002564,0,0,1,1,2
"81133",40566500,1000,0.00261444,0,0,1,1,2
"81134",40567000,1000,0.00262034,0,0,0,2,2
"81135",40567500,1000,0.0025463,0,0,0,2,2
"81136",40568000,1000,0.00252537,0,0,0,1,1
"81137",40568500,1000,0.0026012,0,0,0,0,0
"81138",40569000,1000,0.00263987,0,0,0,0,0
"81139",40569500,1000,0.00267743,0,0,1,0,1
"81140",40570000,1000,0.00275691,0,0,1,0,1
"81141",40570500,1000,0.00275867,0,0,0,1,1
"81142",40571000,1000,0.00271446,0,0,0,1,1
"81143",40571500,1000,0.00267741,0,0,0,0,0
"81144",40572000,1000,0.0027534,0,0,0,0,0
"81145",40572500,1000,0.00271928,0,0,0,0,0
"81146",40573000,1000,0.00261877,0,0,0,0,0
"81147",40573500,1000,0.00252227,0,0,0,0,0
"81148",40574000,1000,0.0024975,0,0,0,0,0
"81149",40574500,1000,0.00248101,0,0,0,0,0
"81150",40575000,1000,0.00239442,0,0,0,0,0
"81151",40575500,1000,0.002501,0,0,0,1,1
"81152",40576000,1000,0.00270415,0,0,0,2,2
"81153",40576500,1000,0.00271091,0,0,0,3,3
"81154",40577000,1000,0.00286012,0,1,0,2,3
"81155",40577500,1000,0.00290014,0,1,0,1,2
"81156",40578000,1000,0.00271511,0,0,0,3,3
"81157",40578500,1000,0.00263574,0,0,0,2,2
"81158",40579000,1000,0.00265034,0,0,0,1,1
"81159",40579500,1000,0.00266964,0,0,0,1,1
"81160",40580000,1000,0.00251349,0,0,0,0,0
"81161",40580500,1000,0.00255468,0,0,0,1,1
"81162",40581000,1000,0.00264188,0,0,0,1,1
"81163",40581500,1000,0.00274019,0,0,0,1,1
"81164",40582000,1000,0.0028253,0,0,1,2,3
"81165",40582500,1000,0.00282718,0,0,2,1,3
"81166",40583000,1000,0.00272538,0,0,1,0,1
"81167",40583500,1000,0.00253084,0,0,0,0,0
"81168",40584000,1000,0.00254933,0,0,0,0,0
"81169",40584500,1000,0.00260197,0,0,0,0,0
"81170",40585000,1000,0.00263307,0,0,0,0,0
"81171",40585500,1000,0.00267574,0,0,0,1,1
"81172",40586000,1000,0.00260884,0,0,0,1,1
"81173",40586500,1000,0.00255743,0,0,0,1,1
"81174",40587000,1000,0.00256928,0,0,0,1,1
"81175",40587500,1000,0.00268017,0,0,0,0,0
"81176",40588000,1000,0.00275895,0,0,0,0,0
"81177",40588500,1000,0.00277082,0,0,0,0,0
"81178",40589000,1000,0.00285382,0,0,0,2,2
"81179",40589500,1000,0.00287014,0,0,0,3,3
"81180",40590000,1000,0.00279551,0,0,0,1,1
"81181",40590500,1000,0.00267627,0,0,0,0,0
"81182",40591000,1000,0.00273372,0,0,0,1,1
"81183",40591500,1000,0.0029269,0,0,2,3,5
"81184",40592000,1000,0.00281178,0,0,2,3,5
"81185",40592500,1000,0.00249226,0,0,0,1,1
"81186",40593000,1000,0.00248124,0,0,0,0,0
"81187",40593500,1000,0.00261231,0,0,0,0,0
"81188",40594000,1000,0.00260994,0,0,0,0,0
"81189",40594500,1000,0.00254922,0,0,0,0,0
"81190",40595000,1000,0.00251351,0,0,0,0,0
"81191",40595500,1000,0.00259216,0,0,0,0,0
"81192",40596000,1000,0.00263379,0,0,0,0,0
"81193",40596500,1000,0.00276075,0,0,0,3,3
"81194",40597000,1000,0.0026969,0,0,0,3,3
"81195",40597500,1000,0.00267357,0,0,0,1,1
"81196",40598000,1000,0.00276225,0,0,0,2,2
"81197",40598500,1000,0.00255532,0,0,0,1,1
"81198",40599000,1000,0.00251493,0,0,0,0,0
"81199",40599500,1000,0.0026854,0,1,0,0,1
"81200",40600000,1000,0.00265718,0,1,0,0,1
"81201",40600500,1000,0.0024678,0,0,0,0,0
"81202",40601000,1000,0.00242082,0,0,0,0,0
"81203",40601500,1000,0.00247144,0,0,0,0,0
"81204",40602000,1000,0.00256675,0,0,0,0,0
"81205",40602500,1000,0.00259994,0,0,0,0,0
"81206",40603000,1000,0.00260473,0,0,0,0,0
"81207",40603500,1000,0.00278511,0,0,0,2,2
"81208",40604000,1000,0.00278409,0,0,0,2,2
"81209",40604500,1000,0.0027384,0,1,0,0,1
"81210",40605000,1000,0.0027691,0,1,0,1,2
"81211",40605500,1000,0.00273295,0,0,0,1,1
"81212",40606000,1000,0.00278429,0,0,0,1,1
"81213",40606500,1000,0.00274624,0,0,0,2,2
"81214",40607000,1000,0.00276477,0,0,0,1,1
"81215",40607500,1000,0.00265219,0,0,0,0,0
"81216",40608000,1000,0.00259895,0,0,0,0,0
"81217",40608500,1000,0.00267839,0,0,0,0,0
"81218",40609000,1000,0.00276627,0,0,0,3,3
"81219",40609500,1000,0.00283798,0,0,0,3,3
"81220",40610000,1000,0.00264348,0,0,0,0,0
"81221",40610500,1000,0.00264348,0,0,0,1,1
"81222",40611000,1000,0.00265872,0,0,0,1,1
"81223",40611500,1000,0.00257276,0,0,0,0,0
"81224",40612000,1000,0.0026913,0,0,0,0,0
"81225",40612500,1000,0.00281765,0,1,0,0,1
"81226",40613000,1000,0.00281673,0,1,0,1,2
"81227",40613500,1000,0.00262764,0,0,0,1,1
"81228",40614000,1000,0.00260509,0,0,0,1,1
"81229",40614500,1000,0.00275302,0,0,0,1,1
"81230",40615000,1000,0.00268547,0,0,0,0,0
"81231",40615500,1000,0.00267651,0,0,0,0,0
"81232",40616000,1000,0.00288778,0,0,0,1,1
"81233",40616500,1000,0.0028819,0,0,0,1,1
"81234",40617000,1000,0.00272068,0,0,0,1,1
"81235",40617500,1000,0.00265536,0,0,0,1,1
"81236",40618000,1000,0.00267438,0,0,0,2,2
"81237",40618500,1000,0.00255286,0,0,0,2,2
"81238",40619000,1000,0.00257709,0,0,0,1,1
"81239",40619500,1000,0.00278806,0,0,0,3,3
"81240",40620000,1000,0.00284336,0,0,0,2,2
"81241",40620500,1000,0.00280914,0,0,1,0,1
"81242",40621000,1000,0.00269425,0,0,1,0,1
"81243",40621500,1000,0.00269331,0,0,0,1,1
"81244",40622000,1000,0.00279128,0,0,0,4,4
"81245",40622500,1000,0.00284619,0,0,1,4,5
"81246",40623000,1000,0.00269155,0,0,1,1,2
"81247",40623500,1000,0.0025314,0,0,0,0,0
"81248",40624000,1000,0.00268645,0,0,0,1,1
"81249",40624500,1000,0.00268787,0,0,0,1,1
"81250",40625000,1000,0.00262785,0,0,1,0,1
"81251",40625500,1000,0.0026576,0,0,1,0,1
"81252",40626000,1000,0.00263898,0,0,1,0,1
"81253",40626500,1000,0.00272568,0,0,1,1,2
"81254",40627000,1000,0.00262673,0,0,0,1,1
"81255",40627500,1000,0.0025339,0,0,0,0,0
"81256",40628000,1000,0.00258671,0,0,0,1,1
"81257",40628500,1000,0.00259074,0,0,0,1,1
"81258",40629000,1000,0.00249468,0,0,0,0,0
"81259",40629500,1000,0.00251575,0,0,0,0,0
"81260",40630000,1000,0.00257834,0,0,0,0,0
"81261",40630500,1000,0.00262733,0,0,0,1,1
"81262",40631000,1000,0.00260953,0,0,0,1,1
"81263",40631500,1000,0.00256081,0,0,0,1,1
"81264",40632000,1000,0.00269743,0,0,0,1,1
"81265",40632500,1000,0.00265255,0,0,0,0,0
"81266",40633000,1000,0.00254696,0,0,0,1,1
"81267",40633500,1000,0.00259543,0,0,0,2,2
"81268",40634000,1000,0.00271214,0,0,0,2,2
"81269",40634500,1000,0.00265693,0,0,0,1,1
"81270",40635000,1000,0.00261481,0,0,0,0,0
"81271",40635500,1000,0.00256054,0,0,0,0,0
"81272",40636000,1000,0.00249705,0,0,0,1,1
"81273",40636500,1000,0.00257246,0,0,0,1,1
"81274",40637000,1000,0.00259909,0,0,0,0,0
"81275",40637500,1000,0.00265376,0,0,0,0,0
"81276",40638000,1000,0.00263271,0,0,0,0,0
"81277",40638500,1000,0.00262176,0,0,0,0,0
"81278",40639000,1000,0.00258127,0,0,0,0,0
"81279",40639500,1000,0.00250145,0,0,0,0,0
"81280",40640000,1000,0.00257101,0,0,0,0,0
"81281",40640500,1000,0.00264285,0,0,0,0,0
"81282",40641000,1000,0.00255159,0,0,0,0,0
"81283",40641500,1000,0.00255103,0,0,1,0,1
"81284",40642000,1000,0.00260185,0,0,1,1,2
"81285",40642500,1000,0.00259748,0,0,0,1,1
"81286",40643000,1000,0.00255702,0,0,0,0,0
"81287",40643500,1000,0.00249811,0,0,0,0,0
"81288",40644000,1000,0.00266558,0,1,0,0,1
"81289",40644500,1000,0.00266662,0,1,0,0,1
"81290",40645000,1000,0.00256443,0,0,0,0,0
"81291",40645500,1000,0.00252946,0,0,0,0,0
"81292",40646000,1000,0.00255537,0,0,1,0,1
"81293",40646500,1000,0.00269111,0,0,1,0,1
"81294",40647000,1000,0.00260434,0,0,0,0,0
"81295",40647500,1000,0.00248068,0,0,0,0,0
"81296",40648000,1000,0.00248411,0,0,0,0,0
"81297",40648500,1000,0.0025907,0,0,0,0,0
"81298",40649000,1000,0.00283341,0,0,2,1,3
"81299",40649500,1000,0.00270497,0,0,2,1,3
"81300",40650000,1000,0.00263438,0,0,0,1,1
"81301",40650500,1000,0.00265352,0,0,0,1,1
"81302",40651000,1000,0.00251228,0,0,0,0,0
"81303",40651500,1000,0.0025686,0,0,0,0,0
"81304",40652000,1000,0.00247866,0,0,0,0,0
"81305",40652500,1000,0.0025414,0,0,0,1,1
"81306",40653000,1000,0.00265679,0,0,0,1,1
"81307",40653500,1000,0.00252635,0,0,0,1,1
"81308",40654000,1000,0.00243557,0,0,0,1,1
"81309",40654500,1000,0.00245046,0,0,0,1,1
"81310",40655000,1000,0.00238535,0,0,0,1,1
"81311",40655500,1000,0.00236793,0,0,0,0,0
"81312",40656000,1000,0.00250295,0,0,0,0,0
"81313",40656500,1000,0.00259598,0,0,0,1,1
"81314",40657000,1000,0.00251481,0,0,0,1,1
"81315",40657500,1000,0.00239501,0,0,0,0,0
"81316",40658000,1000,0.00250403,0,1,0,0,1
"81317",40658500,1000,0.00259502,0,1,0,1,2
"81318",40659000,1000,0.00264338,0,0,0,2,2
"81319",40659500,1000,0.00274408,0,0,0,1,1
"81320",40660000,1000,0.002752,0,0,0,1,1
"81321",40660500,1000,0.00260634,0,0,0,1,1
"81322",40661000,1000,0.00253251,0,0,0,1,1
"81323",40661500,1000,0.00262717,0,0,0,1,1
"81324",40662000,1000,0.00258633,0,0,0,0,0
"81325",40662500,1000,0.00242126,0,0,0,1,1
"81326",40663000,1000,0.00255179,0,0,0,1,1
"81327",40663500,1000,0.00261831,0,0,0,0,0
"81328",40664000,1000,0.00245307,0,0,0,0,0
"81329",40664500,1000,0.00246869,0,0,0,0,0
"81330",40665000,1000,0.00258657,0,0,0,0,0
"81331",40665500,1000,0.00265728,0,0,0,0,0
"81332",40666000,1000,0.00261134,0,0,0,0,0
"81333",40666500,1000,0.00255567,0,0,0,0,0
"81334",40667000,1000,0.00253705,0,0,0,0,0
"81335",40667500,1000,0.00250439,0,0,0,0,0
"81336",40668000,1000,0.00252834,0,0,0,0,0
"81337",40668500,1000,0.00270085,0,0,0,1,1
"81338",40669000,1000,0.00264206,0,0,0,1,1
"81339",40669500,1000,0.00252724,0,0,0,0,0
"81340",40670000,1000,0.00262573,0,0,0,1,1
"81341",40670500,1000,0.00258294,0,0,0,1,1
"81342",40671000,1000,0.00252157,0,0,0,0,0
"81343",40671500,1000,0.0025955,0,0,0,0,0
"81344",40672000,1000,0.00254535,0,0,0,0,0
"81345",40672500,1000,0.0024706,0,0,0,0,0
"81346",40673000,1000,0.00254383,0,0,0,1,1
"81347",40673500,1000,0.00266278,0,0,0,3,3
"81348",40674000,1000,0.00272784,0,0,1,2,3
"81349",40674500,1000,0.00256216,0,0,1,0,1
"81350",40675000,1000,0.00250388,0,0,0,0,0
"81351",40675500,1000,0.00255885,0,0,0,1,1
"81352",40676000,1000,0.00241727,0,0,0,1,1
"81353",40676500,1000,0.00252332,0,0,0,1,1
"81354",40677000,1000,0.00270634,0,0,0,1,1
"81355",40677500,1000,0.00260817,0,0,0,0,0
"81356",40678000,1000,0.00255577,0,0,0,1,1
"81357",40678500,1000,0.00250873,0,0,0,1,1
"81358",40679000,1000,0.00246422,0,0,0,0,0
"81359",40679500,1000,0.00250964,0,0,0,0,0
"81360",40680000,1000,0.002648,0,0,0,1,1
"81361",40680500,1000,0.00279677,0,0,0,3,3
"81362",40681000,1000,0.00268654,0,0,0,2,2
"81363",40681500,1000,0.00261011,0,0,1,0,1
"81364",40682000,1000,0.00262947,0,0,1,0,1
"81365",40682500,1000,0.00269295,0,0,1,1,2
"81366",40683000,1000,0.00267085,0,0,1,1,2
"81367",40683500,1000,0.00246588,0,0,0,0,0
"81368",40684000,1000,0.0026002,0,0,1,1,2
"81369",40684500,1000,0.00287814,0,0,2,1,3
"81370",40685000,1000,0.00274009,0,0,1,0,1
"81371",40685500,1000,0.00253711,0,0,0,0,0
"81372",40686000,1000,0.00268962,0,0,0,2,2
"81373",40686500,1000,0.00273473,0,0,0,2,2
"81374",40687000,1000,0.00265147,0,0,1,0,1
"81375",40687500,1000,0.00262356,0,0,1,0,1
"81376",40688000,1000,0.0026434,0,0,0,2,2
"81377",40688500,1000,0.00262038,0,0,0,2,2
"81378",40689000,1000,0.00258654,0,0,0,1,1
"81379",40689500,1000,0.00264688,0,0,0,1,1
"81380",40690000,1000,0.00246117,0,0,0,0,0
"81381",40690500,1000,0.00250238,0,0,0,2,2
"81382",40691000,1000,0.00267577,0,0,1,2,3
"81383",40691500,1000,0.00252691,0,0,1,0,1
"81384",40692000,1000,0.00244296,0,0,0,0,0
"81385",40692500,1000,0.00260593,0,0,1,2,3
"81386",40693000,1000,0.00275802,0,0,1,3,4
"81387",40693500,1000,0.00267188,0,0,0,2,2
"81388",40694000,1000,0.00258041,0,0,0,1,1
"81389",40694500,1000,0.00265084,0,0,0,1,1
"81390",40695000,1000,0.00284465,0,0,1,3,4
"81391",40695500,1000,0.00277054,0,0,1,2,3
"81392",40696000,1000,0.00260033,0,0,0,0,0
"81393",40696500,1000,0.00253607,0,0,0,0,0
"81394",40697000,1000,0.0024981,0,0,0,0,0
"81395",40697500,1000,0.00258749,0,0,0,1,1
"81396",40698000,1000,0.00259434,0,0,0,1,1
"81397",40698500,1000,0.00266583,0,0,0,0,0
"81398",40699000,1000,0.00287482,0,0,1,3,4
"81399",40699500,1000,0.00275335,0,0,1,3,4
"81400",40700000,1000,0.00251859,0,0,0,0,0
"81401",40700500,1000,0.00260863,0,0,0,0,0
"81402",40701000,1000,0.00271928,0,0,1,0,1
"81403",40701500,1000,0.00265301,0,0,2,0,2
"81404",40702000,1000,0.00271506,0,0,2,1,3
"81405",40702500,1000,0.0026563,0,0,1,1,2
"81406",40703000,1000,0.00264107,0,0,0,0,0
"81407",40703500,1000,0.00280157,0,0,0,0,0
"81408",40704000,1000,0.00257432,0,0,0,0,0
"81409",40704500,1000,0.0025869,0,0,1,1,2
"81410",40705000,1000,0.00263272,0,0,1,1,2
"81411",40705500,1000,0.00248773,0,0,0,0,0
"81412",40706000,1000,0.00246982,0,0,0,0,0
"81413",40706500,1000,0.00244154,0,0,0,0,0
"81414",40707000,1000,0.00272522,0,0,1,1,2
"81415",40707500,1000,0.00283468,0,0,1,2,3
"81416",40708000,1000,0.00270825,0,0,0,1,1
"81417",40708500,1000,0.00267452,0,0,0,0,0
"81418",40709000,1000,0.00268551,0,0,0,0,0
"81419",40709500,1000,0.00267892,0,0,0,0,0
"81420",40710000,1000,0.0025903,0,0,0,0,0
"81421",40710500,1000,0.00261045,0,0,0,0,0
"81422",40711000,1000,0.00258631,0,0,0,0,0
"81423",40711500,1000,0.00254717,0,0,0,0,0
"81424",40712000,1000,0.00270463,0,0,1,0,1
"81425",40712500,1000,0.00283001,0,0,2,1,3
"81426",40713000,1000,0.00267789,0,0,1,1,2
"81427",40713500,1000,0.00254522,0,0,0,0,0
"81428",40714000,1000,0.00254099,0,0,0,0,0
"81429",40714500,1000,0.00264373,0,0,0,0,0
"81430",40715000,1000,0.00258464,0,0,0,0,0
"81431",40715500,1000,0.00247055,0,0,0,0,0
"81432",40716000,1000,0.0025723,0,0,0,0,0
"81433",40716500,1000,0.00259825,0,0,0,0,0
"81434",40717000,1000,0.00261881,0,0,0,1,1
"81435",40717500,1000,0.00263538,0,0,0,1,1
"81436",40718000,1000,0.00274177,0,0,1,0,1
"81437",40718500,1000,0.00265262,0,0,1,0,1
"81438",40719000,1000,0.00258039,0,0,0,1,1
"81439",40719500,1000,0.0026834,0,0,0,1,1
"81440",40720000,1000,0.00266844,0,0,0,1,1
"81441",40720500,1000,0.00260833,0,0,0,2,2
"81442",40721000,1000,0.00260352,0,0,0,1,1
"81443",40721500,1000,0.00278197,0,0,0,0,0
"81444",40722000,1000,0.00261109,0,0,0,0,0
"81445",40722500,1000,0.00239117,0,0,0,0,0
"81446",40723000,1000,0.00260408,0,0,0,0,0
"81447",40723500,1000,0.00276466,0,0,0,1,1
"81448",40724000,1000,0.0026356,0,0,0,1,1
"81449",40724500,1000,0.00267027,0,0,0,1,1
"81450",40725000,1000,0.002531,0,0,0,1,1
"81451",40725500,1000,0.00243702,0,0,0,0,0
"81452",40726000,1000,0.00253274,0,0,0,0,0
"81453",40726500,1000,0.00245116,0,0,0,0,0
"81454",40727000,1000,0.00263417,0,0,1,0,1
"81455",40727500,1000,0.00266085,0,0,1,0,1
"81456",40728000,1000,0.00260716,0,0,1,0,1
"81457",40728500,1000,0.00274066,0,0,2,1,3
"81458",40729000,1000,0.00256772,0,0,1,1,2
"81459",40729500,1000,0.00246296,0,0,0,0,0
"81460",40730000,1000,0.00274852,0,0,1,0,1
"81461",40730500,1000,0.00287623,0,0,2,0,2
"81462",40731000,1000,0.00280745,0,0,1,0,1
"81463",40731500,1000,0.00266725,0,0,0,0,0
"81464",40732000,1000,0.00242253,0,0,0,0,0
"81465",40732500,1000,0.00237883,0,0,0,0,0
"81466",40733000,1000,0.00247795,0,0,0,0,0
"81467",40733500,1000,0.00270779,0,0,0,4,4
"81468",40734000,1000,0.0028313,0,0,0,4,4
"81469",40734500,1000,0.00264352,0,0,0,0,0
"81470",40735000,1000,0.0028164,0,1,0,0,1
"81471",40735500,1000,0.00276828,0,1,0,1,2
"81472",40736000,1000,0.00259464,0,0,0,1,1
"81473",40736500,1000,0.00261745,0,0,0,0,0
"81474",40737000,1000,0.00253918,0,0,0,0,0
"81475",40737500,1000,0.0025871,0,0,0,0,0
"81476",40738000,1000,0.00260844,0,0,0,0,0
"81477",40738500,1000,0.00261201,0,0,0,0,0
"81478",40739000,1000,0.00254425,0,0,0,0,0
"81479",40739500,1000,0.00254252,0,0,0,0,0
"81480",40740000,1000,0.00282851,0,1,0,1,2
"81481",40740500,1000,0.00285203,0,1,0,2,3
"81482",40741000,1000,0.00265779,0,0,0,1,1
"81483",40741500,1000,0.00264032,0,0,0,1,1
"81484",40742000,1000,0.0026066,0,0,0,1,1
"81485",40742500,1000,0.0025601,0,0,0,0,0
"81486",40743000,1000,0.00243925,0,0,0,0,0
"81487",40743500,1000,0.00246445,0,0,0,0,0
"81488",40744000,1000,0.00275708,0,0,1,1,2
"81489",40744500,1000,0.00292568,0,0,2,2,4
"81490",40745000,1000,0.00280234,0,0,2,1,3
"81491",40745500,1000,0.00273714,0,0,1,1,2
"81492",40746000,1000,0.00270713,0,0,0,2,2
"81493",40746500,1000,0.00271099,0,0,0,1,1
"81494",40747000,1000,0.00265069,0,0,0,0,0
"81495",40747500,1000,0.00238579,0,0,0,0,0
"81496",40748000,1000,0.00236564,0,0,0,0,0
"81497",40748500,1000,0.00252614,0,0,0,0,0
"81498",40749000,1000,0.00249839,0,0,0,0,0
"81499",40749500,1000,0.00251566,0,0,0,0,0
"81500",40750000,1000,0.0026293,0,0,0,1,1
"81501",40750500,1000,0.00271125,0,0,0,2,2
"81502",40751000,1000,0.00279234,0,0,0,2,2
"81503",40751500,1000,0.00271332,0,0,0,1,1
"81504",40752000,1000,0.00257712,0,0,0,1,1
"81505",40752500,1000,0.00247893,0,0,0,1,1
"81506",40753000,1000,0.00259666,0,0,1,1,2
"81507",40753500,1000,0.00270263,0,0,1,1,2
"81508",40754000,1000,0.00264115,0,0,0,0,0
"81509",40754500,1000,0.00278765,0,0,0,2,2
"81510",40755000,1000,0.00284137,0,0,0,2,2
"81511",40755500,1000,0.00262981,0,0,0,0,0
"81512",40756000,1000,0.00263631,0,0,1,0,1
"81513",40756500,1000,0.00266434,0,0,1,1,2
"81514",40757000,1000,0.00257147,0,0,1,1,2
"81515",40757500,1000,0.00257159,0,0,1,0,1
"81516",40758000,1000,0.0025638,0,0,0,0,0
"81517",40758500,1000,0.00266612,0,1,0,0,1
"81518",40759000,1000,0.00262688,0,1,0,0,1
"81519",40759500,1000,0.00246398,0,0,0,0,0
"81520",40760000,1000,0.00263324,0,1,0,0,1
"81521",40760500,1000,0.00268772,0,1,0,0,1
"81522",40761000,1000,0.00265204,0,0,0,2,2
"81523",40761500,1000,0.00288334,0,0,0,2,2
"81524",40762000,1000,0.00292175,0,0,0,0,0
"81525",40762500,1000,0.00277718,0,0,0,1,1
"81526",40763000,1000,0.00266887,0,0,0,2,2
"81527",40763500,1000,0.00260684,0,0,0,1,1
"81528",40764000,1000,0.00258909,0,0,0,0,0
"81529",40764500,1000,0.00260557,0,0,0,0,0
"81530",40765000,1000,0.0026328,0,0,0,1,1
"81531",40765500,1000,0.00266875,0,0,1,2,3
"81532",40766000,1000,0.00260687,0,0,1,1,2
"81533",40766500,1000,0.0026866,0,0,1,1,2
"81534",40767000,1000,0.00262723,0,0,1,1,2
"81535",40767500,1000,0.00246517,0,0,0,0,0
"81536",40768000,1000,0.00249338,0,0,0,0,0
"81537",40768500,1000,0.00245241,0,0,0,0,0
"81538",40769000,1000,0.00262493,0,0,1,0,1
"81539",40769500,1000,0.00266204,0,0,1,0,1
"81540",40770000,1000,0.0027346,0,0,0,1,1
"81541",40770500,1000,0.00275683,0,0,0,3,3
"81542",40771000,1000,0.00249315,0,0,0,2,2
"81543",40771500,1000,0.00261851,0,0,0,0,0
"81544",40772000,1000,0.00263867,0,0,0,0,0
"81545",40772500,1000,0.00270525,0,0,0,2,2
"81546",40773000,1000,0.00270463,0,0,0,2,2
"81547",40773500,1000,0.00250798,0,0,0,0,0
"81548",40774000,1000,0.00252446,0,0,0,0,0
"81549",40774500,1000,0.00259385,0,0,0,1,1
"81550",40775000,1000,0.00275151,0,1,0,1,2
"81551",40775500,1000,0.00266225,0,1,0,0,1
"81552",40776000,1000,0.00257,0,0,0,0,0
"81553",40776500,1000,0.00261556,0,0,0,0,0
"81554",40777000,1000,0.00260687,0,0,0,0,0
"81555",40777500,1000,0.00280833,0,0,1,1,2
"81556",40778000,1000,0.00281905,0,0,1,1,2
"81557",40778500,1000,0.00257006,0,0,0,0,0
"81558",40779000,1000,0.00245147,0,0,0,0,0
"81559",40779500,1000,0.00252416,0,0,0,0,0
"81560",40780000,1000,0.00270063,0,0,1,1,2
"81561",40780500,1000,0.0026628,0,0,2,1,3
"81562",40781000,1000,0.00254273,0,0,1,0,1
"81563",40781500,1000,0.00253554,0,0,0,0,0
"81564",40782000,1000,0.00275569,0,0,0,0,0
"81565",40782500,1000,0.00275406,0,0,0,0,0
"81566",40783000,1000,0.00263465,0,0,0,0,0
"81567",40783500,1000,0.00265483,0,0,0,0,0
"81568",40784000,1000,0.00250468,0,0,0,0,0
"81569",40784500,1000,0.00258914,0,0,0,2,2
"81570",40785000,1000,0.00277088,0,1,0,2,3
"81571",40785500,1000,0.00269059,0,1,0,0,1
"81572",40786000,1000,0.00271022,0,0,1,1,2
"81573",40786500,1000,0.00266939,0,0,1,2,3
"81574",40787000,1000,0.00254869,0,0,0,1,1
"81575",40787500,1000,0.00268718,0,0,1,1,2
"81576",40788000,1000,0.00260634,0,0,1,1,2
"81577",40788500,1000,0.00249144,0,0,0,0,0
"81578",40789000,1000,0.00265615,0,0,0,1,1
"81579",40789500,1000,0.00265283,0,0,0,1,1
"81580",40790000,1000,0.00264037,0,0,1,1,2
"81581",40790500,1000,0.00262211,0,0,1,1,2
"81582",40791000,1000,0.0025682,0,0,0,0,0
"81583",40791500,1000,0.00260652,0,0,0,0,0
"81584",40792000,1000,0.00258152,0,0,0,0,0
"81585",40792500,1000,0.00259573,0,0,0,2,2
"81586",40793000,1000,0.00253159,0,0,0,2,2
"81587",40793500,1000,0.00263778,0,0,0,1,1
"81588",40794000,1000,0.00276228,0,0,0,1,1
"81589",40794500,1000,0.00268817,0,1,0,0,1
"81590",40795000,1000,0.00265451,0,1,0,0,1
"81591",40795500,1000,0.00256626,0,0,0,0,0
"81592",40796000,1000,0.00280758,0,1,1,0,2
"81593",40796500,1000,0.00298818,0,1,1,1,3
"81594",40797000,1000,0.0028022,0,0,0,1,1
"81595",40797500,1000,0.00267429,0,0,0,0,0
"81596",40798000,1000,0.00261997,0,0,0,1,1
"81597",40798500,1000,0.00252407,0,0,0,1,1
"81598",40799000,1000,0.00245077,0,0,0,0,0
"81599",40799500,1000,0.00255635,0,0,0,1,1
"81600",40800000,1000,0.00253757,0,0,0,2,2
"81601",40800500,1000,0.00253486,0,0,0,1,1
"81602",40801000,1000,0.00270316,0,0,0,1,1
"81603",40801500,1000,0.00280272,0,0,0,2,2
"81604",40802000,1000,0.00270372,0,0,0,1,1
"81605",40802500,1000,0.00266671,0,1,0,0,1
"81606",40803000,1000,0.00255428,0,1,0,0,1
"81607",40803500,1000,0.00244414,0,0,0,0,0
"81608",40804000,1000,0.00265566,0,1,0,0,1
"81609",40804500,1000,0.00261709,0,1,0,0,1
"81610",40805000,1000,0.00254122,0,0,0,0,0
"81611",40805500,1000,0.00270252,0,0,1,0,1
"81612",40806000,1000,0.00268996,0,0,1,0,1
"81613",40806500,1000,0.00267141,0,0,0,0,0
"81614",40807000,1000,0.0027807,0,0,0,2,2
"81615",40807500,1000,0.00277777,0,0,0,2,2
"81616",40808000,1000,0.00270824,0,0,0,1,1
"81617",40808500,1000,0.0026084,0,0,0,2,2
"81618",40809000,1000,0.00258046,0,0,0,2,2
"81619",40809500,1000,0.00256931,0,0,0,1,1
"81620",40810000,1000,0.00256306,0,0,0,0,0
"81621",40810500,1000,0.00254979,0,0,0,0,0
"81622",40811000,1000,0.00249637,0,0,0,1,1
"81623",40811500,1000,0.00252075,0,0,0,1,1
"81624",40812000,1000,0.00252841,0,0,0,0,0
"81625",40812500,1000,0.0026222,0,0,0,3,3
"81626",40813000,1000,0.00266202,0,0,0,3,3
"81627",40813500,1000,0.00253185,0,0,0,0,0
"81628",40814000,1000,0.00252596,0,0,0,0,0
"81629",40814500,1000,0.00264117,0,0,0,1,1
"81630",40815000,1000,0.00261134,0,0,0,1,1
"81631",40815500,1000,0.00244696,0,0,0,0,0
"81632",40816000,1000,0.00236318,0,0,0,0,0
"81633",40816500,1000,0.00250298,0,0,0,1,1
"81634",40817000,1000,0.00263327,0,0,0,1,1
"81635",40817500,1000,0.0025692,0,0,0,0,0
"81636",40818000,1000,0.00254387,0,0,0,0,0
"81637",40818500,1000,0.00252771,0,0,0,1,1
"81638",40819000,1000,0.00249663,0,0,1,1,2
"81639",40819500,1000,0.00263391,0,0,1,0,1
"81640",40820000,1000,0.002714,0,0,0,0,0
"81641",40820500,1000,0.00267525,0,0,0,1,1
"81642",40821000,1000,0.00279336,0,0,1,1,2
"81643",40821500,1000,0.00272021,0,0,1,1,2
"81644",40822000,1000,0.00256709,0,0,0,1,1
"81645",40822500,1000,0.00260704,0,0,0,1,1
"81646",40823000,1000,0.00249775,0,0,0,2,2
"81647",40823500,1000,0.00241503,0,0,0,1,1
"81648",40824000,1000,0.00272069,0,0,0,2,2
"81649",40824500,1000,0.00267686,0,0,0,2,2
"81650",40825000,1000,0.00242796,0,0,0,0,0
"81651",40825500,1000,0.00255756,0,0,0,0,0
"81652",40826000,1000,0.00272028,0,0,0,1,1
"81653",40826500,1000,0.00280216,0,0,1,1,2
"81654",40827000,1000,0.00267569,0,0,1,0,1
"81655",40827500,1000,0.00251427,0,0,0,0,0
"81656",40828000,1000,0.00260848,0,0,0,0,0
"81657",40828500,1000,0.00263349,0,0,0,0,0
"81658",40829000,1000,0.00249627,0,0,0,1,1
"81659",40829500,1000,0.00258483,0,0,1,1,2
"81660",40830000,1000,0.00267161,0,0,1,1,2
"81661",40830500,1000,0.00243869,0,0,0,1,1
"81662",40831000,1000,0.002388,0,0,0,1,1
"81663",40831500,1000,0.00252478,0,0,0,1,1
"81664",40832000,1000,0.00274571,0,0,1,2,3
"81665",40832500,1000,0.00272919,0,0,1,3,4
"81666",40833000,1000,0.00251846,0,0,0,1,1
"81667",40833500,1000,0.00261053,0,0,0,1,1
"81668",40834000,1000,0.00253834,0,0,0,1,1
"81669",40834500,1000,0.0026569,0,0,0,0,0
"81670",40835000,1000,0.00274925,0,0,0,1,1
"81671",40835500,1000,0.00251762,0,0,0,1,1
"81672",40836000,1000,0.00257446,0,0,0,2,2
"81673",40836500,1000,0.00275992,0,0,1,3,4
"81674",40837000,1000,0.00270525,0,0,1,1,2
"81675",40837500,1000,0.00258494,0,0,0,0,0
"81676",40838000,1000,0.00260887,0,0,0,0,0
"81677",40838500,1000,0.00271837,0,0,0,1,1
"81678",40839000,1000,0.00270447,0,0,0,1,1
"81679",40839500,1000,0.00276614,0,0,0,1,1
"81680",40840000,1000,0.00273665,0,0,0,1,1
"81681",40840500,1000,0.00263253,0,0,1,1,2
"81682",40841000,1000,0.00271221,0,0,1,1,2
"81683",40841500,1000,0.00290324,0,1,1,1,3
"81684",40842000,1000,0.00304982,0,2,1,1,4
"81685",40842500,1000,0.00286947,0,1,0,1,2
"81686",40843000,1000,0.00270445,0,0,0,1,1
"81687",40843500,1000,0.00282266,0,0,1,1,2
"81688",40844000,1000,0.00277158,0,0,1,2,3
"81689",40844500,1000,0.00259299,0,0,0,2,2
"81690",40845000,1000,0.00264081,0,0,0,1,1
"81691",40845500,1000,0.00258393,0,0,0,0,0
"81692",40846000,1000,0.00254262,0,0,0,0,0
"81693",40846500,1000,0.00264902,0,0,0,0,0
"81694",40847000,1000,0.0026207,0,0,0,0,0
"81695",40847500,1000,0.00260334,0,0,0,1,1
"81696",40848000,1000,0.00270834,0,0,1,1,2
"81697",40848500,1000,0.00266964,0,0,1,2,3
"81698",40849000,1000,0.00251022,0,0,0,2,2
"81699",40849500,1000,0.00249993,0,0,0,1,1
"81700",40850000,1000,0.00264056,0,0,0,2,2
"81701",40850500,1000,0.0025727,0,0,0,1,1
"81702",40851000,1000,0.00256096,0,0,0,0,0
"81703",40851500,1000,0.00263496,0,0,0,0,0
"81704",40852000,1000,0.00255334,0,0,0,0,0
"81705",40852500,1000,0.00257569,0,0,0,0,0
"81706",40853000,1000,0.00256114,0,0,0,0,0
"81707",40853500,1000,0.00258492,0,0,0,0,0
"81708",40854000,1000,0.00286138,0,1,0,0,1
"81709",40854500,1000,0.00270534,0,1,0,0,1
"81710",40855000,1000,0.00256081,0,0,0,2,2
"81711",40855500,1000,0.0025691,0,0,0,2,2
"81712",40856000,1000,0.00243489,0,0,0,0,0
"81713",40856500,1000,0.00244085,0,0,0,0,0
"81714",40857000,1000,0.00249741,0,0,1,1,2
"81715",40857500,1000,0.00261563,0,0,1,1,2
"81716",40858000,1000,0.00272085,0,0,1,0,1
"81717",40858500,1000,0.00283307,0,0,2,0,2
"81718",40859000,1000,0.00273252,0,0,1,0,1
"81719",40859500,1000,0.00268508,0,0,0,1,1
"81720",40860000,1000,0.00272032,0,0,1,1,2
"81721",40860500,1000,0.00269811,0,0,1,0,1
"81722",40861000,1000,0.0026574,0,0,0,0,0
"81723",40861500,1000,0.00255707,0,0,0,0,0
"81724",40862000,1000,0.00255852,0,0,0,0,0
"81725",40862500,1000,0.00265331,0,0,0,0,0
"81726",40863000,1000,0.00273506,0,0,0,1,1
"81727",40863500,1000,0.00275151,0,0,0,2,2
"81728",40864000,1000,0.00257925,0,0,0,1,1
"81729",40864500,1000,0.00264316,0,0,0,1,1
"81730",40865000,1000,0.0026784,0,0,0,1,1
"81731",40865500,1000,0.0025668,0,0,0,2,2
"81732",40866000,1000,0.0026534,0,0,0,2,2
"81733",40866500,1000,0.00261793,0,0,0,0,0
"81734",40867000,1000,0.00260662,0,0,0,0,0
"81735",40867500,1000,0.00257396,0,0,0,0,0
"81736",40868000,1000,0.00245063,0,0,0,0,0
"81737",40868500,1000,0.00239191,0,0,0,0,0
"81738",40869000,1000,0.00238257,0,0,0,0,0
"81739",40869500,1000,0.00252027,0,0,0,1,1
"81740",40870000,1000,0.00274419,0,0,0,1,1
"81741",40870500,1000,0.00263797,0,0,0,1,1
"81742",40871000,1000,0.0026014,0,0,0,2,2
"81743",40871500,1000,0.00266491,0,0,0,1,1
"81744",40872000,1000,0.00250144,0,0,0,0,0
"81745",40872500,1000,0.00245395,0,0,0,0,0
"81746",40873000,1000,0.00255971,0,0,0,0,0
"81747",40873500,1000,0.00257279,0,0,0,0,0
"81748",40874000,1000,0.00253815,0,0,0,0,0
"81749",40874500,1000,0.00244816,0,0,0,0,0
"81750",40875000,1000,0.00238406,0,0,0,0,0
"81751",40875500,1000,0.00249029,0,0,0,0,0
"81752",40876000,1000,0.00256968,0,0,0,0,0
"81753",40876500,1000,0.00258149,0,0,0,1,1
"81754",40877000,1000,0.00254257,0,0,0,1,1
"81755",40877500,1000,0.00258028,0,0,0,0,0
"81756",40878000,1000,0.0026694,0,0,0,1,1
"81757",40878500,1000,0.00279042,0,1,0,1,2
"81758",40879000,1000,0.0028298,0,1,1,0,2
"81759",40879500,1000,0.0028848,0,0,2,1,3
"81760",40880000,1000,0.00289388,0,0,1,1,2
"81761",40880500,1000,0.00279573,0,0,0,1,1
"81762",40881000,1000,0.00268973,0,0,0,1,1
"81763",40881500,1000,0.00262861,0,0,0,0,0
"81764",40882000,1000,0.0025703,0,0,0,0,0
"81765",40882500,1000,0.00259164,0,0,0,2,2
"81766",40883000,1000,0.0026773,0,0,0,2,2
"81767",40883500,1000,0.00259829,0,0,0,0,0
"81768",40884000,1000,0.00254829,0,0,0,0,0
"81769",40884500,1000,0.00274121,0,1,0,1,2
"81770",40885000,1000,0.00269578,0,1,0,1,2
"81771",40885500,1000,0.00248442,0,0,0,0,0
"81772",40886000,1000,0.00247751,0,0,0,0,0
"81773",40886500,1000,0.00238631,0,0,0,0,0
"81774",40887000,1000,0.00242126,0,0,0,0,0
"81775",40887500,1000,0.00259914,0,0,0,2,2
"81776",40888000,1000,0.00258985,0,0,0,2,2
"81777",40888500,1000,0.00243824,0,0,0,0,0
"81778",40889000,1000,0.00247725,0,0,0,0,0
"81779",40889500,1000,0.00252487,0,0,0,0,0
"81780",40890000,1000,0.00253061,0,0,0,0,0
"81781",40890500,1000,0.00251824,0,0,0,0,0
"81782",40891000,1000,0.00245938,0,0,0,1,1
"81783",40891500,1000,0.0024924,0,0,0,1,1
"81784",40892000,1000,0.00254326,0,0,0,0,0
"81785",40892500,1000,0.00281461,0,0,1,0,1
"81786",40893000,1000,0.00289493,0,0,1,1,2
"81787",40893500,1000,0.00284089,0,0,1,4,5
"81788",40894000,1000,0.002698,0,0,1,3,4
"81789",40894500,1000,0.00243623,0,0,0,0,0
"81790",40895000,1000,0.00256786,0,0,0,0,0
"81791",40895500,1000,0.002936,0,0,0,4,4
"81792",40896000,1000,0.00294421,0,0,0,6,6
"81793",40896500,1000,0.00260352,0,0,0,2,2
"81794",40897000,1000,0.00249349,0,0,0,0,0
"81795",40897500,1000,0.00268702,0,0,0,3,3
"81796",40898000,1000,0.00280508,0,0,0,3,3
"81797",40898500,1000,0.00262185,0,0,0,0,0
"81798",40899000,1000,0.00247366,0,0,0,0,0
"81799",40899500,1000,0.00255003,0,0,0,0,0
"81800",40900000,1000,0.00286001,0,1,0,0,1
"81801",40900500,1000,0.00282343,0,1,0,0,1
"81802",40901000,1000,0.00267233,0,0,0,0,0
"81803",40901500,1000,0.00280337,0,0,1,0,1
"81804",40902000,1000,0.00270472,0,0,1,0,1
"81805",40902500,1000,0.00262973,0,0,0,0,0
"81806",40903000,1000,0.0027568,0,0,0,0,0
"81807",40903500,1000,0.0027535,0,0,0,0,0
"81808",40904000,1000,0.00273524,0,0,1,1,2
"81809",40904500,1000,0.00273375,0,0,1,1,2
"81810",40905000,1000,0.00269897,0,0,0,0,0
"81811",40905500,1000,0.00271383,0,0,0,0,0
"81812",40906000,1000,0.00262625,0,0,0,0,0
"81813",40906500,1000,0.00255004,0,0,0,0,0
"81814",40907000,1000,0.00248564,0,0,0,0,0
"81815",40907500,1000,0.00257851,0,0,1,1,2
"81816",40908000,1000,0.00266895,0,0,1,1,2
"81817",40908500,1000,0.00279181,0,1,0,0,1
"81818",40909000,1000,0.00276668,0,1,0,0,1
"81819",40909500,1000,0.00256758,0,0,0,1,1
"81820",40910000,1000,0.00263852,0,0,0,2,2
"81821",40910500,1000,0.00266234,0,0,0,1,1
"81822",40911000,1000,0.00265189,0,0,0,0,0
"81823",40911500,1000,0.00260648,0,0,0,0,0
"81824",40912000,1000,0.00263995,0,0,0,1,1
"81825",40912500,1000,0.00259143,0,0,0,1,1
"81826",40913000,1000,0.00262975,0,0,1,1,2
"81827",40913500,1000,0.00271131,0,0,1,1,2
"81828",40914000,1000,0.0027799,0,0,0,3,3
"81829",40914500,1000,0.00273659,0,0,0,3,3
"81830",40915000,1000,0.00254158,0,0,0,0,0
"81831",40915500,1000,0.00252439,0,0,0,0,0
"81832",40916000,1000,0.00256595,0,0,0,0,0
"81833",40916500,1000,0.00256495,0,0,0,0,0
"81834",40917000,1000,0.00252724,0,0,0,1,1
"81835",40917500,1000,0.00246255,0,0,0,1,1
"81836",40918000,1000,0.00247156,0,0,0,0,0
"81837",40918500,1000,0.00258298,0,0,0,0,0
"81838",40919000,1000,0.00280179,0,1,0,0,1
"81839",40919500,1000,0.00269063,0,1,0,0,1
"81840",40920000,1000,0.00248256,0,0,0,0,0
"81841",40920500,1000,0.00260889,0,0,0,1,1
"81842",40921000,1000,0.00264281,0,0,0,1,1
"81843",40921500,1000,0.00278341,0,0,1,1,2
"81844",40922000,1000,0.00278064,0,0,1,1,2
"81845",40922500,1000,0.00257413,0,0,0,0,0
"81846",40923000,1000,0.00272786,0,0,0,0,0
"81847",40923500,1000,0.00275559,0,0,0,0,0
"81848",40924000,1000,0.00253327,0,0,0,0,0
"81849",40924500,1000,0.00253535,0,0,0,0,0
"81850",40925000,1000,0.00269462,0,0,0,0,0
"81851",40925500,1000,0.00287291,0,0,0,1,1
"81852",40926000,1000,0.00267509,0,0,0,1,1
"81853",40926500,1000,0.00254693,0,0,0,1,1
"81854",40927000,1000,0.00273703,0,0,0,1,1
"81855",40927500,1000,0.0026572,0,0,0,0,0
"81856",40928000,1000,0.00266476,0,0,0,1,1
"81857",40928500,1000,0.00268472,0,0,0,1,1
"81858",40929000,1000,0.00255416,0,0,0,0,0
"81859",40929500,1000,0.00266605,0,0,0,0,0
"81860",40930000,1000,0.00259731,0,0,0,0,0
"81861",40930500,1000,0.00248254,0,0,0,0,0
"81862",40931000,1000,0.00274691,0,0,1,0,1
"81863",40931500,1000,0.00282957,0,0,1,1,2
"81864",40932000,1000,0.00265467,0,0,0,1,1
"81865",40932500,1000,0.00254531,0,0,0,0,0
"81866",40933000,1000,0.00250329,0,0,0,0,0
"81867",40933500,1000,0.00256515,0,0,0,0,0
"81868",40934000,1000,0.00264196,0,0,0,2,2
"81869",40934500,1000,0.00255276,0,0,0,2,2
"81870",40935000,1000,0.00245484,0,0,0,0,0
"81871",40935500,1000,0.00265468,0,1,0,0,1
"81872",40936000,1000,0.00277132,0,1,0,0,1
"81873",40936500,1000,0.00262092,0,0,0,0,0
"81874",40937000,1000,0.00263679,0,0,1,0,1
"81875",40937500,1000,0.00261591,0,0,1,0,1
"81876",40938000,1000,0.002603,0,0,0,0,0
"81877",40938500,1000,0.00268622,0,0,0,0,0
"81878",40939000,1000,0.0027229,0,0,0,2,2
"81879",40939500,1000,0.00267832,0,0,0,2,2
"81880",40940000,1000,0.00253104,0,0,0,0,0
"81881",40940500,1000,0.00251787,0,0,0,0,0
"81882",40941000,1000,0.00250684,0,0,0,0,0
"81883",40941500,1000,0.00260337,0,0,0,0,0
"81884",40942000,1000,0.00295109,0,0,0,1,1
"81885",40942500,1000,0.00328974,0,0,0,3,3
"81886",40943000,1000,0.00295016,0,0,0,2,2
"81887",40943500,1000,0.00258323,0,0,0,1,1
"81888",40944000,1000,0.00269393,0,0,0,1,1
"81889",40944500,1000,0.00271409,0,0,0,0,0
"81890",40945000,1000,0.00265018,0,0,0,2,2
"81891",40945500,1000,0.00268062,0,0,0,2,2
"81892",40946000,1000,0.00264375,0,0,0,0,0
"81893",40946500,1000,0.00247782,0,0,0,0,0
"81894",40947000,1000,0.00246663,0,0,0,0,0
"81895",40947500,1000,0.00244701,0,0,0,0,0
"81896",40948000,1000,0.00250905,0,0,0,0,0
"81897",40948500,1000,0.00264907,0,0,1,0,1
"81898",40949000,1000,0.00270299,0,0,1,1,2
"81899",40949500,1000,0.00266221,0,0,0,1,1
"81900",40950000,1000,0.00266672,0,1,0,0,1
"81901",40950500,1000,0.00279081,0,1,1,1,3
"81902",40951000,1000,0.00294041,0,0,1,2,3
"81903",40951500,1000,0.00276697,0,0,0,1,1
"81904",40952000,1000,0.00253968,0,0,0,0,0
"81905",40952500,1000,0.00260915,0,0,0,1,1
"81906",40953000,1000,0.00261639,0,0,0,1,1
"81907",40953500,1000,0.0026089,0,0,0,0,0
"81908",40954000,1000,0.0026985,0,1,0,0,1
"81909",40954500,1000,0.00281955,0,1,1,0,2
"81910",40955000,1000,0.0027587,0,0,1,1,2
"81911",40955500,1000,0.00260536,0,0,0,1,1
"81912",40956000,1000,0.00265362,0,0,0,2,2
"81913",40956500,1000,0.00271962,0,0,0,4,4
"81914",40957000,1000,0.00268656,0,0,0,3,3
"81915",40957500,1000,0.0027013,0,0,1,1,2
"81916",40958000,1000,0.00261019,0,0,1,0,1
"81917",40958500,1000,0.00262698,0,0,0,1,1
"81918",40959000,1000,0.00286658,0,1,0,1,2
"81919",40959500,1000,0.00277307,0,1,0,0,1
"81920",40960000,1000,0.00278588,0,1,1,0,2
"81921",40960500,1000,0.00287942,0,1,1,2,4
"81922",40961000,1000,0.00266496,0,0,0,2,2
"81923",40961500,1000,0.00252237,0,0,0,0,0
"81924",40962000,1000,0.00267485,0,0,0,1,1
"81925",40962500,1000,0.00278927,0,0,0,1,1
"81926",40963000,1000,0.00265669,0,0,0,0,0
"81927",40963500,1000,0.00262851,0,0,0,0,0
"81928",40964000,1000,0.00262349,0,0,0,0,0
"81929",40964500,1000,0.00281807,0,0,0,3,3
"81930",40965000,1000,0.00279768,0,0,0,4,4
"81931",40965500,1000,0.00255773,0,0,0,1,1
"81932",40966000,1000,0.00261586,0,0,0,1,1
"81933",40966500,1000,0.00279647,0,0,0,2,2
"81934",40967000,1000,0.00278621,0,0,0,2,2
"81935",40967500,1000,0.00264025,0,0,0,2,2
"81936",40968000,1000,0.0026604,0,0,0,1,1
"81937",40968500,1000,0.00264006,0,0,0,0,0
"81938",40969000,1000,0.0025232,0,0,0,0,0
"81939",40969500,1000,0.00248883,0,0,0,0,0
"81940",40970000,1000,0.0024804,0,0,0,0,0
"81941",40970500,1000,0.00257146,0,0,0,0,0
"81942",40971000,1000,0.00277258,0,1,0,0,1
"81943",40971500,1000,0.00263471,0,1,0,0,1
"81944",40972000,1000,0.00251059,0,0,0,0,0
"81945",40972500,1000,0.00272906,0,0,0,1,1
"81946",40973000,1000,0.00273341,0,0,0,3,3
"81947",40973500,1000,0.00252146,0,0,0,2,2
"81948",40974000,1000,0.00237701,0,0,0,0,0
"81949",40974500,1000,0.00247263,0,0,1,0,1
"81950",40975000,1000,0.00257126,0,0,1,1,2
"81951",40975500,1000,0.00250523,0,0,0,1,1
"81952",40976000,1000,0.00262442,0,0,0,1,1
"81953",40976500,1000,0.0026537,0,0,0,1,1
"81954",40977000,1000,0.00258756,0,0,0,1,1
"81955",40977500,1000,0.00250103,0,0,0,1,1
"81956",40978000,1000,0.00254432,0,0,0,0,0
"81957",40978500,1000,0.00276089,0,0,0,0,0
"81958",40979000,1000,0.00280609,0,0,1,0,1
"81959",40979500,1000,0.00280766,0,0,1,0,1
"81960",40980000,1000,0.00277769,0,0,0,0,0
"81961",40980500,1000,0.00280081,0,0,0,2,2
"81962",40981000,1000,0.00276244,0,0,0,2,2
"81963",40981500,1000,0.00263729,0,0,0,0,0
"81964",40982000,1000,0.00277874,0,0,1,1,2
"81965",40982500,1000,0.00290982,0,0,2,2,4
"81966",40983000,1000,0.00273305,0,0,1,1,2
"81967",40983500,1000,0.00272983,0,0,0,0,0
"81968",40984000,1000,0.00276342,0,0,0,0,0
"81969",40984500,1000,0.00261174,0,0,0,0,0
"81970",40985000,1000,0.00248036,0,0,0,0,0
"81971",40985500,1000,0.00245333,0,0,0,0,0
"81972",40986000,1000,0.00257995,0,0,0,1,1
"81973",40986500,1000,0.00264485,0,0,1,1,2
"81974",40987000,1000,0.00262715,0,0,1,0,1
"81975",40987500,1000,0.00263777,0,0,0,0,0
"81976",40988000,1000,0.00270167,0,0,0,1,1
"81977",40988500,1000,0.00264593,0,0,0,1,1
"81978",40989000,1000,0.00242637,0,0,0,0,0
"81979",40989500,1000,0.00233476,0,0,0,0,0
"81980",40990000,1000,0.00240406,0,0,0,0,0
"81981",40990500,1000,0.00245186,0,0,0,0,0
"81982",40991000,1000,0.00244187,0,0,0,0,0
"81983",40991500,1000,0.00253993,0,0,1,0,1
"81984",40992000,1000,0.00266243,0,0,2,0,2
"81985",40992500,1000,0.00270631,0,0,1,1,2
"81986",40993000,1000,0.00261786,0,0,0,1,1
"81987",40993500,1000,0.00262022,0,0,0,0,0
"81988",40994000,1000,0.00266057,0,0,0,1,1
"81989",40994500,1000,0.00244609,0,0,0,1,1
"81990",40995000,1000,0.00232807,0,0,0,0,0
"81991",40995500,1000,0.00252865,0,0,0,0,0
"81992",40996000,1000,0.0025682,0,0,0,0,0
"81993",40996500,1000,0.00254197,0,0,0,2,2
"81994",40997000,1000,0.00253979,0,0,0,2,2
"81995",40997500,1000,0.00256103,0,0,0,0,0
"81996",40998000,1000,0.00258618,0,0,0,0,0
"81997",40998500,1000,0.00248616,0,0,0,0,0
"81998",40999000,1000,0.00247306,0,0,0,0,0
"81999",40999500,1000,0.00261705,0,0,0,0,0
"82000",41000000,1000,0.00273961,0,0,0,0,0
"82001",41000500,1000,0.00260178,0,0,0,0,0
"82002",41001000,1000,0.00249767,0,0,0,0,0
"82003",41001500,1000,0.00253993,0,0,0,0,0
"82004",41002000,1000,0.00284105,0,1,0,1,2
"82005",41002500,1000,0.00287786,0,1,0,1,2
"82006",41003000,1000,0.00279157,0,1,1,0,2
"82007",41003500,1000,0.00278848,0,1,1,0,2
"82008",41004000,1000,0.00273696,0,0,1,0,1
"82009",41004500,1000,0.00276795,0,0,1,0,1
"82010",41005000,1000,0.00266937,0,0,0,0,0
"82011",41005500,1000,0.00274781,0,0,0,1,1
"82012",41006000,1000,0.00287031,0,0,1,1,2
"82013",41006500,1000,0.00262417,0,0,1,0,1
"82014",41007000,1000,0.00247426,0,0,0,0,0
"82015",41007500,1000,0.0025028,0,0,0,0,0
"82016",41008000,1000,0.00250247,0,0,0,1,1
"82017",41008500,1000,0.00261895,0,0,0,2,2
"82018",41009000,1000,0.00257048,0,0,0,1,1
"82019",41009500,1000,0.00245253,0,0,0,0,0
"82020",41010000,1000,0.0025506,0,0,0,0,0
"82021",41010500,1000,0.00257028,0,0,0,0,0
"82022",41011000,1000,0.00254863,0,0,0,0,0
"82023",41011500,1000,0.00258429,0,0,0,0,0
"82024",41012000,1000,0.00257688,0,0,0,0,0
"82025",41012500,1000,0.00267013,0,0,0,2,2
"82026",41013000,1000,0.00272572,0,0,0,3,3
"82027",41013500,1000,0.00259951,0,0,0,1,1
"82028",41014000,1000,0.00241993,0,0,0,0,0
"82029",41014500,1000,0.00248483,0,0,0,0,0
"82030",41015000,1000,0.00263258,0,0,0,1,1
"82031",41015500,1000,0.00265447,0,0,0,1,1
"82032",41016000,1000,0.00274622,0,0,1,0,1
"82033",41016500,1000,0.00276733,0,0,1,0,1
"82034",41017000,1000,0.00261126,0,0,0,0,0
"82035",41017500,1000,0.00252106,0,0,0,0,0
"82036",41018000,1000,0.00259045,0,0,0,0,0
"82037",41018500,1000,0.0026125,0,0,0,0,0
"82038",41019000,1000,0.00255804,0,0,0,0,0
"82039",41019500,1000,0.00266023,0,0,0,1,1
"82040",41020000,1000,0.00268807,0,0,0,1,1
"82041",41020500,1000,0.0027424,0,0,2,0,2
"82042",41021000,1000,0.00280094,0,0,2,0,2
"82043",41021500,1000,0.0028235,0,1,0,0,1
"82044",41022000,1000,0.00276907,0,1,0,0,1
"82045",41022500,1000,0.00249985,0,0,0,0,0
"82046",41023000,1000,0.00246324,0,0,0,0,0
"82047",41023500,1000,0.00257337,0,0,0,0,0
"82048",41024000,1000,0.00274693,0,0,1,0,1
"82049",41024500,1000,0.00279951,0,0,1,0,1
"82050",41025000,1000,0.00268808,0,0,0,0,0
"82051",41025500,1000,0.00273496,0,0,0,1,1
"82052",41026000,1000,0.0026543,0,0,0,1,1
"82053",41026500,1000,0.00271782,0,0,1,0,1
"82054",41027000,1000,0.00287363,0,0,2,1,3
"82055",41027500,1000,0.00273414,0,0,1,2,3
"82056",41028000,1000,0.00249759,0,0,0,1,1
"82057",41028500,1000,0.00254853,0,0,0,2,2
"82058",41029000,1000,0.00271251,0,0,0,3,3
"82059",41029500,1000,0.00266696,0,0,0,1,1
"82060",41030000,1000,0.00261611,0,0,0,0,0
"82061",41030500,1000,0.0026074,0,0,0,0,0
"82062",41031000,1000,0.00253241,0,0,0,0,0
"82063",41031500,1000,0.00247829,0,0,0,1,1
"82064",41032000,1000,0.00260845,0,0,0,1,1
"82065",41032500,1000,0.00252502,0,0,0,0,0
"82066",41033000,1000,0.00241949,0,0,0,0,0
"82067",41033500,1000,0.00255671,0,0,0,0,0
"82068",41034000,1000,0.00263747,0,0,0,0,0
"82069",41034500,1000,0.00276861,0,0,1,0,1
"82070",41035000,1000,0.0027158,0,0,1,0,1
"82071",41035500,1000,0.00244051,0,0,0,0,0
"82072",41036000,1000,0.00248342,0,0,0,0,0
"82073",41036500,1000,0.00256883,0,0,0,0,0
"82074",41037000,1000,0.00255884,0,0,0,0,0
"82075",41037500,1000,0.00260966,0,0,0,0,0
"82076",41038000,1000,0.00261416,0,0,0,1,1
"82077",41038500,1000,0.00271152,0,0,1,1,2
"82078",41039000,1000,0.00266616,0,0,1,0,1
"82079",41039500,1000,0.00268623,0,0,0,2,2
"82080",41040000,1000,0.00269289,0,0,0,2,2
"82081",41040500,1000,0.00256077,0,0,0,0,0
"82082",41041000,1000,0.00275092,0,0,0,0,0
"82083",41041500,1000,0.0027603,0,0,0,0,0
"82084",41042000,1000,0.0025256,0,0,0,0,0
"82085",41042500,1000,0.00247725,0,0,0,0,0
"82086",41043000,1000,0.00252135,0,0,0,0,0
"82087",41043500,1000,0.00256523,0,0,0,1,1
"82088",41044000,1000,0.00251289,0,0,0,1,1
"82089",41044500,1000,0.00248094,0,0,0,0,0
"82090",41045000,1000,0.00262188,0,0,0,1,1
"82091",41045500,1000,0.00262521,0,0,0,2,2
"82092",41046000,1000,0.00257153,0,0,0,1,1
"82093",41046500,1000,0.00262891,0,0,0,0,0
"82094",41047000,1000,0.00277263,0,0,0,3,3
"82095",41047500,1000,0.00287134,0,0,0,4,4
"82096",41048000,1000,0.00278102,0,0,0,3,3
"82097",41048500,1000,0.00272094,0,0,0,3,3
"82098",41049000,1000,0.00279723,0,0,1,1,2
"82099",41049500,1000,0.00260891,0,0,1,0,1
"82100",41050000,1000,0.00247924,0,0,0,0,0
"82101",41050500,1000,0.00236617,0,0,0,0,0
"82102",41051000,1000,0.00198858,0,0,0,0,0
"82103",41051500,1000,0.00221739,0,0,0,0,0
"82104",41052000,1000,0.00262795,0,0,0,0,0
"82105",41052500,1000,0.00256287,0,0,0,0,0
"82106",41053000,1000,0.00253201,0,0,0,0,0
"82107",41053500,1000,0.00274165,0,1,0,0,1
"82108",41054000,1000,0.0027059,0,1,0,0,1
"82109",41054500,1000,0.00271045,0,0,0,1,1
"82110",41055000,1000,0.00302182,0,0,1,4,5
"82111",41055500,1000,0.00284914,0,0,1,3,4
"82112",41056000,1000,0.00261943,0,0,0,0,0
"82113",41056500,1000,0.00272411,0,0,1,0,1
"82114",41057000,1000,0.00267278,0,0,1,0,1
"82115",41057500,1000,0.00253483,0,0,0,0,0
"82116",41058000,1000,0.00263169,0,0,0,0,0
"82117",41058500,1000,0.00272958,0,0,0,0,0
"82118",41059000,1000,0.0027222,0,0,0,1,1
"82119",41059500,1000,0.00286165,0,0,0,3,3
"82120",41060000,1000,0.00303189,0,1,0,3,4
"82121",41060500,1000,0.00281329,0,1,0,1,2
"82122",41061000,1000,0.00259494,0,0,0,0,0
"82123",41061500,1000,0.00258202,0,0,0,1,1
"82124",41062000,1000,0.00274459,0,1,0,1,2
"82125",41062500,1000,0.00271115,0,1,0,1,2
"82126",41063000,1000,0.00247037,0,0,0,1,1
"82127",41063500,1000,0.0026153,0,0,0,1,1
"82128",41064000,1000,0.00273806,0,0,0,1,1
"82129",41064500,1000,0.00272931,0,0,0,0,0
"82130",41065000,1000,0.00267104,0,0,0,0,0
"82131",41065500,1000,0.00281066,0,0,0,3,3
"82132",41066000,1000,0.00278642,0,0,0,3,3
"82133",41066500,1000,0.00261931,0,0,0,2,2
"82134",41067000,1000,0.00287204,0,1,0,3,4
"82135",41067500,1000,0.00282071,0,1,0,1,2
"82136",41068000,1000,0.00261723,0,0,0,0,0
"82137",41068500,1000,0.00279878,0,0,0,2,2
"82138",41069000,1000,0.00280528,0,0,0,2,2
"82139",41069500,1000,0.00262255,0,0,0,0,0
"82140",41070000,1000,0.00252573,0,0,0,0,0
"82141",41070500,1000,0.00247191,0,0,0,0,0
"82142",41071000,1000,0.00251582,0,0,0,2,2
"82143",41071500,1000,0.00276865,0,0,0,3,3
"82144",41072000,1000,0.00309956,0,0,0,1,1
"82145",41072500,1000,0.0028793,0,0,0,0,0
"82146",41073000,1000,0.00262512,0,0,0,1,1
"82147",41073500,1000,0.00279693,0,0,0,3,3
"82148",41074000,1000,0.00266659,0,0,0,2,2
"82149",41074500,1000,0.00253558,0,0,0,1,1
"82150",41075000,1000,0.00259456,0,0,0,1,1
"82151",41075500,1000,0.00254948,0,0,0,0,0
"82152",41076000,1000,0.00250901,0,0,0,0,0
"82153",41076500,1000,0.00247766,0,0,0,0,0
"82154",41077000,1000,0.00240924,0,0,0,0,0
"82155",41077500,1000,0.00252645,0,0,0,0,0
"82156",41078000,1000,0.00253827,0,0,0,0,0
"82157",41078500,1000,0.00251098,0,0,0,0,0
"82158",41079000,1000,0.00262929,0,0,0,1,1
"82159",41079500,1000,0.00255146,0,0,0,1,1
"82160",41080000,1000,0.0025581,0,0,0,0,0
"82161",41080500,1000,0.0026198,0,0,0,0,0
"82162",41081000,1000,0.00287935,0,1,0,0,1
"82163",41081500,1000,0.0029375,0,1,0,1,2
"82164",41082000,1000,0.00259073,0,0,0,1,1
"82165",41082500,1000,0.002513,0,0,0,0,0
"82166",41083000,1000,0.00249713,0,0,0,1,1
"82167",41083500,1000,0.00253217,0,0,0,1,1
"82168",41084000,1000,0.00269248,0,0,0,0,0
"82169",41084500,1000,0.00277754,0,0,0,0,0
"82170",41085000,1000,0.0026243,0,0,0,0,0
"82171",41085500,1000,0.00252041,0,0,0,0,0
"82172",41086000,1000,0.0025765,0,0,0,1,1
"82173",41086500,1000,0.00257887,0,0,0,1,1
"82174",41087000,1000,0.00250003,0,0,0,0,0
"82175",41087500,1000,0.00263497,0,0,1,1,2
"82176",41088000,1000,0.00275055,0,0,1,1,2
"82177",41088500,1000,0.0027958,0,0,2,0,2
"82178",41089000,1000,0.00273758,0,0,2,0,2
"82179",41089500,1000,0.00264006,0,0,0,1,1
"82180",41090000,1000,0.0025776,0,0,0,1,1
"82181",41090500,1000,0.00235745,0,0,0,0,0
"82182",41091000,1000,0.00235386,0,0,0,0,0
"82183",41091500,1000,0.00251019,0,0,0,1,1
"82184",41092000,1000,0.00256428,0,0,0,2,2
"82185",41092500,1000,0.00262842,0,0,1,1,2
"82186",41093000,1000,0.00265903,0,0,1,1,2
"82187",41093500,1000,0.00260523,0,0,0,2,2
"82188",41094000,1000,0.00277049,0,0,1,1,2
"82189",41094500,1000,0.00270112,0,0,1,1,2
"82190",41095000,1000,0.00243413,0,0,0,1,1
"82191",41095500,1000,0.00257587,0,0,0,1,1
"82192",41096000,1000,0.0027805,0,0,0,2,2
"82193",41096500,1000,0.00263456,0,0,0,1,1
"82194",41097000,1000,0.00251646,0,0,0,0,0
"82195",41097500,1000,0.00276231,0,0,0,0,0
"82196",41098000,1000,0.00281955,0,0,0,0,0
"82197",41098500,1000,0.0026084,0,0,0,0,0
"82198",41099000,1000,0.00254508,0,0,0,1,1
"82199",41099500,1000,0.00253006,0,0,0,1,1
"82200",41100000,1000,0.00256309,0,0,0,1,1
"82201",41100500,1000,0.00256907,0,0,0,1,1
"82202",41101000,1000,0.00247654,0,0,0,0,0
"82203",41101500,1000,0.00256157,0,0,0,0,0
"82204",41102000,1000,0.00282045,0,0,1,1,2
"82205",41102500,1000,0.00292748,0,0,1,2,3
"82206",41103000,1000,0.00272269,0,0,0,1,1
"82207",41103500,1000,0.00253003,0,0,0,0,0
"82208",41104000,1000,0.00250852,0,0,0,1,1
"82209",41104500,1000,0.00249262,0,0,0,1,1
"82210",41105000,1000,0.00263307,0,0,0,0,0
"82211",41105500,1000,0.00279182,0,0,0,0,0
"82212",41106000,1000,0.00277861,0,0,0,0,0
"82213",41106500,1000,0.00259571,0,0,0,0,0
"82214",41107000,1000,0.00243051,0,0,0,0,0
"82215",41107500,1000,0.00257495,0,0,1,0,1
"82216",41108000,1000,0.00273608,0,0,1,0,1
"82217",41108500,1000,0.00285362,0,0,2,0,2
"82218",41109000,1000,0.00275871,0,0,2,0,2
"82219",41109500,1000,0.00262944,0,0,0,1,1
"82220",41110000,1000,0.00259912,0,0,0,1,1
"82221",41110500,1000,0.00240383,0,0,0,0,0
"82222",41111000,1000,0.00248381,0,0,0,0,0
"82223",41111500,1000,0.00249625,0,0,0,0,0
"82224",41112000,1000,0.00257686,0,0,1,0,1
"82225",41112500,1000,0.00260872,0,0,1,1,2
"82226",41113000,1000,0.00260331,0,0,0,1,1
"82227",41113500,1000,0.00263006,0,0,0,1,1
"82228",41114000,1000,0.00269981,0,0,1,1,2
"82229",41114500,1000,0.00279194,0,0,1,2,3
"82230",41115000,1000,0.00250332,0,0,0,2,2
"82231",41115500,1000,0.00247334,0,0,0,1,1
"82232",41116000,1000,0.00259766,0,0,0,1,1
"82233",41116500,1000,0.00270774,0,0,0,1,1
"82234",41117000,1000,0.00267354,0,0,0,1,1
"82235",41117500,1000,0.00273123,0,0,0,0,0
"82236",41118000,1000,0.0028691,0,0,0,0,0
"82237",41118500,1000,0.00268158,0,0,0,0,0
"82238",41119000,1000,0.0025506,0,0,0,0,0
"82239",41119500,1000,0.00248322,0,0,0,0,0
"82240",41120000,1000,0.0024955,0,0,0,1,1
"82241",41120500,1000,0.00257607,0,0,0,1,1
"82242",41121000,1000,0.00256069,0,0,0,0,0
"82243",41121500,1000,0.00248727,0,0,0,0,0
"82244",41122000,1000,0.00247041,0,0,0,0,0
"82245",41122500,1000,0.0025635,0,0,0,0,0
"82246",41123000,1000,0.00258605,0,0,0,0,0
"82247",41123500,1000,0.00278343,0,0,0,0,0
"82248",41124000,1000,0.00290086,0,0,0,1,1
"82249",41124500,1000,0.00270398,0,0,0,2,2
"82250",41125000,1000,0.0025312,0,0,0,1,1
"82251",41125500,1000,0.00253254,0,0,0,0,0
"82252",41126000,1000,0.00255942,0,0,0,0,0
"82253",41126500,1000,0.00255571,0,0,0,0,0
"82254",41127000,1000,0.0026513,0,0,0,2,2
"82255",41127500,1000,0.00254735,0,0,0,2,2
"82256",41128000,1000,0.00248955,0,0,0,0,0
"82257",41128500,1000,0.00254881,0,0,0,0,0
"82258",41129000,1000,0.00254773,0,0,0,0,0
"82259",41129500,1000,0.0024756,0,0,0,0,0
"82260",41130000,1000,0.00241527,0,0,0,0,0
"82261",41130500,1000,0.00258403,0,0,0,0,0
"82262",41131000,1000,0.00265751,0,0,0,1,1
"82263",41131500,1000,0.00256196,0,0,0,1,1
"82264",41132000,1000,0.0025802,0,0,0,0,0
"82265",41132500,1000,0.00262678,0,0,0,0,0
"82266",41133000,1000,0.00249347,0,0,0,0,0
"82267",41133500,1000,0.00249179,0,0,0,0,0
"82268",41134000,1000,0.00254683,0,0,0,0,0
"82269",41134500,1000,0.0025454,0,0,0,1,1
"82270",41135000,1000,0.00278766,0,0,1,1,2
"82271",41135500,1000,0.00288129,0,0,2,1,3
"82272",41136000,1000,0.0026442,0,0,1,1,2
"82273",41136500,1000,0.00248468,0,0,0,0,0
"82274",41137000,1000,0.00245848,0,0,0,0,0
"82275",41137500,1000,0.00254983,0,0,0,0,0
"82276",41138000,1000,0.00271984,0,0,0,1,1
"82277",41138500,1000,0.00260835,0,0,0,1,1
"82278",41139000,1000,0.00252655,0,0,0,1,1
"82279",41139500,1000,0.00268193,0,0,0,2,2
"82280",41140000,1000,0.00289567,0,0,0,1,1
"82281",41140500,1000,0.00286827,0,0,0,0,0
"82282",41141000,1000,0.00268228,0,0,1,0,1
"82283",41141500,1000,0.0026351,0,0,1,0,1
"82284",41142000,1000,0.00261923,0,0,0,1,1
"82285",41142500,1000,0.00264205,0,0,0,1,1
"82286",41143000,1000,0.00265914,0,0,0,0,0
"82287",41143500,1000,0.00271789,0,1,0,0,1
"82288",41144000,1000,0.00274323,0,1,0,2,3
"82289",41144500,1000,0.00255363,0,0,0,2,2
"82290",41145000,1000,0.00237284,0,0,0,0,0
"82291",41145500,1000,0.00237253,0,0,0,0,0
"82292",41146000,1000,0.0024652,0,0,0,0,0
"82293",41146500,1000,0.00253776,0,0,0,0,0
"82294",41147000,1000,0.00247021,0,0,0,0,0
"82295",41147500,1000,0.00238921,0,0,0,0,0
"82296",41148000,1000,0.00253949,0,0,0,0,0
"82297",41148500,1000,0.00263497,0,0,0,0,0
"82298",41149000,1000,0.00268473,0,0,0,0,0
"82299",41149500,1000,0.00277509,0,0,0,0,0
"82300",41150000,1000,0.00286801,0,1,0,0,1
"82301",41150500,1000,0.00275131,0,1,0,0,1
"82302",41151000,1000,0.00258113,0,0,0,0,0
"82303",41151500,1000,0.00265843,0,0,1,0,1
"82304",41152000,1000,0.00255962,0,0,1,0,1
"82305",41152500,1000,0.00242856,0,0,0,0,0
"82306",41153000,1000,0.00256399,0,0,0,0,0
"82307",41153500,1000,0.00264111,0,0,0,0,0
"82308",41154000,1000,0.00253813,0,0,0,0,0
"82309",41154500,1000,0.00260263,0,0,0,2,2
"82310",41155000,1000,0.00260729,0,0,0,2,2
"82311",41155500,1000,0.00257197,0,0,0,0,0
"82312",41156000,1000,0.00259595,0,0,0,1,1
"82313",41156500,1000,0.00255223,0,0,0,1,1
"82314",41157000,1000,0.00252206,0,0,0,0,0
"82315",41157500,1000,0.00259181,0,0,0,1,1
"82316",41158000,1000,0.00275106,0,0,1,1,2
"82317",41158500,1000,0.00300513,0,0,1,1,2
"82318",41159000,1000,0.00292561,0,0,0,2,2
"82319",41159500,1000,0.00266185,0,0,0,1,1
"82320",41160000,1000,0.00289187,0,0,0,0,0
"82321",41160500,1000,0.00300101,0,0,0,1,1
"82322",41161000,1000,0.00269865,0,0,0,1,1
"82323",41161500,1000,0.0024491,0,0,0,0,0
"82324",41162000,1000,0.00240363,0,0,0,1,1
"82325",41162500,1000,0.00257894,0,0,0,2,2
"82326",41163000,1000,0.00271732,0,0,0,1,1
"82327",41163500,1000,0.00277243,0,0,0,0,0
"82328",41164000,1000,0.00268652,0,0,0,0,0
"82329",41164500,1000,0.00256481,0,0,0,0,0
"82330",41165000,1000,0.00244954,0,0,0,0,0
"82331",41165500,1000,0.00232714,0,0,0,0,0
"82332",41166000,1000,0.0024576,0,0,0,0,0
"82333",41166500,1000,0.0026031,0,0,0,1,1
"82334",41167000,1000,0.00264219,0,0,0,1,1
"82335",41167500,1000,0.00286228,0,0,0,0,0
"82336",41168000,1000,0.00302381,0,0,0,1,1
"82337",41168500,1000,0.00270847,0,0,0,1,1
"82338",41169000,1000,0.00253872,0,0,0,0,0
"82339",41169500,1000,0.00255782,0,0,0,0,0
"82340",41170000,1000,0.0025677,0,0,0,0,0
"82341",41170500,1000,0.00266789,0,0,0,0,0
"82342",41171000,1000,0.00247406,0,0,0,0,0
"82343",41171500,1000,0.00231607,0,0,0,0,0
"82344",41172000,1000,0.00255925,0,0,0,0,0
"82345",41172500,1000,0.00267119,0,0,0,1,1
"82346",41173000,1000,0.00258874,0,0,0,1,1
"82347",41173500,1000,0.0026363,0,0,0,0,0
"82348",41174000,1000,0.00277325,0,0,1,0,1
"82349",41174500,1000,0.00278843,0,0,1,0,1
"82350",41175000,1000,0.00276499,0,0,0,0,0
"82351",41175500,1000,0.00280426,0,0,0,1,1
"82352",41176000,1000,0.00285633,0,0,0,2,2
"82353",41176500,1000,0.00271467,0,0,0,1,1
"82354",41177000,1000,0.00260535,0,0,0,1,1
"82355",41177500,1000,0.00275797,0,0,0,1,1
"82356",41178000,1000,0.00275335,0,0,0,0,0
"82357",41178500,1000,0.00262048,0,0,0,0,0
"82358",41179000,1000,0.00253665,0,0,0,0,0
"82359",41179500,1000,0.0026506,0,0,0,0,0
"82360",41180000,1000,0.0028541,0,0,1,0,1
"82361",41180500,1000,0.00280578,0,0,1,1,2
"82362",41181000,1000,0.00278674,0,0,1,2,3
"82363",41181500,1000,0.00261605,0,0,1,1,2
"82364",41182000,1000,0.00249544,0,0,1,1,2
"82365",41182500,1000,0.00266554,0,0,1,1,2
"82366",41183000,1000,0.00258142,0,0,0,0,0
"82367",41183500,1000,0.00261053,0,0,1,0,1
"82368",41184000,1000,0.00279735,0,0,2,0,2
"82369",41184500,1000,0.00276473,0,0,1,0,1
"82370",41185000,1000,0.00266119,0,0,0,0,0
"82371",41185500,1000,0.00258001,0,0,0,0,0
"82372",41186000,1000,0.00252304,0,0,0,1,1
"82373",41186500,1000,0.00258769,0,0,0,1,1
"82374",41187000,1000,0.00272627,0,0,1,0,1
"82375",41187500,1000,0.00263151,0,0,1,0,1
"82376",41188000,1000,0.0026105,0,0,0,1,1
"82377",41188500,1000,0.00276751,0,0,1,3,4
"82378",41189000,1000,0.00275394,0,0,1,2,3
"82379",41189500,1000,0.00268381,0,0,0,0,0
"82380",41190000,1000,0.0026896,0,0,0,0,0
"82381",41190500,1000,0.00278203,0,0,0,0,0
"82382",41191000,1000,0.00276399,0,0,1,1,2
"82383",41191500,1000,0.00264308,0,0,1,1,2
"82384",41192000,1000,0.00256563,0,0,0,0,0
"82385",41192500,1000,0.00257147,0,0,0,1,1
"82386",41193000,1000,0.00256606,0,0,0,1,1
"82387",41193500,1000,0.00253788,0,0,0,0,0
"82388",41194000,1000,0.00258757,0,0,0,0,0
"82389",41194500,1000,0.00267298,0,0,0,1,1
"82390",41195000,1000,0.00276445,0,0,1,2,3
"82391",41195500,1000,0.00269147,0,0,1,1,2
"82392",41196000,1000,0.0025442,0,0,0,0,0
"82393",41196500,1000,0.00257201,0,0,0,0,0
"82394",41197000,1000,0.00257543,0,0,0,0,0
"82395",41197500,1000,0.00252227,0,0,0,0,0
"82396",41198000,1000,0.00248783,0,0,0,0,0
"82397",41198500,1000,0.00254548,0,0,0,0,0
"82398",41199000,1000,0.00270057,0,0,1,2,3
"82399",41199500,1000,0.00267381,0,0,1,2,3
"82400",41200000,1000,0.00265827,0,0,0,2,2
"82401",41200500,1000,0.00264619,0,0,0,2,2
"82402",41201000,1000,0.00253734,0,0,0,0,0
"82403",41201500,1000,0.00263829,0,0,0,1,1
"82404",41202000,1000,0.00258956,0,0,0,1,1
"82405",41202500,1000,0.00259474,0,0,0,0,0
"82406",41203000,1000,0.00263807,0,0,0,0,0
"82407",41203500,1000,0.00258539,0,0,0,0,0
"82408",41204000,1000,0.00271622,0,0,0,0,0
"82409",41204500,1000,0.00273501,0,0,1,0,1
"82410",41205000,1000,0.00273876,0,0,1,0,1
"82411",41205500,1000,0.00275476,0,0,0,1,1
"82412",41206000,1000,0.00278801,0,0,0,2,2
"82413",41206500,1000,0.00281576,0,0,1,1,2
"82414",41207000,1000,0.00273669,0,0,1,0,1
"82415",41207500,1000,0.0025945,0,0,0,0,0
"82416",41208000,1000,0.00242327,0,0,0,0,0
"82417",41208500,1000,0.00251986,0,0,0,0,0
"82418",41209000,1000,0.00256162,0,0,0,0,0
"82419",41209500,1000,0.00254677,0,0,0,1,1
"82420",41210000,1000,0.00268201,0,0,0,1,1
"82421",41210500,1000,0.0026051,0,0,0,0,0
"82422",41211000,1000,0.00245223,0,0,0,0,0
"82423",41211500,1000,0.00258183,0,0,0,1,1
"82424",41212000,1000,0.00261106,0,0,0,1,1
"82425",41212500,1000,0.00257541,0,0,0,0,0
"82426",41213000,1000,0.00270958,0,0,0,0,0
"82427",41213500,1000,0.00303424,0,1,0,4,5
"82428",41214000,1000,0.00298073,0,1,0,6,7
"82429",41214500,1000,0.00267827,0,0,0,2,2
"82430",41215000,1000,0.00260852,0,0,0,0,0
"82431",41215500,1000,0.00254656,0,0,0,0,0
"82432",41216000,1000,0.00265049,0,0,0,1,1
"82433",41216500,1000,0.00271404,0,0,0,1,1
"82434",41217000,1000,0.00270664,0,0,0,0,0
"82435",41217500,1000,0.0026249,0,0,0,0,0
"82436",41218000,1000,0.00258084,0,0,0,0,0
"82437",41218500,1000,0.00269126,0,0,0,2,2
"82438",41219000,1000,0.00288341,0,0,1,3,4
"82439",41219500,1000,0.00282352,0,0,1,2,3
"82440",41220000,1000,0.00263655,0,0,0,1,1
"82441",41220500,1000,0.00260838,0,0,0,0,0
"82442",41221000,1000,0.00259124,0,0,0,0,0
"82443",41221500,1000,0.00264286,0,0,0,0,0
"82444",41222000,1000,0.00257925,0,0,0,0,0
"82445",41222500,1000,0.00251412,0,0,0,1,1
"82446",41223000,1000,0.00264987,0,0,0,1,1
"82447",41223500,1000,0.00254612,0,0,0,0,0
"82448",41224000,1000,0.00244728,0,0,0,0,0
"82449",41224500,1000,0.00274193,0,1,0,0,1
"82450",41225000,1000,0.00280893,0,1,0,0,1
"82451",41225500,1000,0.00258692,0,0,0,0,0
"82452",41226000,1000,0.00260166,0,0,0,1,1
"82453",41226500,1000,0.00276095,0,0,0,1,1
"82454",41227000,1000,0.0027753,0,0,0,0,0
"82455",41227500,1000,0.00260502,0,0,0,0,0
"82456",41228000,1000,0.00251719,0,0,0,0,0
"82457",41228500,1000,0.00261519,0,0,0,0,0
"82458",41229000,1000,0.00263889,0,0,0,0,0
"82459",41229500,1000,0.00270684,0,0,1,1,2
"82460",41230000,1000,0.00280917,0,0,1,2,3
"82461",41230500,1000,0.0027404,0,0,0,2,2
"82462",41231000,1000,0.00261256,0,0,0,1,1
"82463",41231500,1000,0.00260447,0,0,0,0,0
"82464",41232000,1000,0.00266067,0,0,0,0,0
"82465",41232500,1000,0.0027645,0,0,0,0,0
"82466",41233000,1000,0.00269028,0,0,0,0,0
"82467",41233500,1000,0.00258874,0,0,0,0,0
"82468",41234000,1000,0.00258381,0,0,0,0,0
"82469",41234500,1000,0.00258985,0,0,0,1,1
"82470",41235000,1000,0.00266488,0,0,0,1,1
"82471",41235500,1000,0.00255412,0,0,0,0,0
"82472",41236000,1000,0.00253299,0,0,0,1,1
"82473",41236500,1000,0.00260827,0,0,0,1,1
"82474",41237000,1000,0.00265329,0,0,0,1,1
"82475",41237500,1000,0.00270627,0,0,0,1,1
"82476",41238000,1000,0.00277832,0,0,0,0,0
"82477",41238500,1000,0.00272881,0,0,0,0,0
"82478",41239000,1000,0.00259606,0,0,0,0,0
"82479",41239500,1000,0.00263663,0,0,0,1,1
"82480",41240000,1000,0.00274534,0,0,0,1,1
"82481",41240500,1000,0.00294448,0,0,0,1,1
"82482",41241000,1000,0.00286276,0,0,0,1,1
"82483",41241500,1000,0.00266864,0,0,0,0,0
"82484",41242000,1000,0.00264262,0,0,0,0,0
"82485",41242500,1000,0.00264462,0,0,0,0,0
"82486",41243000,1000,0.00264848,0,0,0,0,0
"82487",41243500,1000,0.00257399,0,0,0,0,0
"82488",41244000,1000,0.00263746,0,0,0,0,0
"82489",41244500,1000,0.00257916,0,0,0,0,0
"82490",41245000,1000,0.00255651,0,0,0,1,1
"82491",41245500,1000,0.0025892,0,0,0,1,1
"82492",41246000,1000,0.00265152,0,0,1,0,1
"82493",41246500,1000,0.00269567,0,0,1,1,2
"82494",41247000,1000,0.00259683,0,0,0,1,1
"82495",41247500,1000,0.0024954,0,0,0,0,0
"82496",41248000,1000,0.002541,0,0,0,1,1
"82497",41248500,1000,0.0026093,0,0,0,1,1
"82498",41249000,1000,0.00275499,0,0,0,1,1
"82499",41249500,1000,0.00289258,0,0,0,1,1
"82500",41250000,1000,0.00274575,0,0,0,0,0
"82501",41250500,1000,0.00259467,0,0,0,0,0
"82502",41251000,1000,0.00255099,0,0,0,0,0
"82503",41251500,1000,0.00262723,0,0,0,0,0
"82504",41252000,1000,0.00263063,0,0,0,0,0
"82505",41252500,1000,0.00260285,0,0,0,0,0
"82506",41253000,1000,0.00261568,0,0,0,1,1
"82507",41253500,1000,0.00260273,0,0,0,1,1
"82508",41254000,1000,0.0026678,0,0,1,2,3
"82509",41254500,1000,0.00269248,0,0,1,2,3
"82510",41255000,1000,0.00270099,0,0,0,0,0
"82511",41255500,1000,0.00279517,0,0,0,0,0
"82512",41256000,1000,0.00262932,0,0,0,0,0
"82513",41256500,1000,0.00245847,0,0,0,0,0
"82514",41257000,1000,0.00256776,0,0,0,0,0
"82515",41257500,1000,0.00259788,0,0,0,0,0
"82516",41258000,1000,0.00254098,0,0,0,0,0
"82517",41258500,1000,0.0025757,0,0,0,0,0
"82518",41259000,1000,0.00255753,0,0,0,0,0
"82519",41259500,1000,0.00257013,0,0,0,1,1
"82520",41260000,1000,0.00263465,0,0,0,1,1
"82521",41260500,1000,0.00253173,0,0,0,0,0
"82522",41261000,1000,0.00249457,0,0,0,0,0
"82523",41261500,1000,0.00257716,0,0,0,1,1
"82524",41262000,1000,0.00266061,0,0,0,1,1
"82525",41262500,1000,0.00265628,0,0,0,0,0
"82526",41263000,1000,0.00254699,0,0,0,0,0
"82527",41263500,1000,0.00267409,0,0,1,1,2
"82528",41264000,1000,0.00266003,0,0,1,1,2
"82529",41264500,1000,0.00260713,0,0,0,1,1
"82530",41265000,1000,0.00274715,0,0,0,1,1
"82531",41265500,1000,0.00281562,0,0,0,0,0
"82532",41266000,1000,0.00279331,0,0,0,0,0
"82533",41266500,1000,0.00260526,0,0,0,0,0
"82534",41267000,1000,0.0024882,0,0,0,0,0
"82535",41267500,1000,0.00254808,0,0,0,0,0
"82536",41268000,1000,0.00254167,0,0,0,0,0
"82537",41268500,1000,0.00252015,0,0,0,0,0
"82538",41269000,1000,0.00255066,0,0,0,0,0
"82539",41269500,1000,0.00271122,0,0,1,0,1
"82540",41270000,1000,0.00275698,0,0,2,0,2
"82541",41270500,1000,0.00263097,0,0,1,0,1
"82542",41271000,1000,0.00268603,0,0,0,0,0
"82543",41271500,1000,0.00278391,0,0,0,0,0
"82544",41272000,1000,0.00266568,0,0,0,0,0
"82545",41272500,1000,0.00257708,0,0,0,2,2
"82546",41273000,1000,0.00252632,0,0,0,2,2
"82547",41273500,1000,0.00248948,0,0,0,0,0
"82548",41274000,1000,0.00264821,0,0,0,0,0
"82549",41274500,1000,0.00268231,0,0,1,0,1
"82550",41275000,1000,0.00274476,0,0,1,1,2
"82551",41275500,1000,0.00281455,0,0,0,1,1
"82552",41276000,1000,0.00274312,0,0,0,0,0
"82553",41276500,1000,0.00260375,0,0,0,0,0
"82554",41277000,1000,0.00259669,0,0,0,1,1
"82555",41277500,1000,0.00258057,0,0,0,1,1
"82556",41278000,1000,0.00276731,0,0,0,2,2
"82557",41278500,1000,0.00288531,0,0,0,3,3
"82558",41279000,1000,0.00272741,0,0,1,1,2
"82559",41279500,1000,0.00269342,0,0,1,0,1
"82560",41280000,1000,0.00276776,0,0,0,2,2
"82561",41280500,1000,0.00283867,0,0,0,2,2
"82562",41281000,1000,0.00266759,0,0,0,0,0
"82563",41281500,1000,0.00260568,0,0,0,1,1
"82564",41282000,1000,0.00268034,0,0,0,1,1
"82565",41282500,1000,0.00264405,0,0,0,0,0
"82566",41283000,1000,0.00260053,0,0,0,0,0
"82567",41283500,1000,0.00266502,0,0,0,0,0
"82568",41284000,1000,0.00262199,0,0,0,0,0
"82569",41284500,1000,0.00252859,0,0,0,0,0
"82570",41285000,1000,0.00256266,0,0,0,0,0
"82571",41285500,1000,0.00253477,0,0,0,1,1
"82572",41286000,1000,0.00249699,0,0,0,1,1
"82573",41286500,1000,0.00266796,0,0,1,0,1
"82574",41287000,1000,0.00263008,0,0,1,0,1
"82575",41287500,1000,0.00258105,0,0,1,0,1
"82576",41288000,1000,0.00282913,0,0,2,2,4
"82577",41288500,1000,0.00280043,0,0,1,4,5
"82578",41289000,1000,0.00272827,0,0,0,3,3
"82579",41289500,1000,0.00268315,0,0,0,2,2
"82580",41290000,1000,0.00261085,0,0,0,1,1
"82581",41290500,1000,0.00260441,0,0,0,2,2
"82582",41291000,1000,0.00258712,0,0,0,2,2
"82583",41291500,1000,0.00260377,0,0,0,0,0
"82584",41292000,1000,0.00269117,0,0,1,0,1
"82585",41292500,1000,0.00279781,0,0,1,3,4
"82586",41293000,1000,0.00264348,0,0,0,3,3
"82587",41293500,1000,0.0025616,0,0,0,2,2
"82588",41294000,1000,0.00267015,0,0,0,3,3
"82589",41294500,1000,0.00257452,0,0,0,1,1
"82590",41295000,1000,0.0026556,0,0,1,1,2
"82591",41295500,1000,0.00270335,0,0,1,1,2
"82592",41296000,1000,0.00261871,0,0,0,1,1
"82593",41296500,1000,0.0024815,0,0,0,1,1
"82594",41297000,1000,0.00239451,0,0,0,0,0
"82595",41297500,1000,0.00253191,0,0,0,1,1
"82596",41298000,1000,0.00261084,0,0,0,1,1
"82597",41298500,1000,0.00264896,0,0,0,1,1
"82598",41299000,1000,0.00255684,0,0,0,2,2
"82599",41299500,1000,0.00269192,0,0,1,1,2
"82600",41300000,1000,0.00279029,0,0,1,0,1
"82601",41300500,1000,0.00269272,0,0,0,1,1
"82602",41301000,1000,0.00271796,0,0,0,1,1
"82603",41301500,1000,0.00275931,0,0,0,1,1
"82604",41302000,1000,0.00277647,0,0,0,1,1
"82605",41302500,1000,0.00288684,0,1,0,0,1
"82606",41303000,1000,0.00288125,0,1,0,0,1
"82607",41303500,1000,0.00263249,0,0,0,0,0
"82608",41304000,1000,0.0025415,0,0,0,0,0
"82609",41304500,1000,0.00259519,0,0,0,0,0
"82610",41305000,1000,0.0025632,0,0,0,0,0
"82611",41305500,1000,0.00267686,0,0,1,1,2
"82612",41306000,1000,0.00284369,0,0,1,1,2
"82613",41306500,1000,0.00282706,0,0,1,0,1
"82614",41307000,1000,0.00277447,0,0,1,0,1
"82615",41307500,1000,0.00261802,0,0,0,0,0
"82616",41308000,1000,0.00260952,0,0,0,0,0
"82617",41308500,1000,0.00279761,0,0,0,0,0
"82618",41309000,1000,0.00275835,0,0,0,0,0
"82619",41309500,1000,0.00263333,0,0,0,0,0
"82620",41310000,1000,0.00248132,0,0,0,0,0
"82621",41310500,1000,0.00254527,0,0,0,1,1
"82622",41311000,1000,0.00276093,0,0,0,2,2
"82623",41311500,1000,0.00280823,0,0,1,1,2
"82624",41312000,1000,0.00281758,0,0,1,0,1
"82625",41312500,1000,0.00281109,0,0,1,1,2
"82626",41313000,1000,0.0026568,0,0,1,1,2
"82627",41313500,1000,0.00242107,0,0,0,0,0
"82628",41314000,1000,0.00270117,0,1,0,0,1
"82629",41314500,1000,0.00278238,0,1,0,0,1
"82630",41315000,1000,0.00288063,0,0,0,1,1
"82631",41315500,1000,0.00293753,0,0,0,1,1
"82632",41316000,1000,0.00263503,0,0,0,0,0
"82633",41316500,1000,0.00262872,0,0,0,0,0
"82634",41317000,1000,0.00265891,0,0,0,0,0
"82635",41317500,1000,0.00285656,0,0,2,1,3
"82636",41318000,1000,0.00300248,0,0,2,2,4
"82637",41318500,1000,0.00271709,0,0,0,1,1
"82638",41319000,1000,0.00241446,0,0,0,0,0
"82639",41319500,1000,0.00241221,0,0,0,0,0
"82640",41320000,1000,0.0024837,0,0,0,0,0
"82641",41320500,1000,0.00256295,0,0,0,0,0
"82642",41321000,1000,0.00259056,0,0,0,0,0
"82643",41321500,1000,0.00248245,0,0,0,1,1
"82644",41322000,1000,0.0024783,0,0,0,2,2
"82645",41322500,1000,0.00256752,0,0,0,1,1
"82646",41323000,1000,0.00268259,0,0,0,0,0
"82647",41323500,1000,0.0027869,0,0,0,0,0
"82648",41324000,1000,0.00286892,0,0,0,1,1
"82649",41324500,1000,0.00279152,0,0,0,2,2
"82650",41325000,1000,0.00273883,0,0,0,1,1
"82651",41325500,1000,0.00288657,0,0,1,0,1
"82652",41326000,1000,0.00279616,0,0,1,0,1
"82653",41326500,1000,0.00268955,0,0,0,0,0
"82654",41327000,1000,0.00272452,0,0,0,0,0
"82655",41327500,1000,0.00267152,0,0,0,0,0
"82656",41328000,1000,0.00268977,0,0,0,1,1
"82657",41328500,1000,0.00273051,0,0,0,1,1
"82658",41329000,1000,0.00271202,0,0,0,0,0
"82659",41329500,1000,0.00265752,0,0,0,0,0
"82660",41330000,1000,0.00254576,0,0,0,1,1
"82661",41330500,1000,0.00260046,0,0,0,1,1
"82662",41331000,1000,0.00269397,0,0,0,0,0
"82663",41331500,1000,0.00277122,0,0,0,0,0
"82664",41332000,1000,0.00282379,0,0,0,0,0
"82665",41332500,1000,0.00268362,0,0,0,0,0
"82666",41333000,1000,0.00267043,0,0,0,0,0
"82667",41333500,1000,0.00273793,0,0,0,0,0
"82668",41334000,1000,0.00270219,0,0,0,0,0
"82669",41334500,1000,0.00274884,0,0,0,0,0
"82670",41335000,1000,0.00267986,0,0,0,0,0
"82671",41335500,1000,0.00302518,0,1,0,1,2
"82672",41336000,1000,0.00306131,0,1,0,1,2
"82673",41336500,1000,0.0025982,0,0,0,0,0
"82674",41337000,1000,0.00259467,0,0,0,0,0
"82675",41337500,1000,0.00253275,0,0,0,1,1
"82676",41338000,1000,0.00248434,0,0,0,2,2
"82677",41338500,1000,0.00262381,0,0,0,1,1
"82678",41339000,1000,0.002602,0,0,0,0,0
"82679",41339500,1000,0.00256561,0,0,0,0,0
"82680",41340000,1000,0.00270225,0,0,0,1,1
"82681",41340500,1000,0.00270808,0,0,0,1,1
"82682",41341000,1000,0.00266437,0,0,0,0,0
"82683",41341500,1000,0.00267552,0,0,0,0,0
"82684",41342000,1000,0.00268047,0,0,0,0,0
"82685",41342500,1000,0.0027073,0,0,0,0,0
"82686",41343000,1000,0.00265817,0,0,0,0,0
"82687",41343500,1000,0.00294472,0,2,0,1,3
"82688",41344000,1000,0.00299164,0,2,0,1,3
"82689",41344500,1000,0.00266671,0,0,0,0,0
"82690",41345000,1000,0.00265321,0,0,0,0,0
"82691",41345500,1000,0.00264732,0,0,0,0,0
"82692",41346000,1000,0.00269509,0,0,0,0,0
"82693",41346500,1000,0.00283837,0,0,0,0,0
"82694",41347000,1000,0.0027964,0,0,0,1,1
"82695",41347500,1000,0.00261857,0,0,0,1,1
"82696",41348000,1000,0.00260897,0,0,0,0,0
"82697",41348500,1000,0.00269891,0,0,0,1,1
"82698",41349000,1000,0.00277305,0,0,0,1,1
"82699",41349500,1000,0.00268927,0,0,0,0,0
"82700",41350000,1000,0.00266303,0,0,0,1,1
"82701",41350500,1000,0.0028219,0,0,0,1,1
"82702",41351000,1000,0.00291146,0,0,0,2,2
"82703",41351500,1000,0.00275382,0,0,0,2,2
"82704",41352000,1000,0.00260639,0,0,0,0,0
"82705",41352500,1000,0.00272622,0,0,0,0,0
"82706",41353000,1000,0.00261334,0,0,0,0,0
"82707",41353500,1000,0.00249288,0,0,0,0,0
"82708",41354000,1000,0.00258766,0,0,0,1,1
"82709",41354500,1000,0.00249815,0,0,0,1,1
"82710",41355000,1000,0.00238623,0,0,0,0,0
"82711",41355500,1000,0.00234005,0,0,0,0,0
"82712",41356000,1000,0.00242898,0,0,0,0,0
"82713",41356500,1000,0.00257413,0,0,0,0,0
"82714",41357000,1000,0.00253856,0,0,0,0,0
"82715",41357500,1000,0.00248614,0,0,0,0,0
"82716",41358000,1000,0.00249576,0,0,0,0,0
"82717",41358500,1000,0.00254423,0,0,0,0,0
"82718",41359000,1000,0.00256699,0,0,0,0,0
"82719",41359500,1000,0.00247799,0,0,0,0,0
"82720",41360000,1000,0.0026049,0,1,0,0,1
"82721",41360500,1000,0.00279493,0,1,1,1,3
"82722",41361000,1000,0.00276754,0,0,1,1,2
"82723",41361500,1000,0.00271106,0,0,0,1,1
"82724",41362000,1000,0.00270962,0,0,0,2,2
"82725",41362500,1000,0.00264909,0,0,0,1,1
"82726",41363000,1000,0.00266976,0,0,0,2,2
"82727",41363500,1000,0.00279814,0,0,0,2,2
"82728",41364000,1000,0.00274803,0,0,0,0,0
"82729",41364500,1000,0.00273183,0,0,0,0,0
"82730",41365000,1000,0.00283029,0,0,0,1,1
"82731",41365500,1000,0.00270257,0,0,0,1,1
"82732",41366000,1000,0.00262757,0,0,0,1,1
"82733",41366500,1000,0.00276901,0,0,0,2,2
"82734",41367000,1000,0.00281216,0,0,0,4,4
"82735",41367500,1000,0.00268366,0,0,0,3,3
"82736",41368000,1000,0.00253287,0,0,0,0,0
"82737",41368500,1000,0.00256862,0,0,0,0,0
"82738",41369000,1000,0.00280981,0,0,0,1,1
"82739",41369500,1000,0.00289134,0,0,0,1,1
"82740",41370000,1000,0.00271178,0,0,0,0,0
"82741",41370500,1000,0.00269911,0,0,0,2,2
"82742",41371000,1000,0.00284582,0,0,1,3,4
"82743",41371500,1000,0.0028238,0,0,1,3,4
"82744",41372000,1000,0.00275214,0,0,1,2,3
"82745",41372500,1000,0.00258043,0,0,1,0,1
"82746",41373000,1000,0.00262266,0,0,0,1,1
"82747",41373500,1000,0.00273164,0,0,0,1,1
"82748",41374000,1000,0.00267567,0,0,0,0,0
"82749",41374500,1000,0.00276389,0,0,0,1,1
"82750",41375000,1000,0.00274117,0,0,0,1,1
"82751",41375500,1000,0.00272637,0,0,0,2,2
"82752",41376000,1000,0.0026731,0,0,0,2,2
"82753",41376500,1000,0.00258818,0,0,0,1,1
"82754",41377000,1000,0.00262579,0,0,0,1,1
"82755",41377500,1000,0.00261725,0,0,0,0,0
"82756",41378000,1000,0.00258992,0,0,0,0,0
"82757",41378500,1000,0.00278502,0,0,0,2,2
"82758",41379000,1000,0.00298527,0,0,0,2,2
"82759",41379500,1000,0.00286993,0,0,0,1,1
"82760",41380000,1000,0.00265123,0,0,0,1,1
"82761",41380500,1000,0.00265906,0,0,0,0,0
"82762",41381000,1000,0.00288793,0,0,0,1,1
"82763",41381500,1000,0.00293834,0,0,0,1,1
"82764",41382000,1000,0.00277463,0,0,0,0,0
"82765",41382500,1000,0.00267819,0,0,0,0,0
"82766",41383000,1000,0.00267478,0,0,0,1,1
"82767",41383500,1000,0.002643,0,0,0,1,1
"82768",41384000,1000,0.00256273,0,0,0,0,0
"82769",41384500,1000,0.00249423,0,0,0,0,0
"82770",41385000,1000,0.00240359,0,0,0,0,0
"82771",41385500,1000,0.00256318,0,0,1,0,1
"82772",41386000,1000,0.00263682,0,0,1,0,1
"82773",41386500,1000,0.00260247,0,0,0,0,0
"82774",41387000,1000,0.00274672,0,0,0,2,2
"82775",41387500,1000,0.00275796,0,0,0,2,2
"82776",41388000,1000,0.00263744,0,0,0,0,0
"82777",41388500,1000,0.00267998,0,0,0,1,1
"82778",41389000,1000,0.00268875,0,0,0,1,1
"82779",41389500,1000,0.00272395,0,1,0,0,1
"82780",41390000,1000,0.00288387,0,1,1,0,2
"82781",41390500,1000,0.00272792,0,0,1,0,1
"82782",41391000,1000,0.00257954,0,0,0,0,0
"82783",41391500,1000,0.00249874,0,0,0,0,0
"82784",41392000,1000,0.00277373,0,1,1,1,3
"82785",41392500,1000,0.00284322,0,1,1,2,4
"82786",41393000,1000,0.00266929,0,0,0,1,1
"82787",41393500,1000,0.00277516,0,0,0,0,0
"82788",41394000,1000,0.00269643,0,0,0,0,0
"82789",41394500,1000,0.00268962,0,0,0,0,0
"82790",41395000,1000,0.00280476,0,0,0,0,0
"82791",41395500,1000,0.00283557,0,0,0,1,1
"82792",41396000,1000,0.00281547,0,0,0,2,2
"82793",41396500,1000,0.00276815,0,0,0,1,1
"82794",41397000,1000,0.00276962,0,0,0,0,0
"82795",41397500,1000,0.00280429,0,0,0,2,2
"82796",41398000,1000,0.00273025,0,0,0,2,2
"82797",41398500,1000,0.00259815,0,0,0,0,0
"82798",41399000,1000,0.00267306,0,0,0,2,2
"82799",41399500,1000,0.00279557,0,0,0,3,3
"82800",41400000,1000,0.00262596,0,0,0,1,1
"82801",41400500,1000,0.00264562,0,0,0,1,1
"82802",41401000,1000,0.00279703,0,0,1,2,3
"82803",41401500,1000,0.00269779,0,0,1,2,3
"82804",41402000,1000,0.00258601,0,0,0,1,1
"82805",41402500,1000,0.00258262,0,0,0,1,1
"82806",41403000,1000,0.002644,0,0,0,1,1
"82807",41403500,1000,0.00286107,0,1,0,1,2
"82808",41404000,1000,0.00293502,0,1,0,2,3
"82809",41404500,1000,0.00286388,0,0,0,1,1
"82810",41405000,1000,0.00271387,0,0,0,0,0
"82811",41405500,1000,0.00257162,0,0,0,0,0
"82812",41406000,1000,0.00262997,0,0,0,0,0
"82813",41406500,1000,0.00271674,0,0,0,2,2
"82814",41407000,1000,0.00292673,0,0,1,2,3
"82815",41407500,1000,0.00296803,0,0,1,1,2
"82816",41408000,1000,0.00292027,0,0,0,2,2
"82817",41408500,1000,0.00295371,0,0,0,2,2
"82818",41409000,1000,0.00277402,0,0,0,1,1
"82819",41409500,1000,0.00270917,0,0,0,0,0
"82820",41410000,1000,0.00279122,0,0,0,2,2
"82821",41410500,1000,0.00267608,0,0,0,3,3
"82822",41411000,1000,0.00273056,0,0,0,2,2
"82823",41411500,1000,0.00278777,0,0,0,2,2
"82824",41412000,1000,0.00261183,0,0,0,1,1
"82825",41412500,1000,0.00249716,0,0,0,0,0
"82826",41413000,1000,0.00243566,0,0,0,0,0
"82827",41413500,1000,0.00264953,0,0,1,0,1
"82828",41414000,1000,0.00276074,0,0,1,0,1
"82829",41414500,1000,0.00276566,0,0,0,3,3
"82830",41415000,1000,0.0027761,0,0,0,3,3
"82831",41415500,1000,0.00259885,0,0,0,1,1
"82832",41416000,1000,0.00266799,0,0,0,2,2
"82833",41416500,1000,0.00274699,0,0,0,1,1
"82834",41417000,1000,0.0027298,0,0,0,2,2
"82835",41417500,1000,0.00269681,0,0,1,2,3
"82836",41418000,1000,0.00265016,0,0,1,0,1
"82837",41418500,1000,0.00269736,0,0,0,0,0
"82838",41419000,1000,0.00266977,0,0,0,1,1
"82839",41419500,1000,0.00274728,0,0,0,2,2
"82840",41420000,1000,0.00279304,0,0,0,1,1
"82841",41420500,1000,0.00269819,0,0,0,0,0
"82842",41421000,1000,0.00276107,0,0,0,0,0
"82843",41421500,1000,0.00289982,0,0,0,0,0
"82844",41422000,1000,0.00296066,0,0,0,0,0
"82845",41422500,1000,0.00288582,0,0,0,0,0
"82846",41423000,1000,0.0027334,0,0,0,0,0
"82847",41423500,1000,0.0026693,0,0,0,0,0
"82848",41424000,1000,0.00282406,0,0,0,2,2
"82849",41424500,1000,0.0030524,0,0,1,3,4
"82850",41425000,1000,0.0028908,0,0,1,1,2
"82851",41425500,1000,0.00278284,0,0,1,1,2
"82852",41426000,1000,0.00275607,0,0,1,1,2
"82853",41426500,1000,0.00254995,0,0,0,0,0
"82854",41427000,1000,0.00252077,0,0,0,0,0
"82855",41427500,1000,0.00269155,0,0,0,2,2
"82856",41428000,1000,0.00272261,0,0,0,3,3
"82857",41428500,1000,0.00260106,0,0,0,2,2
"82858",41429000,1000,0.0025892,0,0,0,1,1
"82859",41429500,1000,0.00279343,0,0,0,2,2
"82860",41430000,1000,0.00285816,0,0,0,2,2
"82861",41430500,1000,0.00274553,0,0,0,3,3
"82862",41431000,1000,0.00263603,0,0,0,3,3
"82863",41431500,1000,0.00247054,0,0,0,0,0
"82864",41432000,1000,0.00246274,0,0,0,0,0
"82865",41432500,1000,0.00267279,0,0,1,1,2
"82866",41433000,1000,0.00278208,0,0,1,1,2
"82867",41433500,1000,0.00271237,0,0,0,1,1
"82868",41434000,1000,0.00270476,0,0,0,1,1
"82869",41434500,1000,0.00267395,0,0,0,0,0
"82870",41435000,1000,0.00266066,0,0,0,0,0
"82871",41435500,1000,0.00261692,0,0,0,0,0
"82872",41436000,1000,0.00259178,0,0,0,0,0
"82873",41436500,1000,0.0025841,0,0,0,0,0
"82874",41437000,1000,0.00264792,0,0,0,0,0
"82875",41437500,1000,0.00275886,0,0,0,0,0
"82876",41438000,1000,0.00279223,0,0,0,0,0
"82877",41438500,1000,0.0028651,0,0,0,0,0
"82878",41439000,1000,0.00285548,0,0,0,0,0
"82879",41439500,1000,0.00270743,0,0,0,0,0
"82880",41440000,1000,0.0027381,0,0,0,0,0
"82881",41440500,1000,0.00293354,0,0,1,0,1
"82882",41441000,1000,0.00292355,0,0,1,2,3
"82883",41441500,1000,0.00269104,0,0,0,2,2
"82884",41442000,1000,0.0026173,0,0,0,0,0
"82885",41442500,1000,0.00262579,0,0,0,0,0
"82886",41443000,1000,0.00262486,0,0,0,0,0
"82887",41443500,1000,0.00269439,0,0,0,0,0
"82888",41444000,1000,0.00275618,0,0,0,1,1
"82889",41444500,1000,0.00269181,0,0,0,1,1
"82890",41445000,1000,0.00263532,0,0,0,0,0
"82891",41445500,1000,0.00267381,0,0,0,0,0
"82892",41446000,1000,0.00279404,0,0,1,2,3
"82893",41446500,1000,0.00277091,0,0,1,2,3
"82894",41447000,1000,0.0026129,0,0,0,0,0
"82895",41447500,1000,0.00265092,0,0,0,2,2
"82896",41448000,1000,0.00290003,0,0,1,2,3
"82897",41448500,1000,0.00309247,0,0,1,1,2
"82898",41449000,1000,0.0031367,0,0,0,2,2
"82899",41449500,1000,0.00290723,0,0,0,3,3
"82900",41450000,1000,0.00259873,0,0,0,2,2
"82901",41450500,1000,0.00273696,0,0,1,0,1
"82902",41451000,1000,0.00271192,0,0,1,0,1
"82903",41451500,1000,0.00262347,0,0,0,0,0
"82904",41452000,1000,0.002652,0,0,0,0,0
"82905",41452500,1000,0.00253992,0,0,0,1,1
"82906",41453000,1000,0.00263139,0,0,0,1,1
"82907",41453500,1000,0.00274554,0,0,0,0,0
"82908",41454000,1000,0.00280322,0,0,0,1,1
"82909",41454500,1000,0.00271925,0,0,0,1,1
"82910",41455000,1000,0.00275145,0,0,0,1,1
"82911",41455500,1000,0.00287453,0,0,1,1,2
"82912",41456000,1000,0.00269669,0,0,1,0,1
"82913",41456500,1000,0.00258561,0,0,0,0,0
"82914",41457000,1000,0.00263992,0,0,0,0,0
"82915",41457500,1000,0.00267743,0,0,0,0,0
"82916",41458000,1000,0.00265891,0,0,0,1,1
"82917",41458500,1000,0.00268367,0,0,0,1,1
"82918",41459000,1000,0.00259614,0,0,0,0,0
"82919",41459500,1000,0.00250899,0,0,0,1,1
"82920",41460000,1000,0.00259016,0,0,0,1,1
"82921",41460500,1000,0.00269751,0,0,0,0,0
"82922",41461000,1000,0.00264616,0,0,0,0,0
"82923",41461500,1000,0.00258959,0,0,0,0,0
"82924",41462000,1000,0.00272575,0,0,0,2,2
"82925",41462500,1000,0.00286608,0,0,0,2,2
"82926",41463000,1000,0.00288625,0,0,1,1,2
"82927",41463500,1000,0.00283509,0,0,1,2,3
"82928",41464000,1000,0.00288881,0,0,0,2,2
"82929",41464500,1000,0.00273143,0,0,0,1,1
"82930",41465000,1000,0.00261395,0,0,0,0,0
"82931",41465500,1000,0.00282575,0,0,0,1,1
"82932",41466000,1000,0.00280807,0,0,0,1,1
"82933",41466500,1000,0.00276873,0,0,0,1,1
"82934",41467000,1000,0.00281474,0,0,0,2,2
"82935",41467500,1000,0.00271204,0,0,0,1,1
"82936",41468000,1000,0.00293101,0,1,0,0,1
"82937",41468500,1000,0.00292595,0,1,0,0,1
"82938",41469000,1000,0.00261556,0,0,0,0,0
"82939",41469500,1000,0.00257465,0,0,0,0,0
"82940",41470000,1000,0.00263476,0,0,0,0,0
"82941",41470500,1000,0.00266042,0,0,0,0,0
"82942",41471000,1000,0.00260668,0,0,0,0,0
"82943",41471500,1000,0.00273697,0,0,1,0,1
"82944",41472000,1000,0.00268095,0,0,1,0,1
"82945",41472500,1000,0.00261551,0,0,1,0,1
"82946",41473000,1000,0.00282212,0,0,1,3,4
"82947",41473500,1000,0.00278801,0,0,0,3,3
"82948",41474000,1000,0.00253885,0,0,0,0,0
"82949",41474500,1000,0.00270268,0,0,1,1,2
"82950",41475000,1000,0.00285712,0,0,1,2,3
"82951",41475500,1000,0.00261982,0,0,0,1,1
"82952",41476000,1000,0.00262098,0,0,0,0,0
"82953",41476500,1000,0.00266605,0,0,0,0,0
"82954",41477000,1000,0.00260066,0,0,0,0,0
"82955",41477500,1000,0.00279968,0,0,0,0,0
"82956",41478000,1000,0.0029772,0,0,0,1,1
"82957",41478500,1000,0.00307096,0,0,1,2,3
"82958",41479000,1000,0.00341117,0,0,1,3,4
"82959",41479500,1000,0.00331811,0,0,0,5,5
"82960",41480000,1000,0.00292203,0,1,0,3,4
"82961",41480500,1000,0.00284523,0,1,0,0,1
"82962",41481000,1000,0.00275792,0,0,0,0,0
"82963",41481500,1000,0.00263859,0,0,0,0,0
"82964",41482000,1000,0.00269774,0,0,0,1,1
"82965",41482500,1000,0.00278956,0,0,1,3,4
"82966",41483000,1000,0.00270504,0,0,1,2,3
"82967",41483500,1000,0.00264059,0,0,0,0,0
"82968",41484000,1000,0.00270079,0,0,0,1,1
"82969",41484500,1000,0.00271202,0,0,0,1,1
"82970",41485000,1000,0.00279574,0,0,0,1,1
"82971",41485500,1000,0.002777,0,0,0,1,1
"82972",41486000,1000,0.00267502,0,0,0,0,0
"82973",41486500,1000,0.00269741,0,0,0,0,0
"82974",41487000,1000,0.00275109,0,0,0,0,0
"82975",41487500,1000,0.00294131,0,1,0,0,1
"82976",41488000,1000,0.00300531,0,1,0,2,3
"82977",41488500,1000,0.00285793,0,0,0,2,2
"82978",41489000,1000,0.00281112,0,0,0,1,1
"82979",41489500,1000,0.00279062,0,0,0,2,2
"82980",41490000,1000,0.00264622,0,0,0,1,1
"82981",41490500,1000,0.00270981,0,0,0,1,1
"82982",41491000,1000,0.00279035,0,0,0,2,2
"82983",41491500,1000,0.00286798,0,0,1,1,2
"82984",41492000,1000,0.00288509,0,0,1,1,2
"82985",41492500,1000,0.00283169,0,0,1,1,2
"82986",41493000,1000,0.00281184,0,0,1,0,1
"82987",41493500,1000,0.00262003,0,0,0,0,0
"82988",41494000,1000,0.00264023,0,0,0,1,1
"82989",41494500,1000,0.00279142,0,0,0,1,1
"82990",41495000,1000,0.00291858,0,0,1,0,1
"82991",41495500,1000,0.00280363,0,0,1,0,1
"82992",41496000,1000,0.00276487,0,0,0,2,2
"82993",41496500,1000,0.00276076,0,0,0,2,2
"82994",41497000,1000,0.00266752,0,0,0,0,0
"82995",41497500,1000,0.00273246,0,0,0,1,1
"82996",41498000,1000,0.00261504,0,0,0,1,1
"82997",41498500,1000,0.0026955,0,0,0,0,0
"82998",41499000,1000,0.002792,0,0,0,0,0
"82999",41499500,1000,0.00267974,0,0,0,0,0
"83000",41500000,1000,0.0026724,0,0,0,0,0
"83001",41500500,1000,0.00269856,0,0,0,0,0
"83002",41501000,1000,0.00284756,0,0,1,1,2
"83003",41501500,1000,0.00280208,0,0,1,1,2
"83004",41502000,1000,0.00273756,0,0,0,0,0
"83005",41502500,1000,0.0028388,0,0,0,0,0
"83006",41503000,1000,0.00303451,0,0,2,1,3
"83007",41503500,1000,0.00298143,0,0,2,1,3
"83008",41504000,1000,0.0027274,0,0,0,0,0
"83009",41504500,1000,0.00270179,0,0,0,1,1
"83010",41505000,1000,0.00282436,0,0,0,2,2
"83011",41505500,1000,0.00284639,0,0,0,2,2
"83012",41506000,1000,0.00271403,0,0,0,1,1
"83013",41506500,1000,0.00268429,0,0,0,0,0
"83014",41507000,1000,0.00267095,0,0,0,0,0
"83015",41507500,1000,0.00266018,0,0,0,0,0
"83016",41508000,1000,0.00261198,0,0,0,0,0
"83017",41508500,1000,0.00270217,0,0,0,0,0
"83018",41509000,1000,0.00264745,0,0,0,0,0
"83019",41509500,1000,0.00254882,0,0,0,0,0
"83020",41510000,1000,0.00267447,0,0,0,2,2
"83021",41510500,1000,0.00270982,0,0,0,2,2
"83022",41511000,1000,0.00275724,0,0,0,2,2
"83023",41511500,1000,0.00271997,0,0,0,2,2
"83024",41512000,1000,0.0026478,0,0,0,0,0
"83025",41512500,1000,0.00276371,0,0,0,0,0
"83026",41513000,1000,0.00279852,0,0,0,2,2
"83027",41513500,1000,0.00277229,0,0,0,2,2
"83028",41514000,1000,0.0026877,0,0,0,0,0
"83029",41514500,1000,0.00255959,0,0,0,0,0
"83030",41515000,1000,0.00279639,0,0,1,2,3
"83031",41515500,1000,0.00292637,0,0,1,2,3
"83032",41516000,1000,0.00307908,0,1,1,1,3
"83033",41516500,1000,0.00316385,0,1,1,2,4
"83034",41517000,1000,0.00287938,0,0,0,1,1
"83035",41517500,1000,0.00273231,0,0,0,1,1
"83036",41518000,1000,0.00283434,0,0,0,2,2
"83037",41518500,1000,0.00284252,0,0,0,1,1
"83038",41519000,1000,0.00279545,0,0,0,0,0
"83039",41519500,1000,0.00277795,0,0,0,1,1
"83040",41520000,1000,0.00266802,0,0,0,1,1
"83041",41520500,1000,0.00262965,0,0,0,1,1
"83042",41521000,1000,0.00282554,0,1,0,1,2
"83043",41521500,1000,0.00292304,0,1,0,0,1
"83044",41522000,1000,0.00269511,0,0,0,1,1
"83045",41522500,1000,0.00265953,0,0,0,1,1
"83046",41523000,1000,0.00256384,0,0,0,0,0
"83047",41523500,1000,0.00263395,0,0,0,0,0
"83048",41524000,1000,0.0029013,0,0,0,2,2
"83049",41524500,1000,0.00282719,0,0,0,2,2
"83050",41525000,1000,0.00262282,0,0,0,0,0
"83051",41525500,1000,0.0029184,0,1,1,0,2
"83052",41526000,1000,0.00305132,0,1,2,1,4
"83053",41526500,1000,0.00274501,0,0,1,1,2
"83054",41527000,1000,0.00265389,0,0,0,0,0
"83055",41527500,1000,0.00267729,0,0,0,0,0
"83056",41528000,1000,0.00255283,0,0,0,0,0
"83057",41528500,1000,0.00259186,0,0,0,2,2
"83058",41529000,1000,0.00269326,0,0,0,2,2
"83059",41529500,1000,0.0025698,0,0,0,0,0
"83060",41530000,1000,0.00263859,0,0,0,0,0
"83061",41530500,1000,0.00269085,0,0,0,0,0
"83062",41531000,1000,0.00281993,0,0,0,1,1
"83063",41531500,1000,0.00281131,0,0,0,2,2
"83064",41532000,1000,0.00260109,0,0,0,1,1
"83065",41532500,1000,0.00274196,0,0,0,2,2
"83066",41533000,1000,0.00279318,0,0,0,2,2
"83067",41533500,1000,0.00265656,0,0,0,0,0
"83068",41534000,1000,0.00282169,0,0,1,1,2
"83069",41534500,1000,0.0028355,0,0,1,2,3
"83070",41535000,1000,0.00263647,0,0,0,1,1
"83071",41535500,1000,0.00272894,0,0,0,1,1
"83072",41536000,1000,0.00293787,0,0,1,3,4
"83073",41536500,1000,0.00285461,0,0,1,2,3
"83074",41537000,1000,0.00267081,0,0,0,0,0
"83075",41537500,1000,0.00297322,0,1,0,1,2
"83076",41538000,1000,0.00305469,0,1,0,3,4
"83077",41538500,1000,0.00271922,0,0,0,2,2
"83078",41539000,1000,0.00266501,0,0,0,1,1
"83079",41539500,1000,0.00269741,0,0,0,1,1
"83080",41540000,1000,0.00274881,0,0,0,1,1
"83081",41540500,1000,0.00272262,0,0,0,1,1
"83082",41541000,1000,0.00270619,0,0,0,1,1
"83083",41541500,1000,0.00270649,0,0,0,1,1
"83084",41542000,1000,0.00264382,0,0,0,0,0
"83085",41542500,1000,0.00276499,0,1,0,0,1
"83086",41543000,1000,0.00275346,0,1,0,1,2
"83087",41543500,1000,0.00255866,0,0,0,1,1
"83088",41544000,1000,0.00238652,0,0,0,0,0
"83089",41544500,1000,0.0024573,0,0,0,0,0
"83090",41545000,1000,0.00262774,0,0,0,1,1
"83091",41545500,1000,0.00263404,0,0,0,1,1
"83092",41546000,1000,0.002616,0,0,0,0,0
"83093",41546500,1000,0.00297492,0,2,0,0,2
"83094",41547000,1000,0.00309629,0,2,0,0,2
"83095",41547500,1000,0.00278886,0,0,0,0,0
"83096",41548000,1000,0.00269935,0,0,0,1,1
"83097",41548500,1000,0.00266636,0,0,0,1,1
"83098",41549000,1000,0.00268775,0,0,0,1,1
"83099",41549500,1000,0.00263317,0,0,0,1,1
"83100",41550000,1000,0.00273859,0,0,0,2,2
"83101",41550500,1000,0.00295244,0,1,0,2,3
"83102",41551000,1000,0.00288049,0,1,1,0,2
"83103",41551500,1000,0.00276074,0,0,1,1,2
"83104",41552000,1000,0.00290129,0,1,0,1,2
"83105",41552500,1000,0.00303398,0,1,0,1,2
"83106",41553000,1000,0.00286183,0,0,0,1,1
"83107",41553500,1000,0.0026667,0,0,0,0,0
"83108",41554000,1000,0.00268075,0,0,0,0,0
"83109",41554500,1000,0.00261971,0,0,0,0,0
"83110",41555000,1000,0.00263668,0,0,0,1,1
"83111",41555500,1000,0.00269838,0,0,0,1,1
"83112",41556000,1000,0.00274131,0,0,0,0,0
"83113",41556500,1000,0.00282807,0,0,0,1,1
"83114",41557000,1000,0.00278692,0,0,1,1,2
"83115",41557500,1000,0.00261507,0,0,1,0,1
"83116",41558000,1000,0.00261174,0,0,0,0,0
"83117",41558500,1000,0.00278307,0,0,0,0,0
"83118",41559000,1000,0.00272501,0,0,0,2,2
"83119",41559500,1000,0.00269338,0,0,1,2,3
"83120",41560000,1000,0.00281515,0,0,2,0,2
"83121",41560500,1000,0.00284572,0,0,1,1,2
"83122",41561000,1000,0.00270493,0,0,0,1,1
"83123",41561500,1000,0.00264276,0,0,0,0,0
"83124",41562000,1000,0.00269107,0,0,0,2,2
"83125",41562500,1000,0.00274094,0,0,1,2,3
"83126",41563000,1000,0.00273415,0,0,1,0,1
"83127",41563500,1000,0.00271842,0,0,0,0,0
"83128",41564000,1000,0.00268853,0,0,0,0,0
"83129",41564500,1000,0.0025383,0,0,0,0,0
"83130",41565000,1000,0.00261508,0,0,1,0,1
"83131",41565500,1000,0.00270163,0,0,1,0,1
"83132",41566000,1000,0.00268457,0,0,0,1,1
"83133",41566500,1000,0.00266536,0,0,0,1,1
"83134",41567000,1000,0.00273273,0,0,0,2,2
"83135",41567500,1000,0.00291353,0,0,0,4,4
"83136",41568000,1000,0.00289421,0,0,0,2,2
"83137",41568500,1000,0.00278359,0,0,0,0,0
"83138",41569000,1000,0.00269724,0,0,0,0,0
"83139",41569500,1000,0.00287479,0,0,0,1,1
"83140",41570000,1000,0.00295475,0,0,0,1,1
"83141",41570500,1000,0.00282302,0,0,0,0,0
"83142",41571000,1000,0.00282967,0,0,0,0,0
"83143",41571500,1000,0.00279531,0,0,0,0,0
"83144",41572000,1000,0.00273996,0,0,0,0,0
"83145",41572500,1000,0.00289053,0,0,1,1,2
"83146",41573000,1000,0.00291735,0,0,1,2,3
"83147",41573500,1000,0.00281262,0,0,0,1,1
"83148",41574000,1000,0.00274374,0,0,0,0,0
"83149",41574500,1000,0.00259188,0,0,0,0,0
"83150",41575000,1000,0.00254309,0,0,0,0,0
"83151",41575500,1000,0.0027076,0,0,0,3,3
"83152",41576000,1000,0.00277145,0,0,0,3,3
"83153",41576500,1000,0.00267629,0,0,0,1,1
"83154",41577000,1000,0.00273938,0,0,1,1,2
"83155",41577500,1000,0.00282633,0,0,1,2,3
"83156",41578000,1000,0.00275988,0,0,0,3,3
"83157",41578500,1000,0.00270505,0,0,0,1,1
"83158",41579000,1000,0.00258334,0,0,0,0,0
"83159",41579500,1000,0.00252113,0,0,0,0,0
"83160",41580000,1000,0.00276259,0,0,1,1,2
"83161",41580500,1000,0.0031112,0,1,1,1,3
"83162",41581000,1000,0.00300176,0,1,0,0,1
"83163",41581500,1000,0.0027627,0,0,0,0,0
"83164",41582000,1000,0.00279512,0,0,0,0,0
"83165",41582500,1000,0.00283467,0,0,1,0,1
"83166",41583000,1000,0.00288064,0,0,1,0,1
"83167",41583500,1000,0.00281555,0,0,0,0,0
"83168",41584000,1000,0.00284692,0,0,0,1,1
"83169",41584500,1000,0.00281989,0,0,0,1,1
"83170",41585000,1000,0.0027562,0,0,0,0,0
"83171",41585500,1000,0.00262404,0,0,0,0,0
"83172",41586000,1000,0.00264182,0,0,0,1,1
"83173",41586500,1000,0.00272261,0,0,0,1,1
"83174",41587000,1000,0.00292678,0,1,0,1,2
"83175",41587500,1000,0.00291199,0,1,0,1,2
"83176",41588000,1000,0.00264339,0,0,0,0,0
"83177",41588500,1000,0.00260456,0,0,0,0,0
"83178",41589000,1000,0.0026292,0,0,0,2,2
"83179",41589500,1000,0.00273094,0,0,0,3,3
"83180",41590000,1000,0.00271958,0,0,0,1,1
"83181",41590500,1000,0.00264396,0,0,0,0,0
"83182",41591000,1000,0.00254209,0,0,0,1,1
"83183",41591500,1000,0.00266592,0,0,0,2,2
"83184",41592000,1000,0.00271697,0,0,0,1,1
"83185",41592500,1000,0.00271421,0,0,0,0,0
"83186",41593000,1000,0.00275804,0,0,0,0,0
"83187",41593500,1000,0.00265575,0,0,0,0,0
"83188",41594000,1000,0.00266847,0,0,1,1,2
"83189",41594500,1000,0.00268939,0,0,1,2,3
"83190",41595000,1000,0.00268262,0,0,0,1,1
"83191",41595500,1000,0.00270647,0,0,0,0,0
"83192",41596000,1000,0.00269628,0,0,0,0,0
"83193",41596500,1000,0.00260629,0,0,0,0,0
"83194",41597000,1000,0.00249523,0,0,0,0,0
"83195",41597500,1000,0.00260876,0,0,0,2,2
"83196",41598000,1000,0.00296077,0,0,0,3,3
"83197",41598500,1000,0.00316641,0,0,0,1,1
"83198",41599000,1000,0.00306403,0,0,0,0,0
"83199",41599500,1000,0.00295305,0,0,0,1,1
"83200",41600000,1000,0.00290422,0,0,0,1,1
"83201",41600500,1000,0.00275176,0,0,0,0,0
"83202",41601000,1000,0.002541,0,0,0,0,0
"83203",41601500,1000,0.00254996,0,0,0,2,2
"83204",41602000,1000,0.00271305,0,0,0,2,2
"83205",41602500,1000,0.00274183,0,0,0,0,0
"83206",41603000,1000,0.00263375,0,0,0,1,1
"83207",41603500,1000,0.00258475,0,0,0,1,1
"83208",41604000,1000,0.00260106,0,0,0,0,0
"83209",41604500,1000,0.00251324,0,0,0,0,0
"83210",41605000,1000,0.00256938,0,0,0,0,0
"83211",41605500,1000,0.00268978,0,0,0,0,0
"83212",41606000,1000,0.00260281,0,0,0,0,0
"83213",41606500,1000,0.00267967,0,0,0,1,1
"83214",41607000,1000,0.0028242,0,0,0,1,1
"83215",41607500,1000,0.00262085,0,0,0,1,1
"83216",41608000,1000,0.00265981,0,0,1,2,3
"83217",41608500,1000,0.00275063,0,0,1,1,2
"83218",41609000,1000,0.00266925,0,0,0,0,0
"83219",41609500,1000,0.00287299,0,0,0,1,1
"83220",41610000,1000,0.0028781,0,0,0,1,1
"83221",41610500,1000,0.00270969,0,0,0,0,0
"83222",41611000,1000,0.00280558,0,0,0,1,1
"83223",41611500,1000,0.00285964,0,0,0,2,2
"83224",41612000,1000,0.00279428,0,0,0,1,1
"83225",41612500,1000,0.00274653,0,0,0,0,0
"83226",41613000,1000,0.00276499,0,0,0,0,0
"83227",41613500,1000,0.00279441,0,0,0,3,3
"83228",41614000,1000,0.00281729,0,0,0,3,3
"83229",41614500,1000,0.00295804,0,0,1,0,1
"83230",41615000,1000,0.00291304,0,0,1,1,2
"83231",41615500,1000,0.00273997,0,0,0,2,2
"83232",41616000,1000,0.00268556,0,0,0,1,1
"83233",41616500,1000,0.00269246,0,0,0,1,1
"83234",41617000,1000,0.00283595,0,1,0,1,2
"83235",41617500,1000,0.00294687,0,1,0,0,1
"83236",41618000,1000,0.00277391,0,0,0,0,0
"83237",41618500,1000,0.00272072,0,0,0,0,0
"83238",41619000,1000,0.00277096,0,0,0,0,0
"83239",41619500,1000,0.00280275,0,0,1,0,1
"83240",41620000,1000,0.00285381,0,0,1,0,1
"83241",41620500,1000,0.00277253,0,0,0,0,0
"83242",41621000,1000,0.00277143,0,0,0,0,0
"83243",41621500,1000,0.00284983,0,0,0,1,1
"83244",41622000,1000,0.00285016,0,0,0,1,1
"83245",41622500,1000,0.00274229,0,0,0,0,0
"83246",41623000,1000,0.00261835,0,0,0,1,1
"83247",41623500,1000,0.00265796,0,0,0,1,1
"83248",41624000,1000,0.0027622,0,0,0,0,0
"83249",41624500,1000,0.00274561,0,0,0,0,0
"83250",41625000,1000,0.00271831,0,0,0,1,1
"83251",41625500,1000,0.0026844,0,0,0,1,1
"83252",41626000,1000,0.00262272,0,0,0,0,0
"83253",41626500,1000,0.00264548,0,0,0,0,0
"83254",41627000,1000,0.00281947,0,0,0,2,2
"83255",41627500,1000,0.00302283,0,0,0,5,5
"83256",41628000,1000,0.00296765,0,0,0,4,4
"83257",41628500,1000,0.0028587,0,0,0,1,1
"83258",41629000,1000,0.00292003,0,0,1,0,1
"83259",41629500,1000,0.00279606,0,0,1,0,1
"83260",41630000,1000,0.00286036,0,0,1,2,3
"83261",41630500,1000,0.00296287,0,0,2,2,4
"83262",41631000,1000,0.00264006,0,0,1,0,1
"83263",41631500,1000,0.00263331,0,0,0,2,2
"83264",41632000,1000,0.00287108,0,0,0,3,3
"83265",41632500,1000,0.00309397,0,0,0,1,1
"83266",41633000,1000,0.00321659,0,0,0,1,1
"83267",41633500,1000,0.0031126,0,0,0,4,4
"83268",41634000,1000,0.00302593,0,0,0,5,5
"83269",41634500,1000,0.0028266,0,0,0,3,3
"83270",41635000,1000,0.00267236,0,0,0,1,1
"83271",41635500,1000,0.00270078,0,0,0,0,0
"83272",41636000,1000,0.00265534,0,0,0,0,0
"83273",41636500,1000,0.0026125,0,0,0,0,0
"83274",41637000,1000,0.00264089,0,0,0,0,0
"83275",41637500,1000,0.00275434,0,0,1,1,2
"83276",41638000,1000,0.00280822,0,0,1,2,3
"83277",41638500,1000,0.00274563,0,0,0,1,1
"83278",41639000,1000,0.0026645,0,0,0,0,0
"83279",41639500,1000,0.00291015,0,0,0,0,0
"83280",41640000,1000,0.00296227,0,0,0,0,0
"83281",41640500,1000,0.00286928,0,0,1,3,4
"83282",41641000,1000,0.00295529,0,1,1,3,5
"83283",41641500,1000,0.00295458,0,1,1,3,5
"83284",41642000,1000,0.002882,0,0,1,4,5
"83285",41642500,1000,0.00278009,0,0,0,2,2
"83286",41643000,1000,0.0027358,0,0,0,1,1
"83287",41643500,1000,0.00264419,0,0,0,0,0
"83288",41644000,1000,0.00262396,0,0,0,0,0
"83289",41644500,1000,0.00273293,0,0,0,1,1
"83290",41645000,1000,0.0027584,0,0,0,2,2
"83291",41645500,1000,0.00267955,0,0,0,1,1
"83292",41646000,1000,0.00270115,0,0,0,0,0
"83293",41646500,1000,0.00286528,0,0,1,3,4
"83294",41647000,1000,0.00270056,0,0,1,3,4
"83295",41647500,1000,0.00248393,0,0,0,0,0
"83296",41648000,1000,0.00259975,0,0,0,0,0
"83297",41648500,1000,0.00260267,0,0,0,0,0
"83298",41649000,1000,0.00265137,0,0,1,1,2
"83299",41649500,1000,0.00274984,0,0,1,1,2
"83300",41650000,1000,0.00285151,0,0,0,0,0
"83301",41650500,1000,0.00304427,0,1,0,0,1
"83302",41651000,1000,0.00301681,0,1,0,0,1
"83303",41651500,1000,0.00274108,0,0,0,0,0
"83304",41652000,1000,0.00273221,0,0,0,1,1
"83305",41652500,1000,0.00269415,0,0,0,1,1
"83306",41653000,1000,0.00260824,0,0,0,0,0
"83307",41653500,1000,0.0027161,0,0,0,1,1
"83308",41654000,1000,0.00274939,0,0,0,3,3
"83309",41654500,1000,0.00273592,0,0,0,2,2
"83310",41655000,1000,0.00279623,0,0,0,1,1
"83311",41655500,1000,0.00273309,0,0,0,1,1
"83312",41656000,1000,0.00258921,0,0,0,0,0
"83313",41656500,1000,0.0026979,0,0,1,0,1
"83314",41657000,1000,0.00269244,0,0,1,0,1
"83315",41657500,1000,0.00263502,0,0,0,0,0
"83316",41658000,1000,0.00266224,0,0,0,0,0
"83317",41658500,1000,0.00265904,0,0,0,0,0
"83318",41659000,1000,0.00272535,0,0,0,0,0
"83319",41659500,1000,0.00271645,0,0,0,0,0
"83320",41660000,1000,0.00279954,0,0,0,1,1
"83321",41660500,1000,0.00282451,0,0,0,1,1
"83322",41661000,1000,0.00267427,0,0,0,1,1
"83323",41661500,1000,0.00266099,0,0,1,1,2
"83324",41662000,1000,0.00268642,0,0,1,1,2
"83325",41662500,1000,0.00268894,0,0,0,1,1
"83326",41663000,1000,0.00268415,0,0,0,1,1
"83327",41663500,1000,0.00281166,0,0,0,2,2
"83328",41664000,1000,0.00288485,0,0,0,2,2
"83329",41664500,1000,0.00275791,0,0,0,3,3
"83330",41665000,1000,0.00265883,0,0,0,3,3
"83331",41665500,1000,0.002583,0,0,0,1,1
"83332",41666000,1000,0.00257663,0,0,0,0,0
"83333",41666500,1000,0.00258296,0,0,0,0,0
"83334",41667000,1000,0.00257186,0,0,0,1,1
"83335",41667500,1000,0.00262253,0,0,0,1,1
"83336",41668000,1000,0.00263766,0,0,0,0,0
"83337",41668500,1000,0.00285848,0,0,2,2,4
"83338",41669000,1000,0.00297828,0,0,2,4,6
"83339",41669500,1000,0.00276627,0,0,0,2,2
"83340",41670000,1000,0.0026526,0,0,0,1,1
"83341",41670500,1000,0.00262013,0,0,0,3,3
"83342",41671000,1000,0.00275446,0,0,1,2,3
"83343",41671500,1000,0.00274004,0,0,1,0,1
"83344",41672000,1000,0.00264504,0,0,0,3,3
"83345",41672500,1000,0.00275227,0,0,1,4,5
"83346",41673000,1000,0.00265452,0,0,1,1,2
"83347",41673500,1000,0.00262705,0,0,1,0,1
"83348",41674000,1000,0.00273779,0,0,1,2,3
"83349",41674500,1000,0.00277969,0,0,1,3,4
"83350",41675000,1000,0.00292005,0,0,1,3,4
"83351",41675500,1000,0.00278825,0,0,0,2,2
"83352",41676000,1000,0.00259391,0,0,0,0,0
"83353",41676500,1000,0.00261477,0,0,0,0,0
"83354",41677000,1000,0.00282309,0,0,0,3,3
"83355",41677500,1000,0.00296484,0,1,0,4,5
"83356",41678000,1000,0.00287649,0,1,0,3,4
"83357",41678500,1000,0.00283863,0,0,1,2,3
"83358",41679000,1000,0.00281473,0,0,2,0,2
"83359",41679500,1000,0.00276128,0,0,1,2,3
"83360",41680000,1000,0.00268482,0,0,0,3,3
"83361",41680500,1000,0.00262375,0,0,0,1,1
"83362",41681000,1000,0.00264857,0,0,1,1,2
"83363",41681500,1000,0.00265481,0,0,1,1,2
"83364",41682000,1000,0.00271905,0,0,0,0,0
"83365",41682500,1000,0.00285807,0,1,0,0,1
"83366",41683000,1000,0.0028465,0,1,1,1,3
"83367",41683500,1000,0.00268419,0,0,1,1,2
"83368",41684000,1000,0.00260716,0,0,0,1,1
"83369",41684500,1000,0.00274773,0,0,0,4,4
"83370",41685000,1000,0.00273674,0,0,0,4,4
"83371",41685500,1000,0.00257624,0,0,0,1,1
"83372",41686000,1000,0.00252245,0,0,0,1,1
"83373",41686500,1000,0.00251367,0,0,0,1,1
"83374",41687000,1000,0.00267347,0,0,1,1,2
"83375",41687500,1000,0.00278069,0,0,1,3,4
"83376",41688000,1000,0.00259447,0,0,0,2,2
"83377",41688500,1000,0.00246925,0,0,0,0,0
"83378",41689000,1000,0.00252767,0,0,0,1,1
"83379",41689500,1000,0.00261921,0,0,0,1,1
"83380",41690000,1000,0.0027114,0,0,0,0,0
"83381",41690500,1000,0.00267912,0,0,0,0,0
"83382",41691000,1000,0.00275643,0,0,0,2,2
"83383",41691500,1000,0.0028049,0,0,0,3,3
"83384",41692000,1000,0.00272655,0,0,0,2,2
"83385",41692500,1000,0.00269207,0,0,0,1,1
"83386",41693000,1000,0.00262894,0,0,0,0,0
"83387",41693500,1000,0.00261971,0,0,0,0,0
"83388",41694000,1000,0.00272897,0,0,1,0,1
"83389",41694500,1000,0.00277551,0,0,1,2,3
"83390",41695000,1000,0.0027497,0,0,0,2,2
"83391",41695500,1000,0.00283113,0,0,1,0,1
"83392",41696000,1000,0.00274905,0,0,1,0,1
"83393",41696500,1000,0.00281438,0,1,0,0,1
"83394",41697000,1000,0.00279487,0,1,0,0,1
"83395",41697500,1000,0.00255196,0,0,0,0,0
"83396",41698000,1000,0.00260382,0,0,0,2,2
"83397",41698500,1000,0.00274434,0,0,0,4,4
"83398",41699000,1000,0.00277729,0,0,0,2,2
"83399",41699500,1000,0.00284832,0,0,1,3,4
"83400",41700000,1000,0.00279611,0,0,1,5,6
"83401",41700500,1000,0.00271169,0,0,0,3,3
"83402",41701000,1000,0.00280186,0,0,0,3,3
"83403",41701500,1000,0.00283041,0,0,1,2,3
"83404",41702000,1000,0.00268193,0,0,1,1,2
"83405",41702500,1000,0.00259064,0,0,0,1,1
"83406",41703000,1000,0.00259898,0,0,0,0,0
"83407",41703500,1000,0.00266386,0,0,1,0,1
"83408",41704000,1000,0.00283166,0,0,2,0,2
"83409",41704500,1000,0.00271768,0,0,1,1,2
"83410",41705000,1000,0.00262136,0,0,0,2,2
"83411",41705500,1000,0.00295291,0,1,0,2,3
"83412",41706000,1000,0.00292619,0,1,0,1,2
"83413",41706500,1000,0.00258798,0,0,0,0,0
"83414",41707000,1000,0.00267805,0,0,0,1,1
"83415",41707500,1000,0.00269735,0,0,0,1,1
"83416",41708000,1000,0.00272926,0,0,0,2,2
"83417",41708500,1000,0.00278174,0,0,0,2,2
"83418",41709000,1000,0.00262378,0,0,0,0,0
"83419",41709500,1000,0.00275089,0,0,1,1,2
"83420",41710000,1000,0.00286457,0,0,1,1,2
"83421",41710500,1000,0.00271727,0,0,0,0,0
"83422",41711000,1000,0.00268635,0,0,1,1,2
"83423",41711500,1000,0.00276361,0,0,1,2,3
"83424",41712000,1000,0.00280291,0,0,0,2,2
"83425",41712500,1000,0.00277018,0,0,0,2,2
"83426",41713000,1000,0.00277386,0,0,0,4,4
"83427",41713500,1000,0.00266068,0,0,0,3,3
"83428",41714000,1000,0.00253812,0,0,0,0,0
"83429",41714500,1000,0.00272043,0,0,0,0,0
"83430",41715000,1000,0.00284811,0,0,1,1,2
"83431",41715500,1000,0.00270962,0,0,1,1,2
"83432",41716000,1000,0.00261045,0,0,0,2,2
"83433",41716500,1000,0.00268103,0,0,0,2,2
"83434",41717000,1000,0.00287324,0,1,0,1,2
"83435",41717500,1000,0.00284738,0,1,0,2,3
"83436",41718000,1000,0.0026475,0,0,0,1,1
"83437",41718500,1000,0.00261062,0,0,0,0,0
"83438",41719000,1000,0.00273366,0,0,1,1,2
"83439",41719500,1000,0.00270084,0,0,1,1,2
"83440",41720000,1000,0.00270488,0,0,1,3,4
"83441",41720500,1000,0.0027355,0,0,1,3,4
"83442",41721000,1000,0.00279153,0,0,1,1,2
"83443",41721500,1000,0.00290905,0,0,2,2,4
"83444",41722000,1000,0.00286423,0,0,2,3,5
"83445",41722500,1000,0.0028134,0,0,1,3,4
"83446",41723000,1000,0.00269258,0,0,0,1,1
"83447",41723500,1000,0.00270602,0,0,0,1,1
"83448",41724000,1000,0.00270404,0,0,0,1,1
"83449",41724500,1000,0.00270771,0,0,0,0,0
"83450",41725000,1000,0.002623,0,0,0,0,0
"83451",41725500,1000,0.00260463,0,0,0,0,0
"83452",41726000,1000,0.00290868,0,0,0,3,3
"83453",41726500,1000,0.00303206,0,0,2,3,5
"83454",41727000,1000,0.00287629,0,0,2,0,2
"83455",41727500,1000,0.00271078,0,0,0,0,0
"83456",41728000,1000,0.00274673,0,0,0,1,1
"83457",41728500,1000,0.00275057,0,0,0,1,1
"83458",41729000,1000,0.002825,0,0,1,2,3
"83459",41729500,1000,0.00290148,0,0,2,2,4
"83460",41730000,1000,0.0028762,0,0,2,1,3
"83461",41730500,1000,0.00286067,0,0,1,1,2
"83462",41731000,1000,0.00284283,0,0,1,2,3
"83463",41731500,1000,0.0028953,0,0,1,3,4
"83464",41732000,1000,0.00291325,0,0,0,1,1
"83465",41732500,1000,0.00284226,0,0,0,1,1
"83466",41733000,1000,0.00279128,0,0,1,2,3
"83467",41733500,1000,0.00272816,0,0,1,1,2
"83468",41734000,1000,0.00249659,0,0,0,0,0
"83469",41734500,1000,0.00245408,0,0,0,0,0
"83470",41735000,1000,0.00268101,0,0,1,0,1
"83471",41735500,1000,0.00276192,0,0,1,0,1
"83472",41736000,1000,0.00269328,0,0,0,2,2
"83473",41736500,1000,0.00278219,0,0,1,2,3
"83474",41737000,1000,0.00273928,0,0,1,0,1
"83475",41737500,1000,0.00262964,0,0,0,0,0
"83476",41738000,1000,0.00273697,0,0,0,0,0
"83477",41738500,1000,0.00268581,0,0,0,0,0
"83478",41739000,1000,0.00259682,0,0,0,0,0
"83479",41739500,1000,0.0027183,0,0,0,0,0
"83480",41740000,1000,0.00291663,0,0,1,1,2
"83481",41740500,1000,0.00285156,0,0,1,1,2
"83482",41741000,1000,0.00258664,0,0,0,0,0
"83483",41741500,1000,0.00259916,0,0,0,1,1
"83484",41742000,1000,0.00272567,0,0,0,1,1
"83485",41742500,1000,0.00275355,0,0,0,2,2
"83486",41743000,1000,0.00285794,0,0,1,5,6
"83487",41743500,1000,0.00283754,0,0,1,3,4
"83488",41744000,1000,0.00285159,0,0,0,3,3
"83489",41744500,1000,0.00293431,0,0,1,3,4
"83490",41745000,1000,0.00296421,0,0,2,3,5
"83491",41745500,1000,0.00276914,0,0,1,3,4
"83492",41746000,1000,0.0026342,0,0,0,1,1
"83493",41746500,1000,0.00269499,0,0,0,1,1
"83494",41747000,1000,0.00267036,0,0,0,2,2
"83495",41747500,1000,0.0026777,0,0,0,2,2
"83496",41748000,1000,0.00272219,0,0,0,2,2
"83497",41748500,1000,0.00276243,0,0,0,4,4
"83498",41749000,1000,0.00261652,0,0,0,2,2
"83499",41749500,1000,0.00267683,0,0,1,1,2
"83500",41750000,1000,0.00282299,0,0,2,1,3
"83501",41750500,1000,0.00276313,0,0,1,0,1
"83502",41751000,1000,0.00276717,0,0,0,1,1
"83503",41751500,1000,0.00265939,0,0,0,1,1
"83504",41752000,1000,0.00256492,0,0,0,0,0
"83505",41752500,1000,0.00264378,0,0,0,0,0
"83506",41753000,1000,0.00290518,0,0,2,2,4
"83507",41753500,1000,0.00298238,0,0,2,3,5
"83508",41754000,1000,0.00269406,0,0,0,1,1
"83509",41754500,1000,0.00261681,0,0,0,1,1
"83510",41755000,1000,0.00262659,0,0,0,1,1
"83511",41755500,1000,0.00266301,0,0,0,0,0
"83512",41756000,1000,0.00283844,0,0,1,1,2
"83513",41756500,1000,0.0028571,0,0,1,1,2
"83514",41757000,1000,0.00264561,0,0,0,0,0
"83515",41757500,1000,0.00256794,0,0,0,0,0
"83516",41758000,1000,0.00268312,0,0,0,0,0
"83517",41758500,1000,0.00291821,0,0,1,1,2
"83518",41759000,1000,0.00300188,0,0,3,1,4
"83519",41759500,1000,0.00287991,0,0,3,0,3
"83520",41760000,1000,0.00280301,0,0,2,2,4
"83521",41760500,1000,0.00274605,0,0,1,3,4
"83522",41761000,1000,0.00273441,0,0,0,2,2
"83523",41761500,1000,0.00281968,0,0,0,3,3
"83524",41762000,1000,0.0028272,0,0,0,3,3
"83525",41762500,1000,0.00276088,0,0,0,1,1
"83526",41763000,1000,0.00285376,0,0,0,0,0
"83527",41763500,1000,0.00281075,0,0,0,0,0
"83528",41764000,1000,0.00280474,0,0,0,3,3
"83529",41764500,1000,0.00299507,0,0,1,3,4
"83530",41765000,1000,0.00297339,0,0,2,1,3
"83531",41765500,1000,0.00283478,0,0,1,3,4
"83532",41766000,1000,0.00268355,0,0,0,2,2
"83533",41766500,1000,0.002685,0,0,1,1,2
"83534",41767000,1000,0.00269841,0,0,1,1,2
"83535",41767500,1000,0.00268687,0,0,0,1,1
"83536",41768000,1000,0.00277875,0,0,0,2,2
"83537",41768500,1000,0.00269575,0,0,0,1,1
"83538",41769000,1000,0.00265191,0,0,0,0,0
"83539",41769500,1000,0.00274898,0,0,0,0,0
"83540",41770000,1000,0.0026622,0,0,0,0,0
"83541",41770500,1000,0.00256721,0,0,0,1,1
"83542",41771000,1000,0.00265614,0,0,0,3,3
"83543",41771500,1000,0.00286225,0,0,0,4,4
"83544",41772000,1000,0.00288006,0,0,0,3,3
"83545",41772500,1000,0.00299346,0,0,1,2,3
"83546",41773000,1000,0.00297996,0,0,1,2,3
"83547",41773500,1000,0.00273437,0,0,0,1,1
"83548",41774000,1000,0.00273502,0,0,0,1,1
"83549",41774500,1000,0.00291753,0,0,0,5,5
"83550",41775000,1000,0.00293546,0,0,0,4,4
"83551",41775500,1000,0.00283318,0,0,0,2,2
"83552",41776000,1000,0.00278567,0,0,0,2,2
"83553",41776500,1000,0.00276002,0,0,0,2,2
"83554",41777000,1000,0.00275895,0,0,0,3,3
"83555",41777500,1000,0.00273952,0,0,0,2,2
"83556",41778000,1000,0.00279476,0,0,0,1,1
"83557",41778500,1000,0.0028099,0,0,1,1,2
"83558",41779000,1000,0.00273609,0,0,1,1,2
"83559",41779500,1000,0.00272728,0,0,1,1,2
"83560",41780000,1000,0.00285462,0,0,2,3,5
"83561",41780500,1000,0.00296825,0,0,2,5,7
"83562",41781000,1000,0.00276697,0,0,1,3,4
"83563",41781500,1000,0.00265364,0,0,0,1,1
"83564",41782000,1000,0.0027926,0,0,0,1,1
"83565",41782500,1000,0.00283325,0,0,1,2,3
"83566",41783000,1000,0.00269226,0,0,1,2,3
"83567",41783500,1000,0.00264805,0,0,0,3,3
"83568",41784000,1000,0.00275855,0,0,0,4,4
"83569",41784500,1000,0.00266634,0,0,0,1,1
"83570",41785000,1000,0.00252756,0,0,0,0,0
"83571",41785500,1000,0.00252773,0,0,0,0,0
"83572",41786000,1000,0.00251597,0,0,0,0,0
"83573",41786500,1000,0.00247865,0,0,0,0,0
"83574",41787000,1000,0.00260264,0,0,0,2,2
"83575",41787500,1000,0.00265249,0,0,0,2,2
"83576",41788000,1000,0.00271019,0,0,1,1,2
"83577",41788500,1000,0.00269112,0,0,1,1,2
"83578",41789000,1000,0.00265823,0,0,0,0,0
"83579",41789500,1000,0.00287299,0,1,0,1,2
"83580",41790000,1000,0.00286082,0,1,0,1,2
"83581",41790500,1000,0.00272188,0,0,0,0,0
"83582",41791000,1000,0.00270496,0,0,0,0,0
"83583",41791500,1000,0.00284866,0,0,1,2,3
"83584",41792000,1000,0.00302438,0,1,1,3,5
"83585",41792500,1000,0.00287345,0,1,0,3,4
"83586",41793000,1000,0.00269346,0,0,0,2,2
"83587",41793500,1000,0.00272934,0,0,1,0,1
"83588",41794000,1000,0.00269866,0,0,1,0,1
"83589",41794500,1000,0.00276039,0,0,1,1,2
"83590",41795000,1000,0.0027819,0,0,1,1,2
"83591",41795500,1000,0.0027011,0,0,1,0,1
"83592",41796000,1000,0.00267075,0,0,1,0,1
"83593",41796500,1000,0.00261007,0,0,0,0,0
"83594",41797000,1000,0.00285357,0,0,1,3,4
"83595",41797500,1000,0.00282698,0,0,1,3,4
"83596",41798000,1000,0.002736,0,0,0,2,2
"83597",41798500,1000,0.00280126,0,0,0,3,3
"83598",41799000,1000,0.0027092,0,0,0,2,2
"83599",41799500,1000,0.00264271,0,0,0,1,1
"83600",41800000,1000,0.00271329,0,0,0,4,4
"83601",41800500,1000,0.00286159,0,0,1,4,5
"83602",41801000,1000,0.00273647,0,0,1,0,1
"83603",41801500,1000,0.00265408,0,0,0,0,0
"83604",41802000,1000,0.00276792,0,0,0,2,2
"83605",41802500,1000,0.00272201,0,0,0,3,3
"83606",41803000,1000,0.0026413,0,0,0,2,2
"83607",41803500,1000,0.00264835,0,0,0,1,1
"83608",41804000,1000,0.00276661,0,0,0,3,3
"83609",41804500,1000,0.00285494,0,0,0,5,5
"83610",41805000,1000,0.00285278,0,0,1,4,5
"83611",41805500,1000,0.0027337,0,0,1,3,4
"83612",41806000,1000,0.00296282,0,2,0,1,3
"83613",41806500,1000,0.00305841,0,2,0,0,2
"83614",41807000,1000,0.00271131,0,0,0,0,0
"83615",41807500,1000,0.00273057,0,0,0,0,0
"83616",41808000,1000,0.00276527,0,0,0,0,0
"83617",41808500,1000,0.00274074,0,0,0,1,1
"83618",41809000,1000,0.00276208,0,0,0,3,3
"83619",41809500,1000,0.00277154,0,0,0,2,2
"83620",41810000,1000,0.00294198,0,0,0,2,2
"83621",41810500,1000,0.00293317,0,0,0,2,2
"83622",41811000,1000,0.00276976,0,0,0,0,0
"83623",41811500,1000,0.00262341,0,0,0,1,1
"83624",41812000,1000,0.00248357,0,0,0,1,1
"83625",41812500,1000,0.00250865,0,0,0,0,0
"83626",41813000,1000,0.00260664,0,0,0,1,1
"83627",41813500,1000,0.00265782,0,0,0,2,2
"83628",41814000,1000,0.00270024,0,0,0,2,2
"83629",41814500,1000,0.00272631,0,0,0,2,2
"83630",41815000,1000,0.0026572,0,0,0,1,1
"83631",41815500,1000,0.00266891,0,0,1,1,2
"83632",41816000,1000,0.0025761,0,0,1,1,2
"83633",41816500,1000,0.00261624,0,0,0,1,1
"83634",41817000,1000,0.00283231,0,0,1,2,3
"83635",41817500,1000,0.00283433,0,0,1,2,3
"83636",41818000,1000,0.0027799,0,0,0,2,2
"83637",41818500,1000,0.00282379,0,0,1,2,3
"83638",41819000,1000,0.00283164,0,0,1,2,3
"83639",41819500,1000,0.00266178,0,0,0,1,1
"83640",41820000,1000,0.00260095,0,0,0,0,0
"83641",41820500,1000,0.00269164,0,0,0,0,0
"83642",41821000,1000,0.00272726,0,0,0,2,2
"83643",41821500,1000,0.00268357,0,0,0,2,2
"83644",41822000,1000,0.00281597,0,0,1,0,1
"83645",41822500,1000,0.00284668,0,0,1,0,1
"83646",41823000,1000,0.00270536,0,0,1,0,1
"83647",41823500,1000,0.00277032,0,0,1,1,2
"83648",41824000,1000,0.00274436,0,0,0,2,2
"83649",41824500,1000,0.00274869,0,0,1,1,2
"83650",41825000,1000,0.00276758,0,0,1,0,1
"83651",41825500,1000,0.00267335,0,0,0,0,0
"83652",41826000,1000,0.0026315,0,0,0,1,1
"83653",41826500,1000,0.00260905,0,0,0,1,1
"83654",41827000,1000,0.0026816,0,0,0,2,2
"83655",41827500,1000,0.00271976,0,0,0,2,2
"83656",41828000,1000,0.00282622,0,1,0,0,1
"83657",41828500,1000,0.00299535,0,1,1,1,3
"83658",41829000,1000,0.00281622,0,0,1,2,3
"83659",41829500,1000,0.0026446,0,0,0,1,1
"83660",41830000,1000,0.00270177,0,0,0,1,1
"83661",41830500,1000,0.0027691,0,0,0,2,2
"83662",41831000,1000,0.00275329,0,0,0,1,1
"83663",41831500,1000,0.00262123,0,0,0,0,0
"83664",41832000,1000,0.00260825,0,0,0,0,0
"83665",41832500,1000,0.00278734,0,0,1,1,2
"83666",41833000,1000,0.00279565,0,0,1,2,3
"83667",41833500,1000,0.00276775,0,0,1,2,3
"83668",41834000,1000,0.00269293,0,0,1,1,2
"83669",41834500,1000,0.00259156,0,0,0,1,1
"83670",41835000,1000,0.00268267,0,0,0,2,2
"83671",41835500,1000,0.0026459,0,0,0,1,1
"83672",41836000,1000,0.00249877,0,0,0,0,0
"83673",41836500,1000,0.0025489,0,0,0,0,0
"83674",41837000,1000,0.00263718,0,0,0,1,1
"83675",41837500,1000,0.00271316,0,0,0,2,2
"83676",41838000,1000,0.00276654,0,0,0,2,2
"83677",41838500,1000,0.00278358,0,0,1,3,4
"83678",41839000,1000,0.00269776,0,0,1,3,4
"83679",41839500,1000,0.00263818,0,0,0,1,1
"83680",41840000,1000,0.00270549,0,0,0,2,2
"83681",41840500,1000,0.00268786,0,0,0,3,3
"83682",41841000,1000,0.00259665,0,0,0,1,1
"83683",41841500,1000,0.00274362,0,0,0,2,2
"83684",41842000,1000,0.0028623,0,0,0,3,3
"83685",41842500,1000,0.00273484,0,0,1,2,3
"83686",41843000,1000,0.00278085,0,0,2,2,4
"83687",41843500,1000,0.0027932,0,0,1,4,5
"83688",41844000,1000,0.00273663,0,0,1,3,4
"83689",41844500,1000,0.00277758,0,0,1,3,4
"83690",41845000,1000,0.002676,0,0,0,4,4
"83691",41845500,1000,0.00270725,0,0,0,3,3
"83692",41846000,1000,0.00282016,0,0,0,4,4
"83693",41846500,1000,0.00278273,0,0,0,5,5
"83694",41847000,1000,0.00280555,0,0,0,3,3
"83695",41847500,1000,0.00274973,0,0,0,1,1
"83696",41848000,1000,0.00265331,0,0,0,2,2
"83697",41848500,1000,0.00256974,0,0,0,1,1
"83698",41849000,1000,0.00251001,0,0,0,0,0
"83699",41849500,1000,0.00245731,0,0,0,0,0
"83700",41850000,1000,0.00244376,0,0,0,0,0
"83701",41850500,1000,0.00250285,0,0,0,0,0
"83702",41851000,1000,0.00276446,0,0,1,1,2
"83703",41851500,1000,0.0027685,0,0,1,2,3
"83704",41852000,1000,0.00251392,0,0,0,1,1
"83705",41852500,1000,0.00263305,0,0,0,2,2
"83706",41853000,1000,0.00264776,0,0,0,2,2
"83707",41853500,1000,0.00261172,0,0,0,0,0
"83708",41854000,1000,0.00267265,0,0,0,0,0
"83709",41854500,1000,0.00265461,0,0,0,0,0
"83710",41855000,1000,0.00264108,0,0,0,0,0
"83711",41855500,1000,0.00266721,0,0,0,2,2
"83712",41856000,1000,0.00285019,0,0,1,4,5
"83713",41856500,1000,0.0028592,0,0,1,4,5
"83714",41857000,1000,0.00288607,0,0,1,4,5
"83715",41857500,1000,0.00276501,0,0,1,2,3
"83716",41858000,1000,0.00270606,0,0,0,2,2
"83717",41858500,1000,0.00275999,0,0,0,3,3
"83718",41859000,1000,0.00275758,0,0,1,2,3
"83719",41859500,1000,0.0027247,0,0,1,1,2
"83720",41860000,1000,0.00255721,0,0,0,0,0
"83721",41860500,1000,0.00257884,0,0,0,0,0
"83722",41861000,1000,0.00269484,0,0,0,2,2
"83723",41861500,1000,0.00276963,0,0,1,2,3
"83724",41862000,1000,0.00273885,0,0,2,0,2
"83725",41862500,1000,0.00265129,0,0,1,0,1
"83726",41863000,1000,0.00280605,0,0,1,1,2
"83727",41863500,1000,0.00285284,0,0,1,1,2
"83728",41864000,1000,0.00258841,0,0,0,0,0
"83729",41864500,1000,0.00260172,0,0,0,0,0
"83730",41865000,1000,0.0026633,0,0,0,1,1
"83731",41865500,1000,0.00259392,0,0,0,1,1
"83732",41866000,1000,0.00263662,0,0,1,1,2
"83733",41866500,1000,0.00274973,0,0,1,1,2
"83734",41867000,1000,0.00261881,0,0,0,0,0
"83735",41867500,1000,0.00248343,0,0,0,0,0
"83736",41868000,1000,0.0025031,0,0,0,0,0
"83737",41868500,1000,0.0024889,0,0,0,0,0
"83738",41869000,1000,0.00258727,0,0,0,0,0
"83739",41869500,1000,0.00271179,0,0,0,0,0
"83740",41870000,1000,0.00283271,0,0,0,1,1
"83741",41870500,1000,0.00296317,0,1,0,1,2
"83742",41871000,1000,0.00297804,0,2,0,0,2
"83743",41871500,1000,0.00287133,0,1,0,0,1
"83744",41872000,1000,0.00271435,0,0,0,0,0
"83745",41872500,1000,0.00285168,0,1,0,1,2
"83746",41873000,1000,0.00298118,0,1,1,1,3
"83747",41873500,1000,0.00286638,0,0,1,1,2
"83748",41874000,1000,0.00272634,0,0,0,1,1
"83749",41874500,1000,0.00278079,0,0,0,2,2
"83750",41875000,1000,0.00291069,0,0,1,3,4
"83751",41875500,1000,0.00276809,0,0,1,1,2
"83752",41876000,1000,0.00258786,0,0,0,0,0
"83753",41876500,1000,0.00254245,0,0,0,0,0
"83754",41877000,1000,0.00269512,0,0,1,0,1
"83755",41877500,1000,0.00281032,0,0,1,0,1
"83756",41878000,1000,0.00272127,0,0,0,0,0
"83757",41878500,1000,0.00264211,0,0,0,0,0
"83758",41879000,1000,0.00267553,0,0,0,1,1
"83759",41879500,1000,0.00272433,0,0,0,2,2
"83760",41880000,1000,0.00270017,0,0,0,1,1
"83761",41880500,1000,0.0026717,0,0,0,1,1
"83762",41881000,1000,0.00271515,0,0,1,1,2
"83763",41881500,1000,0.00265353,0,0,1,0,1
"83764",41882000,1000,0.00273763,0,1,0,0,1
"83765",41882500,1000,0.00284316,0,1,0,0,1
"83766",41883000,1000,0.00274911,0,0,0,1,1
"83767",41883500,1000,0.00271159,0,0,0,2,2
"83768",41884000,1000,0.002616,0,0,0,1,1
"83769",41884500,1000,0.00270558,0,0,1,1,2
"83770",41885000,1000,0.0027629,0,0,1,1,2
"83771",41885500,1000,0.00265962,0,0,0,2,2
"83772",41886000,1000,0.00273207,0,0,0,2,2
"83773",41886500,1000,0.00271104,0,0,0,0,0
"83774",41887000,1000,0.0026551,0,0,0,1,1
"83775",41887500,1000,0.00275547,0,0,1,2,3
"83776",41888000,1000,0.00278765,0,0,1,1,2
"83777",41888500,1000,0.00266504,0,0,0,0,0
"83778",41889000,1000,0.00260755,0,0,0,1,1
"83779",41889500,1000,0.0028531,0,0,1,3,4
"83780",41890000,1000,0.00279779,0,0,1,2,3
"83781",41890500,1000,0.00253233,0,0,0,1,1
"83782",41891000,1000,0.0026056,0,0,0,1,1
"83783",41891500,1000,0.0027232,0,0,0,3,3
"83784",41892000,1000,0.00291143,0,1,0,3,4
"83785",41892500,1000,0.00289834,0,1,0,2,3
"83786",41893000,1000,0.00268127,0,0,0,2,2
"83787",41893500,1000,0.00273717,0,0,0,0,0
"83788",41894000,1000,0.00273131,0,0,0,0,0
"83789",41894500,1000,0.00256921,0,0,0,0,0
"83790",41895000,1000,0.00266576,0,0,0,0,0
"83791",41895500,1000,0.00284111,0,0,1,0,1
"83792",41896000,1000,0.00284957,0,0,1,0,1
"83793",41896500,1000,0.00272323,0,0,0,0,0
"83794",41897000,1000,0.00264138,0,0,0,0,0
"83795",41897500,1000,0.00264994,0,0,0,1,1
"83796",41898000,1000,0.00262012,0,0,0,2,2
"83797",41898500,1000,0.00262287,0,0,0,1,1
"83798",41899000,1000,0.00266328,0,0,0,2,2
"83799",41899500,1000,0.00275913,0,0,0,4,4
"83800",41900000,1000,0.00271949,0,0,0,3,3
"83801",41900500,1000,0.00264494,0,0,0,1,1
"83802",41901000,1000,0.00270758,0,0,0,2,2
"83803",41901500,1000,0.00270247,0,0,0,2,2
"83804",41902000,1000,0.00267931,0,0,0,1,1
"83805",41902500,1000,0.00268027,0,0,0,1,1
"83806",41903000,1000,0.0027006,0,0,0,0,0
"83807",41903500,1000,0.00293067,0,1,0,1,2
"83808",41904000,1000,0.0028342,0,1,0,1,2
"83809",41904500,1000,0.00277907,0,0,0,3,3
"83810",41905000,1000,0.00287947,0,0,0,3,3
"83811",41905500,1000,0.00269726,0,0,0,0,0
"83812",41906000,1000,0.00272097,0,0,0,1,1
"83813",41906500,1000,0.00281176,0,1,0,1,2
"83814",41907000,1000,0.00284526,0,2,0,1,3
"83815",41907500,1000,0.00290251,0,2,0,2,4
"83816",41908000,1000,0.00295661,0,1,0,2,3
"83817",41908500,1000,0.00300958,0,0,1,3,4
"83818",41909000,1000,0.00291856,0,0,1,2,3
"83819",41909500,1000,0.00276148,0,0,0,0,0
"83820",41910000,1000,0.00281793,0,0,0,1,1
"83821",41910500,1000,0.00279265,0,0,0,1,1
"83822",41911000,1000,0.00271221,0,0,0,0,0
"83823",41911500,1000,0.00274009,0,0,1,1,2
"83824",41912000,1000,0.00284878,0,0,1,2,3
"83825",41912500,1000,0.00288816,0,0,1,1,2
"83826",41913000,1000,0.00275951,0,0,1,1,2
"83827",41913500,1000,0.00271765,0,0,0,1,1
"83828",41914000,1000,0.00267448,0,0,0,0,0
"83829",41914500,1000,0.00262139,0,0,0,0,0
"83830",41915000,1000,0.00263865,0,0,0,0,0
"83831",41915500,1000,0.00267665,0,0,0,1,1
"83832",41916000,1000,0.00264181,0,0,0,1,1
"83833",41916500,1000,0.0028648,0,0,1,3,4
"83834",41917000,1000,0.00302245,0,0,1,4,5
"83835",41917500,1000,0.00276522,0,0,0,1,1
"83836",41918000,1000,0.00257675,0,0,0,1,1
"83837",41918500,1000,0.00238656,0,0,0,1,1
"83838",41919000,1000,0.00240165,0,0,0,0,0
"83839",41919500,1000,0.00263393,0,0,0,0,0
"83840",41920000,1000,0.00280803,0,0,0,2,2
"83841",41920500,1000,0.00283542,0,0,1,2,3
"83842",41921000,1000,0.00269341,0,0,1,1,2
"83843",41921500,1000,0.00268639,0,0,0,3,3
"83844",41922000,1000,0.00272914,0,0,0,3,3
"83845",41922500,1000,0.0026857,0,0,0,2,2
"83846",41923000,1000,0.00268272,0,0,0,2,2
"83847",41923500,1000,0.00262703,0,0,0,2,2
"83848",41924000,1000,0.00266737,0,0,0,4,4
"83849",41924500,1000,0.00267242,0,0,0,3,3
"83850",41925000,1000,0.00258131,0,0,0,0,0
"83851",41925500,1000,0.0026922,0,0,0,0,0
"83852",41926000,1000,0.00272126,0,0,0,0,0
"83853",41926500,1000,0.00273977,0,0,0,1,1
"83854",41927000,1000,0.00276008,0,0,0,1,1
"83855",41927500,1000,0.00274953,0,0,1,0,1
"83856",41928000,1000,0.00265427,0,0,1,0,1
"83857",41928500,1000,0.00267707,0,0,0,2,2
"83858",41929000,1000,0.00287984,0,0,0,4,4
"83859",41929500,1000,0.00270315,0,0,0,2,2
"83860",41930000,1000,0.00261672,0,0,0,1,1
"83861",41930500,1000,0.00264544,0,0,0,1,1
"83862",41931000,1000,0.00274598,0,0,1,2,3
"83863",41931500,1000,0.00290439,0,0,2,3,5
"83864",41932000,1000,0.00286162,0,0,1,1,2
"83865",41932500,1000,0.00275372,0,0,0,0,0
"83866",41933000,1000,0.00282202,0,0,0,3,3
"83867",41933500,1000,0.00281876,0,0,0,3,3
"83868",41934000,1000,0.00266964,0,0,0,1,1
"83869",41934500,1000,0.00272416,0,0,0,2,2
"83870",41935000,1000,0.00275642,0,0,0,2,2
"83871",41935500,1000,0.00271604,0,0,0,1,1
"83872",41936000,1000,0.0026351,0,0,0,0,0
"83873",41936500,1000,0.00262267,0,0,0,0,0
"83874",41937000,1000,0.00289826,0,1,0,1,2
"83875",41937500,1000,0.00302507,0,1,0,3,4
"83876",41938000,1000,0.00282594,0,0,0,2,2
"83877",41938500,1000,0.00284633,0,0,0,1,1
"83878",41939000,1000,0.00288249,0,0,0,2,2
"83879",41939500,1000,0.00280496,0,0,0,2,2
"83880",41940000,1000,0.00275576,0,0,0,2,2
"83881",41940500,1000,0.00258966,0,0,0,1,1
"83882",41941000,1000,0.00268194,0,0,0,1,1
"83883",41941500,1000,0.002866,0,0,1,2,3
"83884",41942000,1000,0.00277637,0,0,1,2,3
"83885",41942500,1000,0.0026901,0,0,0,1,1
"83886",41943000,1000,0.00263772,0,0,0,0,0
"83887",41943500,1000,0.0027,0,0,0,2,2
"83888",41944000,1000,0.00274206,0,0,0,2,2
"83889",41944500,1000,0.0026452,0,0,0,1,1
"83890",41945000,1000,0.002765,0,1,0,2,3
"83891",41945500,1000,0.00283154,0,1,1,2,4
"83892",41946000,1000,0.00275183,0,0,1,2,3
"83893",41946500,1000,0.00268079,0,0,0,3,3
"83894",41947000,1000,0.0027071,0,0,1,3,4
"83895",41947500,1000,0.00267422,0,0,1,1,2
"83896",41948000,1000,0.00255691,0,0,0,0,0
"83897",41948500,1000,0.00266099,0,0,1,0,1
"83898",41949000,1000,0.00274075,0,0,1,0,1
"83899",41949500,1000,0.00281864,0,0,1,1,2
"83900",41950000,1000,0.00285775,0,0,2,2,4
"83901",41950500,1000,0.00278943,0,0,2,1,3
"83902",41951000,1000,0.00276751,0,0,1,1,2
"83903",41951500,1000,0.00269088,0,0,0,1,1
"83904",41952000,1000,0.00266149,0,0,0,2,2
"83905",41952500,1000,0.00266858,0,0,0,2,2
"83906",41953000,1000,0.00271361,0,0,0,2,2
"83907",41953500,1000,0.00279165,0,0,0,3,3
"83908",41954000,1000,0.00283983,0,0,1,2,3
"83909",41954500,1000,0.00276425,0,0,1,1,2
"83910",41955000,1000,0.00267358,0,0,0,0,0
"83911",41955500,1000,0.00280027,0,0,1,1,2
"83912",41956000,1000,0.00284822,0,0,3,2,5
"83913",41956500,1000,0.00270812,0,0,2,2,4
"83914",41957000,1000,0.00261517,0,0,0,1,1
"83915",41957500,1000,0.00256856,0,0,0,0,0
"83916",41958000,1000,0.0026505,0,0,0,2,2
"83917",41958500,1000,0.00274803,0,0,0,4,4
"83918",41959000,1000,0.00277248,0,0,0,2,2
"83919",41959500,1000,0.00282266,0,0,0,2,2
"83920",41960000,1000,0.00278143,0,0,0,3,3
"83921",41960500,1000,0.00283826,0,0,1,2,3
"83922",41961000,1000,0.00275716,0,0,1,1,2
"83923",41961500,1000,0.00270133,0,0,0,0,0
"83924",41962000,1000,0.00275844,0,0,0,0,0
"83925",41962500,1000,0.00264335,0,0,0,0,0
"83926",41963000,1000,0.00258552,0,0,0,0,0
"83927",41963500,1000,0.00255676,0,0,0,0,0
"83928",41964000,1000,0.00265686,0,0,0,3,3
"83929",41964500,1000,0.0026883,0,0,0,4,4
"83930",41965000,1000,0.0027522,0,0,0,1,1
"83931",41965500,1000,0.0027401,0,0,0,0,0
"83932",41966000,1000,0.00263382,0,0,0,1,1
"83933",41966500,1000,0.00250556,0,0,0,1,1
"83934",41967000,1000,0.0024363,0,0,0,1,1
"83935",41967500,1000,0.0025732,0,0,0,1,1
"83936",41968000,1000,0.00274351,0,0,0,1,1
"83937",41968500,1000,0.0028849,0,0,0,1,1
"83938",41969000,1000,0.0027147,0,0,0,0,0
"83939",41969500,1000,0.00268308,0,0,0,1,1
"83940",41970000,1000,0.00264145,0,0,0,1,1
"83941",41970500,1000,0.00257128,0,0,0,0,0
"83942",41971000,1000,0.0026516,0,0,0,0,0
"83943",41971500,1000,0.00276438,0,0,1,1,2
"83944",41972000,1000,0.00272388,0,0,1,1,2
"83945",41972500,1000,0.00290439,0,1,1,1,3
"83946",41973000,1000,0.0031029,0,1,2,1,4
"83947",41973500,1000,0.00298519,0,0,2,0,2
"83948",41974000,1000,0.00282248,0,0,1,0,1
"83949",41974500,1000,0.0026274,0,0,0,1,1
"83950",41975000,1000,0.0027179,0,0,0,1,1
"83951",41975500,1000,0.00289445,0,0,1,2,3
"83952",41976000,1000,0.00291151,0,0,1,3,4
"83953",41976500,1000,0.00280636,0,0,0,3,3
"83954",41977000,1000,0.00266631,0,0,0,2,2
"83955",41977500,1000,0.00257814,0,0,0,0,0
"83956",41978000,1000,0.00259626,0,0,0,0,0
"83957",41978500,1000,0.00264547,0,0,1,0,1
"83958",41979000,1000,0.00269829,0,0,1,2,3
"83959",41979500,1000,0.00267433,0,0,0,2,2
"83960",41980000,1000,0.00280788,0,0,1,1,2
"83961",41980500,1000,0.00287572,0,0,2,2,4
"83962",41981000,1000,0.00284374,0,0,1,4,5
"83963",41981500,1000,0.00293251,0,0,0,5,5
"83964",41982000,1000,0.00294492,0,0,0,2,2
"83965",41982500,1000,0.00273011,0,0,0,1,1
"83966",41983000,1000,0.0025561,0,0,0,2,2
"83967",41983500,1000,0.00268015,0,0,0,1,1
"83968",41984000,1000,0.00260439,0,0,0,0,0
"83969",41984500,1000,0.00274375,0,0,1,1,2
"83970",41985000,1000,0.00286865,0,0,2,2,4
"83971",41985500,1000,0.00269912,0,0,1,1,2
"83972",41986000,1000,0.0026615,0,0,0,0,0
"83973",41986500,1000,0.00263092,0,0,0,0,0
"83974",41987000,1000,0.0026173,0,0,0,0,0
"83975",41987500,1000,0.00280699,0,1,0,1,2
"83976",41988000,1000,0.00290994,0,1,1,1,3
"83977",41988500,1000,0.00271117,0,0,1,0,1
"83978",41989000,1000,0.00261502,0,0,0,0,0
"83979",41989500,1000,0.00263958,0,0,0,0,0
"83980",41990000,1000,0.00276462,0,0,0,0,0
"83981",41990500,1000,0.00269555,0,0,0,0,0
"83982",41991000,1000,0.00253271,0,0,0,0,0
"83983",41991500,1000,0.00265293,0,0,0,2,2
"83984",41992000,1000,0.00282148,0,0,0,2,2
"83985",41992500,1000,0.00278234,0,0,0,0,0
"83986",41993000,1000,0.00271434,0,0,0,2,2
"83987",41993500,1000,0.00265647,0,0,0,2,2
"83988",41994000,1000,0.0026611,0,0,0,2,2
"83989",41994500,1000,0.00268291,0,0,0,2,2
"83990",41995000,1000,0.00271718,0,0,0,0,0
"83991",41995500,1000,0.00270308,0,0,0,0,0
"83992",41996000,1000,0.0026787,0,0,0,0,0
"83993",41996500,1000,0.00271929,0,0,0,0,0
"83994",41997000,1000,0.00273335,0,0,0,2,2
"83995",41997500,1000,0.00263868,0,0,0,2,2
"83996",41998000,1000,0.00255488,0,0,0,1,1
"83997",41998500,1000,0.00258883,0,0,0,2,2
"83998",41999000,1000,0.00260592,0,0,0,2,2
"83999",41999500,1000,0.00264926,0,0,0,1,1
"84000",42000000,1000,0.00269622,0,0,0,0,0
"84001",42000500,1000,0.00265896,0,0,0,0,0
"84002",42001000,1000,0.00268731,0,0,1,1,2
"84003",42001500,1000,0.0026755,0,0,1,2,3
"84004",42002000,1000,0.00255061,0,0,0,1,1
"84005",42002500,1000,0.00255869,0,0,0,1,1
"84006",42003000,1000,0.00266379,0,0,0,1,1
"84007",42003500,1000,0.00273018,0,0,0,1,1
"84008",42004000,1000,0.00274372,0,0,0,4,4
"84009",42004500,1000,0.00271289,0,0,0,3,3
"84010",42005000,1000,0.00263027,0,0,0,1,1
"84011",42005500,1000,0.00249889,0,0,0,1,1
"84012",42006000,1000,0.00255392,0,0,0,2,2
"84013",42006500,1000,0.00278261,0,0,0,5,5
"84014",42007000,1000,0.00275809,0,0,1,3,4
"84015",42007500,1000,0.00262027,0,0,1,0,1
"84016",42008000,1000,0.00257253,0,0,0,1,1
"84017",42008500,1000,0.00268425,0,0,0,4,4
"84018",42009000,1000,0.00264477,0,0,0,3,3
"84019",42009500,1000,0.00253541,0,0,0,0,0
"84020",42010000,1000,0.00263195,0,0,0,0,0
"84021",42010500,1000,0.00268824,0,0,0,1,1
"84022",42011000,1000,0.00266951,0,0,0,1,1
"84023",42011500,1000,0.00271405,0,0,0,1,1
"84024",42012000,1000,0.002753,0,0,0,1,1
"84025",42012500,1000,0.00261935,0,0,0,0,0
"84026",42013000,1000,0.00264562,0,0,0,1,1
"84027",42013500,1000,0.0026585,0,0,0,1,1
"84028",42014000,1000,0.00260871,0,0,0,2,2
"84029",42014500,1000,0.002774,0,0,1,2,3
"84030",42015000,1000,0.00274076,0,0,1,0,1
"84031",42015500,1000,0.00269028,0,0,1,1,2
"84032",42016000,1000,0.00270153,0,0,1,1,2
"84033",42016500,1000,0.00268085,0,0,0,1,1
"84034",42017000,1000,0.00262972,0,0,0,1,1
"84035",42017500,1000,0.00255779,0,0,0,0,0
"84036",42018000,1000,0.0026048,0,0,0,1,1
"84037",42018500,1000,0.00260526,0,0,0,1,1
"84038",42019000,1000,0.00264399,0,0,0,1,1
"84039",42019500,1000,0.00274361,0,0,0,1,1
"84040",42020000,1000,0.00264321,0,0,0,0,0
"84041",42020500,1000,0.00262215,0,0,0,1,1
"84042",42021000,1000,0.00276429,0,0,0,1,1
"84043",42021500,1000,0.00277433,0,0,0,0,0
"84044",42022000,1000,0.00267421,0,0,0,0,0
"84045",42022500,1000,0.00298218,0,2,0,0,2
"84046",42023000,1000,0.00311586,0,2,0,1,3
"84047",42023500,1000,0.00294206,0,0,0,2,2
"84048",42024000,1000,0.0029911,0,1,0,1,2
"84049",42024500,1000,0.00291099,0,1,0,0,1
"84050",42025000,1000,0.00276574,0,0,0,2,2
"84051",42025500,1000,0.00262803,0,0,0,2,2
"84052",42026000,1000,0.00268941,0,0,0,2,2
"84053",42026500,1000,0.00295367,0,1,0,2,3
"84054",42027000,1000,0.00289474,0,1,0,1,2
"84055",42027500,1000,0.00272819,0,0,0,1,1
"84056",42028000,1000,0.00279629,0,0,1,1,2
"84057",42028500,1000,0.00281984,0,0,1,2,3
"84058",42029000,1000,0.00277692,0,0,0,1,1
"84059",42029500,1000,0.00277374,0,0,1,1,2
"84060",42030000,1000,0.00278502,0,0,2,2,4
"84061",42030500,1000,0.00282154,0,0,3,1,4
"84062",42031000,1000,0.00286096,0,0,2,1,3
"84063",42031500,1000,0.00306941,0,0,2,2,4
"84064",42032000,1000,0.00306379,0,0,3,2,5
"84065",42032500,1000,0.00281725,0,0,1,3,4
"84066",42033000,1000,0.00272809,0,0,0,2,2
"84067",42033500,1000,0.00274349,0,0,0,1,1
"84068",42034000,1000,0.00280057,0,0,0,1,1
"84069",42034500,1000,0.00277892,0,0,0,2,2
"84070",42035000,1000,0.00271227,0,0,0,2,2
"84071",42035500,1000,0.00266685,0,0,0,1,1
"84072",42036000,1000,0.00270078,0,0,0,2,2
"84073",42036500,1000,0.002615,0,0,0,1,1
"84074",42037000,1000,0.00273189,0,0,0,1,1
"84075",42037500,1000,0.00276707,0,0,0,1,1
"84076",42038000,1000,0.00259131,0,0,0,0,0
"84077",42038500,1000,0.00271377,0,0,0,1,1
"84078",42039000,1000,0.00283451,0,0,1,2,3
"84079",42039500,1000,0.00272293,0,0,1,1,2
"84080",42040000,1000,0.0025904,0,0,0,0,0
"84081",42040500,1000,0.00255532,0,0,0,0,0
"84082",42041000,1000,0.00258503,0,0,0,0,0
"84083",42041500,1000,0.0026887,0,0,0,1,1
"84084",42042000,1000,0.00274523,0,0,1,1,2
"84085",42042500,1000,0.0026708,0,0,1,0,1
"84086",42043000,1000,0.00268778,0,0,1,0,1
"84087",42043500,1000,0.002704,0,0,1,0,1
"84088",42044000,1000,0.00272809,0,0,0,3,3
"84089",42044500,1000,0.002757,0,0,0,3,3
"84090",42045000,1000,0.00290058,0,0,2,2,4
"84091",42045500,1000,0.00296213,0,0,2,3,5
"84092",42046000,1000,0.00277762,0,0,0,1,1
"84093",42046500,1000,0.00256673,0,0,0,0,0
"84094",42047000,1000,0.00260297,0,0,0,3,3
"84095",42047500,1000,0.00286537,0,0,1,5,6
"84096",42048000,1000,0.00290117,0,0,2,2,4
"84097",42048500,1000,0.00270992,0,0,1,0,1
"84098",42049000,1000,0.00254023,0,0,0,0,0
"84099",42049500,1000,0.00264289,0,0,0,2,2
"84100",42050000,1000,0.00275316,0,0,0,3,3
"84101",42050500,1000,0.00259229,0,0,0,2,2
"84102",42051000,1000,0.00282504,0,1,1,1,3
"84103",42051500,1000,0.00299888,0,1,1,0,2
"84104",42052000,1000,0.0026724,0,0,0,0,0
"84105",42052500,1000,0.00259774,0,0,0,1,1
"84106",42053000,1000,0.00273853,0,0,0,2,2
"84107",42053500,1000,0.00272414,0,0,0,1,1
"84108",42054000,1000,0.0027823,0,0,0,0,0
"84109",42054500,1000,0.00298481,0,0,1,1,2
"84110",42055000,1000,0.00284223,0,0,1,1,2
"84111",42055500,1000,0.00272456,0,0,0,0,0
"84112",42056000,1000,0.00276525,0,1,0,0,1
"84113",42056500,1000,0.00274391,0,1,0,0,1
"84114",42057000,1000,0.00273533,0,0,0,0,0
"84115",42057500,1000,0.00275012,0,0,0,2,2
"84116",42058000,1000,0.00274096,0,0,0,3,3
"84117",42058500,1000,0.00281358,0,1,0,1,2
"84118",42059000,1000,0.00279119,0,1,0,0,1
"84119",42059500,1000,0.00272967,0,0,0,1,1
"84120",42060000,1000,0.00282134,0,0,0,2,2
"84121",42060500,1000,0.00280666,0,0,0,2,2
"84122",42061000,1000,0.00266092,0,0,0,2,2
"84123",42061500,1000,0.00263497,0,0,0,1,1
"84124",42062000,1000,0.00272353,0,0,1,0,1
"84125",42062500,1000,0.00270553,0,0,1,0,1
"84126",42063000,1000,0.00277778,0,0,0,2,2
"84127",42063500,1000,0.00275776,0,0,0,3,3
"84128",42064000,1000,0.00259977,0,0,0,1,1
"84129",42064500,1000,0.00285854,0,1,0,0,1
"84130",42065000,1000,0.0028648,0,1,0,1,2
"84131",42065500,1000,0.00266132,0,0,0,2,2
"84132",42066000,1000,0.00275521,0,0,0,1,1
"84133",42066500,1000,0.00306318,0,1,0,1,2
"84134",42067000,1000,0.00300261,0,1,0,1,2
"84135",42067500,1000,0.00268792,0,0,0,1,1
"84136",42068000,1000,0.00273628,0,0,0,1,1
"84137",42068500,1000,0.00272938,0,0,1,0,1
"84138",42069000,1000,0.00268701,0,0,1,0,1
"84139",42069500,1000,0.00259473,0,0,0,0,0
"84140",42070000,1000,0.00263045,0,0,1,1,2
"84141",42070500,1000,0.00274867,0,0,1,1,2
"84142",42071000,1000,0.00274675,0,0,0,0,0
"84143",42071500,1000,0.00275874,0,0,0,0,0
"84144",42072000,1000,0.00266789,0,0,0,0,0
"84145",42072500,1000,0.00248527,0,0,0,1,1
"84146",42073000,1000,0.00260431,0,0,1,2,3
"84147",42073500,1000,0.0027858,0,0,1,1,2
"84148",42074000,1000,0.00270656,0,0,0,1,1
"84149",42074500,1000,0.00280247,0,0,1,3,4
"84150",42075000,1000,0.00285411,0,0,1,3,4
"84151",42075500,1000,0.00280125,0,0,1,3,4
"84152",42076000,1000,0.00287452,0,0,2,3,5
"84153",42076500,1000,0.0027416,0,0,1,1,2
"84154",42077000,1000,0.00261603,0,0,0,0,0
"84155",42077500,1000,0.00262466,0,0,0,0,0
"84156",42078000,1000,0.00260499,0,0,0,1,1
"84157",42078500,1000,0.00268152,0,0,0,1,1
"84158",42079000,1000,0.00269029,0,0,0,1,1
"84159",42079500,1000,0.00263095,0,0,0,2,2
"84160",42080000,1000,0.00270589,0,0,0,1,1
"84161",42080500,1000,0.0027381,0,0,0,0,0
"84162",42081000,1000,0.0028318,0,0,1,0,1
"84163",42081500,1000,0.00304595,0,0,3,1,4
"84164",42082000,1000,0.00295281,0,0,2,2,4
"84165",42082500,1000,0.0028242,0,0,0,3,3
"84166",42083000,1000,0.00272738,0,0,0,3,3
"84167",42083500,1000,0.00260423,0,0,0,2,2
"84168",42084000,1000,0.00257588,0,0,0,2,2
"84169",42084500,1000,0.00246393,0,0,0,1,1
"84170",42085000,1000,0.0026565,0,0,0,1,1
"84171",42085500,1000,0.00283519,0,0,0,3,3
"84172",42086000,1000,0.00287839,0,0,1,4,5
"84173",42086500,1000,0.00271566,0,0,1,2,3
"84174",42087000,1000,0.00246548,0,0,0,0,0
"84175",42087500,1000,0.00256975,0,0,0,0,0
"84176",42088000,1000,0.00264918,0,0,0,0,0
"84177",42088500,1000,0.00258387,0,0,0,0,0
"84178",42089000,1000,0.00260071,0,0,0,0,0
"84179",42089500,1000,0.00259914,0,0,0,0,0
"84180",42090000,1000,0.00259628,0,0,0,1,1
"84181",42090500,1000,0.00274947,0,0,1,2,3
"84182",42091000,1000,0.00277759,0,0,1,2,3
"84183",42091500,1000,0.0027375,0,0,0,1,1
"84184",42092000,1000,0.0027548,0,0,0,1,1
"84185",42092500,1000,0.0026234,0,0,0,1,1
"84186",42093000,1000,0.00269541,0,0,2,0,2
"84187",42093500,1000,0.00280462,0,0,2,1,3
"84188",42094000,1000,0.00277717,0,0,1,1,2
"84189",42094500,1000,0.00287359,0,0,2,1,3
"84190",42095000,1000,0.00270639,0,0,1,1,2
"84191",42095500,1000,0.00267757,0,0,1,0,1
"84192",42096000,1000,0.00279137,0,0,1,1,2
"84193",42096500,1000,0.00266194,0,0,0,1,1
"84194",42097000,1000,0.00275323,0,0,1,0,1
"84195",42097500,1000,0.00275608,0,0,1,0,1
"84196",42098000,1000,0.00253786,0,0,0,0,0
"84197",42098500,1000,0.00253079,0,0,0,0,0
"84198",42099000,1000,0.00263625,0,0,0,1,1
"84199",42099500,1000,0.00258766,0,0,0,1,1
"84200",42100000,1000,0.00265612,0,0,1,0,1
"84201",42100500,1000,0.00275502,0,0,1,2,3
"84202",42101000,1000,0.00271053,0,0,0,3,3
"84203",42101500,1000,0.00274512,0,0,0,1,1
"84204",42102000,1000,0.00275867,0,0,0,0,0
"84205",42102500,1000,0.00266747,0,0,0,1,1
"84206",42103000,1000,0.00260972,0,0,0,2,2
"84207",42103500,1000,0.00264584,0,0,0,1,1
"84208",42104000,1000,0.00278983,0,0,1,1,2
"84209",42104500,1000,0.00278383,0,0,1,1,2
"84210",42105000,1000,0.002689,0,0,0,0,0
"84211",42105500,1000,0.00278692,0,0,1,0,1
"84212",42106000,1000,0.00272174,0,0,1,0,1
"84213",42106500,1000,0.00278434,0,0,1,2,3
"84214",42107000,1000,0.00276987,0,0,1,2,3
"84215",42107500,1000,0.00260422,0,0,0,0,0
"84216",42108000,1000,0.00272755,0,0,0,1,1
"84217",42108500,1000,0.00281507,0,0,0,1,1
"84218",42109000,1000,0.00280257,0,0,0,0,0
"84219",42109500,1000,0.00291481,0,0,1,2,3
"84220",42110000,1000,0.00283803,0,0,1,2,3
"84221",42110500,1000,0.0028013,0,0,1,1,2
"84222",42111000,1000,0.0028714,0,0,1,2,3
"84223",42111500,1000,0.00273403,0,0,0,1,1
"84224",42112000,1000,0.0026198,0,0,0,0,0
"84225",42112500,1000,0.0025872,0,0,0,0,0
"84226",42113000,1000,0.00260361,0,0,0,0,0
"84227",42113500,1000,0.00274058,0,0,0,0,0
"84228",42114000,1000,0.00279811,0,0,0,1,1
"84229",42114500,1000,0.00281724,0,0,0,1,1
"84230",42115000,1000,0.00284457,0,0,0,0,0
"84231",42115500,1000,0.00290381,0,0,0,1,1
"84232",42116000,1000,0.00286654,0,0,0,2,2
"84233",42116500,1000,0.00272199,0,0,0,3,3
"84234",42117000,1000,0.00285224,0,1,0,2,3
"84235",42117500,1000,0.00306745,0,2,0,0,2
"84236",42118000,1000,0.0030446,0,1,0,2,3
"84237",42118500,1000,0.00283415,0,0,0,2,2
"84238",42119000,1000,0.00263402,0,0,0,0,0
"84239",42119500,1000,0.00288262,0,1,0,0,1
"84240",42120000,1000,0.00309834,0,1,0,1,2
"84241",42120500,1000,0.00289245,0,1,0,1,2
"84242",42121000,1000,0.00264346,0,1,0,0,1
"84243",42121500,1000,0.00263318,0,0,0,2,2
"84244",42122000,1000,0.00280656,0,0,0,3,3
"84245",42122500,1000,0.00268734,0,0,0,1,1
"84246",42123000,1000,0.00267837,0,0,0,1,1
"84247",42123500,1000,0.00279541,0,0,1,2,3
"84248",42124000,1000,0.00266457,0,0,1,1,2
"84249",42124500,1000,0.00272392,0,0,1,0,1
"84250",42125000,1000,0.00282417,0,0,1,0,1
"84251",42125500,1000,0.00276766,0,0,0,0,0
"84252",42126000,1000,0.00284723,0,0,1,1,2
"84253",42126500,1000,0.00288661,0,0,2,2,4
"84254",42127000,1000,0.0027993,0,0,1,1,2
"84255",42127500,1000,0.00269499,0,0,0,1,1
"84256",42128000,1000,0.00264577,0,0,0,2,2
"84257",42128500,1000,0.00261705,0,0,0,1,1
"84258",42129000,1000,0.00295525,0,1,1,0,2
"84259",42129500,1000,0.00297795,0,1,1,0,2
"84260",42130000,1000,0.00271619,0,0,0,0,0
"84261",42130500,1000,0.00280031,0,0,0,1,1
"84262",42131000,1000,0.00273685,0,0,0,1,1
"84263",42131500,1000,0.00266262,0,0,0,0,0
"84264",42132000,1000,0.00262519,0,0,0,0,0
"84265",42132500,1000,0.00263407,0,0,0,1,1
"84266",42133000,1000,0.00273084,0,0,0,1,1
"84267",42133500,1000,0.00285507,0,0,0,0,0
"84268",42134000,1000,0.00278194,0,0,0,0,0
"84269",42134500,1000,0.00263057,0,0,0,1,1
"84270",42135000,1000,0.00268676,0,0,0,1,1
"84271",42135500,1000,0.00277801,0,0,0,0,0
"84272",42136000,1000,0.00277228,0,0,0,1,1
"84273",42136500,1000,0.00270117,0,0,0,1,1
"84274",42137000,1000,0.00268854,0,0,1,1,2
"84275",42137500,1000,0.00270263,0,0,2,1,3
"84276",42138000,1000,0.00274443,0,0,1,2,3
"84277",42138500,1000,0.00276352,0,0,0,2,2
"84278",42139000,1000,0.00274537,0,0,0,0,0
"84279",42139500,1000,0.00283165,0,1,0,0,1
"84280",42140000,1000,0.00284022,0,1,0,2,3
"84281",42140500,1000,0.00272267,0,0,0,3,3
"84282",42141000,1000,0.00264382,0,0,0,1,1
"84283",42141500,1000,0.00279058,0,0,0,0,0
"84284",42142000,1000,0.00277443,0,0,0,0,0
"84285",42142500,1000,0.00259998,0,0,0,0,0
"84286",42143000,1000,0.00269605,0,0,0,1,1
"84287",42143500,1000,0.00271691,0,0,0,2,2
"84288",42144000,1000,0.00259956,0,0,0,1,1
"84289",42144500,1000,0.00277905,0,1,1,1,3
"84290",42145000,1000,0.00281987,0,1,1,2,4
"84291",42145500,1000,0.00264875,0,0,0,3,3
"84292",42146000,1000,0.00276505,0,0,1,3,4
"84293",42146500,1000,0.00293095,0,0,2,2,4
"84294",42147000,1000,0.00282079,0,0,1,1,2
"84295",42147500,1000,0.00269421,0,0,1,0,1
"84296",42148000,1000,0.00285304,0,0,1,1,2
"84297",42148500,1000,0.00275131,0,0,0,1,1
"84298",42149000,1000,0.00256546,0,0,0,0,0
"84299",42149500,1000,0.00246848,0,0,0,0,0
"84300",42150000,1000,0.00273609,0,0,1,3,4
"84301",42150500,1000,0.00290706,0,0,1,5,6
"84302",42151000,1000,0.00280606,0,0,1,3,4
"84303",42151500,1000,0.00280609,0,0,1,2,3
"84304",42152000,1000,0.00261644,0,0,0,1,1
"84305",42152500,1000,0.0027815,0,0,1,1,2
"84306",42153000,1000,0.00286125,0,0,1,2,3
"84307",42153500,1000,0.00273305,0,0,0,2,2
"84308",42154000,1000,0.00278582,0,0,0,1,1
"84309",42154500,1000,0.00266745,0,0,0,0,0
"84310",42155000,1000,0.00267555,0,0,1,1,2
"84311",42155500,1000,0.00272377,0,0,1,1,2
"84312",42156000,1000,0.00267542,0,0,0,0,0
"84313",42156500,1000,0.00271108,0,0,0,1,1
"84314",42157000,1000,0.00270554,0,0,0,1,1
"84315",42157500,1000,0.00271734,0,0,0,2,2
"84316",42158000,1000,0.00278172,0,0,1,4,5
"84317",42158500,1000,0.00276304,0,0,1,4,5
"84318",42159000,1000,0.00277225,0,0,1,4,5
"84319",42159500,1000,0.00272347,0,0,1,2,3
"84320",42160000,1000,0.00274112,0,0,0,1,1
"84321",42160500,1000,0.00268807,0,0,0,1,1
"84322",42161000,1000,0.00258021,0,0,0,1,1
"84323",42161500,1000,0.00261307,0,0,0,1,1
"84324",42162000,1000,0.00268412,0,0,0,0,0
"84325",42162500,1000,0.00284792,0,0,1,1,2
"84326",42163000,1000,0.00279899,0,0,1,1,2
"84327",42163500,1000,0.00259345,0,0,0,0,0
"84328",42164000,1000,0.00251019,0,0,0,0,0
"84329",42164500,1000,0.00274388,0,0,1,3,4
"84330",42165000,1000,0.0028078,0,0,1,3,4
"84331",42165500,1000,0.00290611,0,1,0,2,3
"84332",42166000,1000,0.0029995,0,1,0,3,4
"84333",42166500,1000,0.00285647,0,1,0,1,2
"84334",42167000,1000,0.00279928,0,1,0,0,1
"84335",42167500,1000,0.00266551,0,0,0,0,0
"84336",42168000,1000,0.00265433,0,0,0,0,0
"84337",42168500,1000,0.00276019,0,0,1,1,2
"84338",42169000,1000,0.00281986,0,0,1,3,4
"84339",42169500,1000,0.0028805,0,0,0,3,3
"84340",42170000,1000,0.00285732,0,0,1,1,2
"84341",42170500,1000,0.00265494,0,0,1,0,1
"84342",42171000,1000,0.00285043,0,1,0,1,2
"84343",42171500,1000,0.00294566,0,1,0,1,2
"84344",42172000,1000,0.0027043,0,0,0,1,1
"84345",42172500,1000,0.002783,0,0,0,1,1
"84346",42173000,1000,0.00275889,0,0,0,1,1
"84347",42173500,1000,0.00273013,0,0,0,3,3
"84348",42174000,1000,0.00279567,0,0,0,2,2
"84349",42174500,1000,0.00273295,0,0,0,0,0
"84350",42175000,1000,0.00264828,0,0,0,0,0
"84351",42175500,1000,0.00278025,0,0,0,2,2
"84352",42176000,1000,0.00285348,0,0,0,2,2
"84353",42176500,1000,0.00275388,0,0,0,2,2
"84354",42177000,1000,0.00271516,0,0,0,3,3
"84355",42177500,1000,0.00260229,0,0,0,1,1
"84356",42178000,1000,0.00262555,0,0,0,0,0
"84357",42178500,1000,0.00292804,0,1,1,1,3
"84358",42179000,1000,0.00357319,0,2,3,4,9
"84359",42179500,1000,0.00342122,0,1,2,3,6
"84360",42180000,1000,0.00272325,0,0,0,0,0
"84361",42180500,1000,0.00252444,0,0,0,0,0
"84362",42181000,1000,0.00237628,0,0,0,0,0
"84363",42181500,1000,0.00247955,0,0,0,0,0
"84364",42182000,1000,0.00285187,0,0,0,1,1
"84365",42182500,1000,0.00295042,0,0,0,4,4
"84366",42183000,1000,0.00275191,0,0,0,4,4
"84367",42183500,1000,0.00263991,0,0,0,2,2
"84368",42184000,1000,0.00258608,0,0,0,1,1
"84369",42184500,1000,0.00264873,0,0,0,0,0
"84370",42185000,1000,0.00268747,0,0,0,0,0
"84371",42185500,1000,0.00257132,0,0,0,0,0
"84372",42186000,1000,0.00267051,0,0,0,2,2
"84373",42186500,1000,0.00280919,0,0,1,3,4
"84374",42187000,1000,0.0028329,0,0,2,1,3
"84375",42187500,1000,0.00285676,0,0,1,2,3
"84376",42188000,1000,0.00284024,0,0,1,3,4
"84377",42188500,1000,0.00272905,0,0,1,1,2
"84378",42189000,1000,0.00267084,0,0,0,1,1
"84379",42189500,1000,0.00265162,0,0,0,1,1
"84380",42190000,1000,0.00265162,0,0,0,0,0
"84381",42190500,1000,0.00280649,0,0,0,0,0
"84382",42191000,1000,0.00282079,0,0,0,1,1
"84383",42191500,1000,0.00278431,0,0,1,3,4
"84384",42192000,1000,0.00278037,0,0,1,3,4
"84385",42192500,1000,0.00267942,0,0,0,1,1
"84386",42193000,1000,0.00270277,0,0,0,0,0
"84387",42193500,1000,0.00275492,0,0,0,1,1
"84388",42194000,1000,0.00266232,0,0,0,1,1
"84389",42194500,1000,0.00272342,0,0,0,2,2
"84390",42195000,1000,0.00272087,0,0,0,2,2
"84391",42195500,1000,0.00279141,0,0,0,3,3
"84392",42196000,1000,0.00291957,0,0,1,4,5
"84393",42196500,1000,0.00270768,0,0,1,1,2
"84394",42197000,1000,0.00254899,0,0,0,1,1
"84395",42197500,1000,0.00266008,0,0,0,3,3
"84396",42198000,1000,0.00284974,0,1,0,2,3
"84397",42198500,1000,0.0028829,0,1,1,1,3
"84398",42199000,1000,0.00264448,0,0,1,1,2
"84399",42199500,1000,0.00255901,0,0,0,0,0
"84400",42200000,1000,0.0026588,0,0,0,0,0
"84401",42200500,1000,0.0026738,0,0,0,2,2
"84402",42201000,1000,0.00272258,0,0,0,2,2
"84403",42201500,1000,0.0028349,0,0,0,2,2
"84404",42202000,1000,0.00279634,0,0,0,2,2
"84405",42202500,1000,0.00267046,0,0,0,0,0
"84406",42203000,1000,0.00284304,0,0,0,3,3
"84407",42203500,1000,0.00288967,0,0,1,3,4
"84408",42204000,1000,0.00280975,0,0,1,0,1
"84409",42204500,1000,0.00268365,0,0,0,1,1
"84410",42205000,1000,0.00264257,0,0,0,4,4
"84411",42205500,1000,0.00268614,0,0,0,3,3
"84412",42206000,1000,0.00262877,0,0,0,1,1
"84413",42206500,1000,0.00267052,0,0,0,1,1
"84414",42207000,1000,0.00270759,0,0,1,1,2
"84415",42207500,1000,0.00259407,0,0,1,1,2
"84416",42208000,1000,0.00265651,0,0,0,4,4
"84417",42208500,1000,0.00277395,0,0,1,5,6
"84418",42209000,1000,0.00269555,0,0,1,1,2
"84419",42209500,1000,0.00270745,0,0,0,1,1
"84420",42210000,1000,0.00265755,0,0,0,2,2
"84421",42210500,1000,0.00265648,0,0,0,3,3
"84422",42211000,1000,0.00267866,0,0,0,2,2
"84423",42211500,1000,0.00272968,0,0,0,2,2
"84424",42212000,1000,0.00287299,0,0,0,2,2
"84425",42212500,1000,0.00279165,0,0,0,0,0
"84426",42213000,1000,0.00265712,0,0,0,1,1
"84427",42213500,1000,0.00303911,0,2,1,1,4
"84428",42214000,1000,0.00299179,0,2,1,0,3
"84429",42214500,1000,0.00257227,0,0,0,1,1
"84430",42215000,1000,0.00254014,0,0,0,1,1
"84431",42215500,1000,0.00264033,0,0,1,1,2
"84432",42216000,1000,0.00270447,0,0,1,1,2
"84433",42216500,1000,0.00272646,0,0,0,2,2
"84434",42217000,1000,0.00300236,0,1,0,2,3
"84435",42217500,1000,0.003027,0,1,0,3,4
"84436",42218000,1000,0.0029668,0,0,0,3,3
"84437",42218500,1000,0.00311681,0,1,0,0,1
"84438",42219000,1000,0.00304384,0,1,0,1,2
"84439",42219500,1000,0.00288309,0,0,0,1,1
"84440",42220000,1000,0.00288795,0,0,0,1,1
"84441",42220500,1000,0.00288103,0,0,0,1,1
"84442",42221000,1000,0.00280543,0,0,0,0,0
"84443",42221500,1000,0.00285251,0,0,0,2,2
"84444",42222000,1000,0.0030851,0,0,0,6,6
"84445",42222500,1000,0.00301186,0,0,1,6,7
"84446",42223000,1000,0.00276137,0,0,1,3,4
"84447",42223500,1000,0.00278429,0,0,0,1,1
"84448",42224000,1000,0.00293699,0,1,0,1,2
"84449",42224500,1000,0.00293782,0,1,0,3,4
"84450",42225000,1000,0.00280065,0,0,1,3,4
"84451",42225500,1000,0.00266287,0,0,1,1,2
"84452",42226000,1000,0.00271515,0,0,1,1,2
"84453",42226500,1000,0.00279544,0,0,1,3,4
"84454",42227000,1000,0.00274207,0,0,0,2,2
"84455",42227500,1000,0.00268268,0,0,0,0,0
"84456",42228000,1000,0.00256852,0,0,0,0,0
"84457",42228500,1000,0.00257984,0,0,0,0,0
"84458",42229000,1000,0.00271528,0,0,0,2,2
"84459",42229500,1000,0.00274951,0,0,0,4,4
"84460",42230000,1000,0.00269079,0,0,0,2,2
"84461",42230500,1000,0.00257844,0,0,0,0,0
"84462",42231000,1000,0.00251459,0,0,0,0,0
"84463",42231500,1000,0.00252849,0,0,0,0,0
"84464",42232000,1000,0.00265947,0,0,1,1,2
"84465",42232500,1000,0.0026975,0,0,1,1,2
"84466",42233000,1000,0.00265665,0,0,0,4,4
"84467",42233500,1000,0.00283047,0,1,0,4,5
"84468",42234000,1000,0.00274684,0,1,0,0,1
"84469",42234500,1000,0.00258517,0,0,0,1,1
"84470",42235000,1000,0.00258946,0,0,0,2,2
"84471",42235500,1000,0.00266132,0,0,0,2,2
"84472",42236000,1000,0.00267623,0,0,0,2,2
"84473",42236500,1000,0.00269065,0,0,0,2,2
"84474",42237000,1000,0.00267454,0,0,0,1,1
"84475",42237500,1000,0.00250151,0,0,0,0,0
"84476",42238000,1000,0.00248757,0,0,0,1,1
"84477",42238500,1000,0.00259327,0,0,0,2,2
"84478",42239000,1000,0.00264151,0,0,0,2,2
"84479",42239500,1000,0.00276485,0,1,0,1,2
"84480",42240000,1000,0.00278713,0,1,1,0,2
"84481",42240500,1000,0.00263234,0,0,1,0,1
"84482",42241000,1000,0.00263753,0,0,0,0,0
"84483",42241500,1000,0.00269367,0,0,0,2,2
"84484",42242000,1000,0.0025925,0,0,0,2,2
"84485",42242500,1000,0.00272906,0,1,0,1,2
"84486",42243000,1000,0.00280584,0,1,0,1,2
"84487",42243500,1000,0.00263084,0,0,0,0,0
"84488",42244000,1000,0.00266101,0,0,0,1,1
"84489",42244500,1000,0.00251841,0,0,0,1,1
"84490",42245000,1000,0.00266511,0,1,0,0,1
"84491",42245500,1000,0.00288268,0,1,1,0,2
"84492",42246000,1000,0.00271691,0,1,1,0,2
"84493",42246500,1000,0.00259962,0,1,0,0,1
"84494",42247000,1000,0.00249361,0,0,0,0,0
"84495",42247500,1000,0.00264048,0,0,0,2,2
"84496",42248000,1000,0.00272337,0,0,0,2,2
"84497",42248500,1000,0.00276139,0,0,0,1,1
"84498",42249000,1000,0.00287328,0,0,0,3,3
"84499",42249500,1000,0.00271721,0,0,0,2,2
"84500",42250000,1000,0.00260455,0,0,0,0,0
"84501",42250500,1000,0.002815,0,0,1,2,3
"84502",42251000,1000,0.002726,0,0,1,2,3
"84503",42251500,1000,0.00263831,0,0,1,0,1
"84504",42252000,1000,0.0026875,0,0,1,0,1
"84505",42252500,1000,0.00255146,0,0,0,2,2
"84506",42253000,1000,0.00258344,0,0,0,2,2
"84507",42253500,1000,0.00261597,0,0,0,0,0
"84508",42254000,1000,0.00271462,0,0,0,1,1
"84509",42254500,1000,0.00277824,0,0,0,3,3
"84510",42255000,1000,0.00270432,0,0,0,2,2
"84511",42255500,1000,0.00271863,0,0,1,1,2
"84512",42256000,1000,0.00264641,0,0,1,1,2
"84513",42256500,1000,0.00253826,0,0,0,1,1
"84514",42257000,1000,0.00260141,0,0,0,2,2
"84515",42257500,1000,0.00270556,0,1,0,1,2
"84516",42258000,1000,0.00267163,0,1,0,2,3
"84517",42258500,1000,0.00257419,0,0,0,4,4
"84518",42259000,1000,0.0025536,0,0,0,2,2
"84519",42259500,1000,0.0026091,0,0,0,2,2
"84520",42260000,1000,0.00262456,0,0,0,2,2
"84521",42260500,1000,0.00264569,0,0,0,1,1
"84522",42261000,1000,0.00259692,0,0,0,1,1
"84523",42261500,1000,0.00246646,0,0,0,0,0
"84524",42262000,1000,0.00246723,0,0,0,0,0
"84525",42262500,1000,0.00240838,0,0,0,0,0
"84526",42263000,1000,0.00235106,0,0,0,0,0
"84527",42263500,1000,0.00248478,0,0,0,0,0
"84528",42264000,1000,0.00262208,0,0,0,1,1
"84529",42264500,1000,0.00264184,0,0,0,2,2
"84530",42265000,1000,0.00262528,0,0,0,1,1
"84531",42265500,1000,0.00260621,0,0,0,2,2
"84532",42266000,1000,0.0025063,0,0,0,3,3
"84533",42266500,1000,0.00251144,0,0,0,2,2
"84534",42267000,1000,0.00268855,0,0,0,1,1
"84535",42267500,1000,0.00275115,0,0,0,2,2
"84536",42268000,1000,0.00263099,0,0,0,2,2
"84537",42268500,1000,0.00248876,0,0,0,0,0
"84538",42269000,1000,0.00262824,0,0,1,1,2
"84539",42269500,1000,0.00280201,0,0,2,2,4
"84540",42270000,1000,0.00265132,0,0,1,1,2
"84541",42270500,1000,0.00251019,0,0,0,1,1
"84542",42271000,1000,0.00248427,0,0,0,1,1
"84543",42271500,1000,0.00248217,0,0,0,0,0
"84544",42272000,1000,0.00265698,0,0,0,1,1
"84545",42272500,1000,0.0027083,0,0,0,1,1
"84546",42273000,1000,0.00245011,0,0,0,0,0
"84547",42273500,1000,0.00239272,0,0,0,0,0
"84548",42274000,1000,0.00250945,0,0,0,0,0
"84549",42274500,1000,0.00248504,0,0,0,0,0
"84550",42275000,1000,0.0024764,0,0,0,0,0
"84551",42275500,1000,0.00244675,0,0,0,0,0
"84552",42276000,1000,0.00226839,0,0,0,0,0
"84553",42276500,1000,0.00225608,0,0,0,0,0
"84554",42277000,1000,0.00262329,0,0,0,1,1
"84555",42277500,1000,0.00285975,0,0,1,2,3
"84556",42278000,1000,0.00290953,0,0,1,2,3
"84557",42278500,1000,0.00297394,0,0,1,2,3
"84558",42279000,1000,0.00282154,0,0,1,1,2
"84559",42279500,1000,0.00268375,0,0,0,0,0
"84560",42280000,1000,0.00271825,0,0,0,0,0
"84561",42280500,1000,0.0027527,0,0,1,0,1
"84562",42281000,1000,0.00262763,0,0,1,0,1
"84563",42281500,1000,0.00254832,0,0,0,0,0
"84564",42282000,1000,0.00263326,0,0,0,0,0
"84565",42282500,1000,0.00271226,0,0,0,2,2
"84566",42283000,1000,0.00273288,0,0,0,2,2
"84567",42283500,1000,0.00267663,0,0,0,1,1
"84568",42284000,1000,0.00303437,0,1,2,1,4
"84569",42284500,1000,0.00303131,0,1,2,0,3
"84570",42285000,1000,0.00267077,0,0,0,1,1
"84571",42285500,1000,0.00270599,0,0,0,2,2
"84572",42286000,1000,0.0026805,0,0,0,1,1
"84573",42286500,1000,0.00266511,0,0,0,0,0
"84574",42287000,1000,0.00269235,0,0,0,0,0
"84575",42287500,1000,0.00264112,0,0,0,0,0
"84576",42288000,1000,0.00252318,0,0,0,0,0
"84577",42288500,1000,0.00247663,0,0,0,0,0
"84578",42289000,1000,0.00251663,0,0,0,0,0
"84579",42289500,1000,0.0026808,0,0,0,2,2
"84580",42290000,1000,0.00271145,0,0,0,2,2
"84581",42290500,1000,0.00259962,0,0,0,0,0
"84582",42291000,1000,0.00269435,0,0,0,1,1
"84583",42291500,1000,0.00280105,0,0,0,1,1
"84584",42292000,1000,0.00275334,0,0,0,0,0
"84585",42292500,1000,0.00280373,0,0,1,2,3
"84586",42293000,1000,0.00280146,0,0,1,3,4
"84587",42293500,1000,0.00264754,0,0,0,1,1
"84588",42294000,1000,0.00270848,0,0,0,1,1
"84589",42294500,1000,0.00272634,0,0,0,3,3
"84590",42295000,1000,0.00270475,0,0,0,3,3
"84591",42295500,1000,0.00282473,0,0,0,2,2
"84592",42296000,1000,0.00280038,0,0,0,1,1
"84593",42296500,1000,0.00276319,0,0,0,2,2
"84594",42297000,1000,0.00270221,0,0,0,2,2
"84595",42297500,1000,0.00266858,0,0,0,0,0
"84596",42298000,1000,0.00276462,0,0,1,0,1
"84597",42298500,1000,0.00280707,0,0,2,1,3
"84598",42299000,1000,0.00293312,0,0,1,3,4
"84599",42299500,1000,0.00301808,0,0,0,2,2
"84600",42300000,1000,0.00296445,0,0,0,1,1
"84601",42300500,1000,0.00302772,0,1,0,1,2
"84602",42301000,1000,0.0030615,0,1,0,1,2
"84603",42301500,1000,0.0029276,0,0,0,2,2
"84604",42302000,1000,0.00277481,0,0,0,1,1
"84605",42302500,1000,0.00277038,0,0,0,1,1
"84606",42303000,1000,0.00293517,0,0,1,2,3
"84607",42303500,1000,0.00287662,0,0,1,2,3
"84608",42304000,1000,0.00275959,0,0,0,3,3
"84609",42304500,1000,0.00282615,0,0,0,2,2
"84610",42305000,1000,0.00288902,0,0,1,0,1
"84611",42305500,1000,0.00274918,0,0,1,0,1
"84612",42306000,1000,0.0027259,0,0,0,0,0
"84613",42306500,1000,0.00287389,0,0,1,2,3
"84614",42307000,1000,0.00289202,0,0,1,2,3
"84615",42307500,1000,0.0028095,0,0,0,0,0
"84616",42308000,1000,0.00265571,0,0,0,0,0
"84617",42308500,1000,0.00261434,0,0,0,0,0
"84618",42309000,1000,0.00268668,0,0,0,0,0
"84619",42309500,1000,0.00266105,0,0,0,0,0
"84620",42310000,1000,0.00265759,0,0,0,0,0
"84621",42310500,1000,0.00280652,0,0,0,0,0
"84622",42311000,1000,0.00274604,0,0,0,0,0
"84623",42311500,1000,0.00260939,0,0,0,0,0
"84624",42312000,1000,0.00249653,0,0,0,0,0
"84625",42312500,1000,0.00242426,0,0,0,0,0
"84626",42313000,1000,0.0025144,0,0,0,1,1
"84627",42313500,1000,0.00257106,0,0,0,1,1
"84628",42314000,1000,0.00263519,0,0,0,0,0
"84629",42314500,1000,0.00270152,0,0,0,2,2
"84630",42315000,1000,0.00271323,0,0,0,4,4
"84631",42315500,1000,0.00282695,0,0,1,2,3
"84632",42316000,1000,0.00293423,0,0,2,1,3
"84633",42316500,1000,0.00279599,0,0,1,1,2
"84634",42317000,1000,0.00281203,0,1,0,0,1
"84635",42317500,1000,0.00279708,0,1,0,0,1
"84636",42318000,1000,0.00272898,0,0,0,2,2
"84637",42318500,1000,0.0027366,0,0,0,3,3
"84638",42319000,1000,0.00280487,0,0,1,2,3
"84639",42319500,1000,0.00281761,0,0,1,1,2
"84640",42320000,1000,0.00265357,0,0,0,0,0
"84641",42320500,1000,0.00278226,0,0,1,0,1
"84642",42321000,1000,0.00275854,0,0,1,0,1
"84643",42321500,1000,0.00254729,0,0,0,0,0
"84644",42322000,1000,0.00260797,0,0,0,1,1
"84645",42322500,1000,0.00266757,0,0,0,1,1
"84646",42323000,1000,0.0027262,0,0,0,1,1
"84647",42323500,1000,0.00283492,0,0,0,1,1
"84648",42324000,1000,0.00264687,0,0,0,0,0
"84649",42324500,1000,0.00257009,0,0,0,0,0
"84650",42325000,1000,0.00283004,0,0,0,1,1
"84651",42325500,1000,0.00290291,0,0,1,2,3
"84652",42326000,1000,0.00295428,0,0,1,3,4
"84653",42326500,1000,0.00288863,0,0,0,3,3
"84654",42327000,1000,0.00260769,0,0,0,1,1
"84655",42327500,1000,0.00259352,0,0,0,2,2
"84656",42328000,1000,0.00258343,0,0,0,2,2
"84657",42328500,1000,0.00255285,0,0,0,2,2
"84658",42329000,1000,0.00264804,0,0,0,2,2
"84659",42329500,1000,0.0026473,0,0,0,0,0
"84660",42330000,1000,0.00258526,0,0,0,0,0
"84661",42330500,1000,0.00266724,0,0,1,1,2
"84662",42331000,1000,0.00273557,0,0,1,1,2
"84663",42331500,1000,0.00261957,0,0,0,0,0
"84664",42332000,1000,0.00277345,0,0,1,1,2
"84665",42332500,1000,0.00277838,0,0,1,1,2
"84666",42333000,1000,0.00265425,0,0,0,0,0
"84667",42333500,1000,0.00272778,0,0,0,0,0
"84668",42334000,1000,0.00268598,0,0,0,0,0
"84669",42334500,1000,0.00275266,0,0,0,2,2
"84670",42335000,1000,0.00280105,0,0,0,3,3
"84671",42335500,1000,0.00264028,0,0,0,1,1
"84672",42336000,1000,0.00253631,0,0,0,0,0
"84673",42336500,1000,0.00247686,0,0,0,0,0
"84674",42337000,1000,0.00255056,0,0,0,2,2
"84675",42337500,1000,0.00319256,0,0,4,3,7
"84676",42338000,1000,0.0040577,0,0,8,1,9
"84677",42338500,1000,0.00368797,0,0,5,0,5
"84678",42339000,1000,0.00280321,0,0,1,0,1
"84679",42339500,1000,0.00269275,0,0,0,1,1
"84680",42340000,1000,0.00272925,0,0,0,3,3
"84681",42340500,1000,0.00272019,0,0,0,2,2
"84682",42341000,1000,0.00270984,0,0,0,0,0
"84683",42341500,1000,0.00260059,0,0,0,0,0
"84684",42342000,1000,0.00263311,0,0,0,2,2
"84685",42342500,1000,0.00280942,0,0,0,3,3
"84686",42343000,1000,0.00260544,0,0,0,1,1
"84687",42343500,1000,0.00252157,0,0,0,1,1
"84688",42344000,1000,0.00272348,0,0,1,1,2
"84689",42344500,1000,0.00273613,0,0,1,2,3
"84690",42345000,1000,0.00272926,0,0,1,3,4
"84691",42345500,1000,0.00266064,0,0,1,1,2
"84692",42346000,1000,0.00261418,0,0,0,0,0
"84693",42346500,1000,0.00278021,0,0,1,1,2
"84694",42347000,1000,0.0027897,0,0,1,2,3
"84695",42347500,1000,0.00269375,0,0,0,1,1
"84696",42348000,1000,0.00275999,0,0,0,0,0
"84697",42348500,1000,0.00270717,0,0,0,0,0
"84698",42349000,1000,0.00258147,0,0,0,1,1
"84699",42349500,1000,0.00261589,0,0,0,1,1
"84700",42350000,1000,0.00265836,0,0,0,1,1
"84701",42350500,1000,0.0027116,0,0,1,2,3
"84702",42351000,1000,0.00268747,0,0,1,2,3
"84703",42351500,1000,0.00258086,0,0,0,1,1
"84704",42352000,1000,0.00276252,0,0,1,2,3
"84705",42352500,1000,0.00280853,0,0,1,3,4
"84706",42353000,1000,0.00265486,0,0,0,3,3
"84707",42353500,1000,0.00262456,0,0,0,2,2
"84708",42354000,1000,0.00260063,0,0,0,2,2
"84709",42354500,1000,0.00266996,0,0,0,4,4
"84710",42355000,1000,0.00268033,0,0,0,2,2
"84711",42355500,1000,0.00258283,0,0,0,0,0
"84712",42356000,1000,0.00249861,0,0,0,0,0
"84713",42356500,1000,0.00257911,0,0,0,1,1
"84714",42357000,1000,0.00271706,0,0,1,2,3
"84715",42357500,1000,0.00262075,0,0,1,2,3
"84716",42358000,1000,0.00252652,0,0,0,2,2
"84717",42358500,1000,0.00268219,0,0,1,1,2
"84718",42359000,1000,0.00278417,0,0,1,1,2
"84719",42359500,1000,0.00269589,0,0,0,2,2
"84720",42360000,1000,0.00267919,0,0,0,2,2
"84721",42360500,1000,0.00274504,0,0,0,2,2
"84722",42361000,1000,0.00274871,0,0,0,1,1
"84723",42361500,1000,0.00265809,0,0,0,0,0
"84724",42362000,1000,0.00260483,0,0,0,0,0
"84725",42362500,1000,0.00265383,0,0,0,1,1
"84726",42363000,1000,0.00269246,0,0,0,1,1
"84727",42363500,1000,0.00271583,0,0,0,1,1
"84728",42364000,1000,0.00277868,0,0,0,1,1
"84729",42364500,1000,0.00290191,0,0,1,2,3
"84730",42365000,1000,0.00282,0,0,1,2,3
"84731",42365500,1000,0.00267744,0,0,0,2,2
"84732",42366000,1000,0.00272594,0,0,0,3,3
"84733",42366500,1000,0.00273458,0,0,1,2,3
"84734",42367000,1000,0.00262848,0,0,1,1,2
"84735",42367500,1000,0.00256286,0,0,0,0,0
"84736",42368000,1000,0.00257187,0,0,0,0,0
"84737",42368500,1000,0.00262298,0,0,0,0,0
"84738",42369000,1000,0.00269428,0,0,0,1,1
"84739",42369500,1000,0.00264882,0,0,0,1,1
"84740",42370000,1000,0.00269101,0,1,0,0,1
"84741",42370500,1000,0.00281734,0,1,1,1,3
"84742",42371000,1000,0.00271098,0,0,1,1,2
"84743",42371500,1000,0.00267678,0,0,0,1,1
"84744",42372000,1000,0.002726,0,0,0,2,2
"84745",42372500,1000,0.00259541,0,0,0,1,1
"84746",42373000,1000,0.00269124,0,0,1,0,1
"84747",42373500,1000,0.0027426,0,0,2,1,3
"84748",42374000,1000,0.0027143,0,0,2,2,4
"84749",42374500,1000,0.00270881,0,0,1,1,2
"84750",42375000,1000,0.00257704,0,0,0,0,0
"84751",42375500,1000,0.00264029,0,0,0,1,1
"84752",42376000,1000,0.00263862,0,0,0,1,1
"84753",42376500,1000,0.00263318,0,0,0,2,2
"84754",42377000,1000,0.00257273,0,0,0,2,2
"84755",42377500,1000,0.00249178,0,0,0,0,0
"84756",42378000,1000,0.00270941,0,0,0,2,2
"84757",42378500,1000,0.00272206,0,0,0,2,2
"84758",42379000,1000,0.0026051,0,0,0,0,0
"84759",42379500,1000,0.00256789,0,0,0,0,0
"84760",42380000,1000,0.00252354,0,0,0,1,1
"84761",42380500,1000,0.00268735,0,0,0,3,3
"84762",42381000,1000,0.00280887,0,0,1,3,4
"84763",42381500,1000,0.00266891,0,0,1,2,3
"84764",42382000,1000,0.00255638,0,0,0,1,1
"84765",42382500,1000,0.00269388,0,0,1,1,2
"84766",42383000,1000,0.00284735,0,0,1,4,5
"84767",42383500,1000,0.00279292,0,0,0,3,3
"84768",42384000,1000,0.00267517,0,0,0,1,1
"84769",42384500,1000,0.00262116,0,0,0,2,2
"84770",42385000,1000,0.0027358,0,0,0,3,3
"84771",42385500,1000,0.0027219,0,0,0,2,2
"84772",42386000,1000,0.00262426,0,0,0,2,2
"84773",42386500,1000,0.00260948,0,0,0,2,2
"84774",42387000,1000,0.00258899,0,0,0,0,0
"84775",42387500,1000,0.00255932,0,0,0,0,0
"84776",42388000,1000,0.0024466,0,0,0,0,0
"84777",42388500,1000,0.00248575,0,0,0,0,0
"84778",42389000,1000,0.00256966,0,0,0,0,0
"84779",42389500,1000,0.00256033,0,0,0,1,1
"84780",42390000,1000,0.00264556,0,0,0,2,2
"84781",42390500,1000,0.00283462,0,0,1,2,3
"84782",42391000,1000,0.00270019,0,0,1,1,2
"84783",42391500,1000,0.00264609,0,0,0,2,2
"84784",42392000,1000,0.00289962,0,0,1,5,6
"84785",42392500,1000,0.00285877,0,0,1,4,5
"84786",42393000,1000,0.00272333,0,0,0,2,2
"84787",42393500,1000,0.00263865,0,0,0,1,1
"84788",42394000,1000,0.00258142,0,0,0,0,0
"84789",42394500,1000,0.00267546,0,0,0,1,1
"84790",42395000,1000,0.00274126,0,0,0,3,3
"84791",42395500,1000,0.00269914,0,0,0,2,2
"84792",42396000,1000,0.0028173,0,0,1,1,2
"84793",42396500,1000,0.00286129,0,0,2,1,3
"84794",42397000,1000,0.00278092,0,0,1,0,1
"84795",42397500,1000,0.00269886,0,0,0,0,0
"84796",42398000,1000,0.00270899,0,0,0,1,1
"84797",42398500,1000,0.0027343,0,0,0,2,2
"84798",42399000,1000,0.00266823,0,0,0,1,1
"84799",42399500,1000,0.00273905,0,0,0,1,1
"84800",42400000,1000,0.00275295,0,0,0,1,1
"84801",42400500,1000,0.00268784,0,0,0,1,1
"84802",42401000,1000,0.00285709,0,0,0,5,5
"84803",42401500,1000,0.00277591,0,0,0,4,4
"84804",42402000,1000,0.00253089,0,0,0,0,0
"84805",42402500,1000,0.00254256,0,0,0,0,0
"84806",42403000,1000,0.00270383,0,0,1,0,1
"84807",42403500,1000,0.00272115,0,0,1,0,1
"84808",42404000,1000,0.00265061,0,0,0,0,0
"84809",42404500,1000,0.00277117,0,0,0,0,0
"84810",42405000,1000,0.00280131,0,0,0,0,0
"84811",42405500,1000,0.00270409,0,0,0,1,1
"84812",42406000,1000,0.00259576,0,0,0,1,1
"84813",42406500,1000,0.00270035,0,0,1,0,1
"84814",42407000,1000,0.00275443,0,0,1,0,1
"84815",42407500,1000,0.00270957,0,0,0,1,1
"84816",42408000,1000,0.00263527,0,0,0,1,1
"84817",42408500,1000,0.00261573,0,0,0,0,0
"84818",42409000,1000,0.00279294,0,0,0,3,3
"84819",42409500,1000,0.00280041,0,0,0,3,3
"84820",42410000,1000,0.00273429,0,0,0,1,1
"84821",42410500,1000,0.00287135,0,0,2,2,4
"84822",42411000,1000,0.00281258,0,0,2,1,3
"84823",42411500,1000,0.00262298,0,0,0,0,0
"84824",42412000,1000,0.00280553,0,1,0,1,2
"84825",42412500,1000,0.00282568,0,1,0,2,3
"84826",42413000,1000,0.00270342,0,0,0,4,4
"84827",42413500,1000,0.00267041,0,0,0,3,3
"84828",42414000,1000,0.00265441,0,0,0,2,2
"84829",42414500,1000,0.00270981,0,0,0,2,2
"84830",42415000,1000,0.00280891,0,0,0,0,0
"84831",42415500,1000,0.00274027,0,0,0,0,0
"84832",42416000,1000,0.00268348,0,0,1,1,2
"84833",42416500,1000,0.00261101,0,0,1,1,2
"84834",42417000,1000,0.00261036,0,0,0,2,2
"84835",42417500,1000,0.0027059,0,0,0,3,3
"84836",42418000,1000,0.00260646,0,0,0,1,1
"84837",42418500,1000,0.00254659,0,0,0,0,0
"84838",42419000,1000,0.00258317,0,0,0,0,0
"84839",42419500,1000,0.00279627,0,0,1,0,1
"84840",42420000,1000,0.00274719,0,0,1,0,1
"84841",42420500,1000,0.00264008,0,0,0,0,0
"84842",42421000,1000,0.00267442,0,0,0,0,0
"84843",42421500,1000,0.00261734,0,0,0,0,0
"84844",42422000,1000,0.00247992,0,0,0,0,0
"84845",42422500,1000,0.00276621,0,0,2,0,2
"84846",42423000,1000,0.00280682,0,0,2,0,2
"84847",42423500,1000,0.00253824,0,0,0,0,0
"84848",42424000,1000,0.00274,0,0,0,4,4
"84849",42424500,1000,0.00278221,0,0,0,4,4
"84850",42425000,1000,0.00265202,0,0,0,0,0
"84851",42425500,1000,0.00272321,0,0,0,0,0
"84852",42426000,1000,0.00278602,0,0,0,1,1
"84853",42426500,1000,0.00264388,0,0,0,1,1
"84854",42427000,1000,0.00270007,0,0,1,1,2
"84855",42427500,1000,0.0027931,0,0,1,3,4
"84856",42428000,1000,0.00278279,0,0,0,3,3
"84857",42428500,1000,0.00269713,0,0,0,1,1
"84858",42429000,1000,0.00259605,0,0,0,1,1
"84859",42429500,1000,0.00269549,0,0,0,3,3
"84860",42430000,1000,0.00263368,0,0,0,2,2
"84861",42430500,1000,0.0025587,0,0,0,1,1
"84862",42431000,1000,0.0026058,0,0,0,2,2
"84863",42431500,1000,0.0025192,0,0,0,1,1
"84864",42432000,1000,0.00265112,0,1,0,0,1
"84865",42432500,1000,0.0028682,0,1,0,2,3
"84866",42433000,1000,0.00267316,0,0,0,2,2
"84867",42433500,1000,0.00268725,0,0,1,1,2
"84868",42434000,1000,0.00290034,0,0,1,2,3
"84869",42434500,1000,0.00274364,0,0,0,2,2
"84870",42435000,1000,0.0025047,0,0,0,1,1
"84871",42435500,1000,0.00243641,0,0,0,0,0
"84872",42436000,1000,0.00254917,0,0,0,1,1
"84873",42436500,1000,0.00269032,0,0,0,3,3
"84874",42437000,1000,0.00278857,0,0,1,3,4
"84875",42437500,1000,0.00270971,0,0,1,2,3
"84876",42438000,1000,0.00257733,0,0,0,1,1
"84877",42438500,1000,0.00254519,0,0,0,0,0
"84878",42439000,1000,0.00251444,0,0,0,0,0
"84879",42439500,1000,0.00267455,0,0,0,2,2
"84880",42440000,1000,0.0026405,0,0,0,2,2
"84881",42440500,1000,0.00255557,0,0,0,2,2
"84882",42441000,1000,0.00261916,0,0,0,2,2
"84883",42441500,1000,0.00262966,0,0,0,0,0
"84884",42442000,1000,0.00276264,0,0,0,2,2
"84885",42442500,1000,0.00260735,0,0,0,2,2
"84886",42443000,1000,0.00257847,0,1,0,0,1
"84887",42443500,1000,0.00275507,0,1,0,1,2
"84888",42444000,1000,0.0029403,0,1,1,2,4
"84889",42444500,1000,0.00294665,0,1,1,2,4
"84890",42445000,1000,0.00259792,0,0,0,2,2
"84891",42445500,1000,0.00268996,0,0,1,2,3
"84892",42446000,1000,0.00272037,0,0,1,1,2
"84893",42446500,1000,0.00248772,0,0,0,1,1
"84894",42447000,1000,0.00262199,0,0,1,2,3
"84895",42447500,1000,0.00282419,0,0,1,3,4
"84896",42448000,1000,0.00285687,0,0,0,4,4
"84897",42448500,1000,0.00272381,0,0,0,2,2
"84898",42449000,1000,0.00257854,0,0,0,0,0
"84899",42449500,1000,0.00264199,0,0,0,0,0
"84900",42450000,1000,0.00266295,0,0,0,1,1
"84901",42450500,1000,0.00261379,0,0,0,3,3
"84902",42451000,1000,0.00265568,0,0,0,2,2
"84903",42451500,1000,0.00276965,0,0,0,1,1
"84904",42452000,1000,0.00267635,0,0,0,1,1
"84905",42452500,1000,0.00267317,0,0,0,2,2
"84906",42453000,1000,0.00270478,0,0,0,2,2
"84907",42453500,1000,0.00281214,0,1,0,2,3
"84908",42454000,1000,0.00281848,0,1,0,2,3
"84909",42454500,1000,0.00254362,0,0,0,0,0
"84910",42455000,1000,0.00264768,0,0,1,1,2
"84911",42455500,1000,0.00265531,0,0,1,1,2
"84912",42456000,1000,0.00261144,0,0,0,0,0
"84913",42456500,1000,0.0026234,0,0,0,0,0
"84914",42457000,1000,0.00252431,0,0,0,0,0
"84915",42457500,1000,0.0024462,0,0,0,0,0
"84916",42458000,1000,0.00241004,0,0,0,0,0
"84917",42458500,1000,0.0025358,0,0,0,1,1
"84918",42459000,1000,0.00261733,0,0,0,1,1
"84919",42459500,1000,0.00266233,0,0,0,0,0
"84920",42460000,1000,0.00265768,0,0,0,0,0
"84921",42460500,1000,0.00277709,0,1,0,0,1
"84922",42461000,1000,0.00269891,0,1,0,0,1
"84923",42461500,1000,0.00269007,0,0,0,2,2
"84924",42462000,1000,0.00272374,0,0,0,2,2
"84925",42462500,1000,0.00264764,0,0,1,1,2
"84926",42463000,1000,0.00279992,0,0,2,2,4
"84927",42463500,1000,0.00269401,0,0,1,1,2
"84928",42464000,1000,0.00262766,0,0,0,1,1
"84929",42464500,1000,0.00269186,0,0,1,2,3
"84930",42465000,1000,0.00272714,0,0,1,2,3
"84931",42465500,1000,0.00282632,0,0,0,5,5
"84932",42466000,1000,0.00276484,0,0,0,4,4
"84933",42466500,1000,0.00275379,0,0,1,2,3
"84934",42467000,1000,0.00272049,0,0,1,2,3
"84935",42467500,1000,0.00257813,0,0,0,1,1
"84936",42468000,1000,0.002563,0,0,0,1,1
"84937",42468500,1000,0.0026709,0,0,1,1,2
"84938",42469000,1000,0.00269639,0,0,1,1,2
"84939",42469500,1000,0.00282294,0,0,1,4,5
"84940",42470000,1000,0.00291054,0,0,2,4,6
"84941",42470500,1000,0.00269405,0,0,2,0,2
"84942",42471000,1000,0.00270536,0,0,1,2,3
"84943",42471500,1000,0.00282113,0,0,0,4,4
"84944",42472000,1000,0.00272217,0,0,0,2,2
"84945",42472500,1000,0.00269283,0,0,0,2,2
"84946",42473000,1000,0.00272542,0,0,0,3,3
"84947",42473500,1000,0.00253742,0,0,0,1,1
"84948",42474000,1000,0.0026121,0,0,0,1,1
"84949",42474500,1000,0.00268581,0,0,0,1,1
"84950",42475000,1000,0.00255431,0,0,0,0,0
"84951",42475500,1000,0.00252117,0,0,0,0,0
"84952",42476000,1000,0.00256473,0,0,0,0,0
"84953",42476500,1000,0.00254888,0,0,0,0,0
"84954",42477000,1000,0.00258339,0,0,0,0,0
"84955",42477500,1000,0.00265249,0,0,0,0,0
"84956",42478000,1000,0.00263647,0,0,0,0,0
"84957",42478500,1000,0.00265828,0,0,0,0,0
"84958",42479000,1000,0.0026787,0,0,0,0,0
"84959",42479500,1000,0.00263449,0,0,0,0,0
"84960",42480000,1000,0.00262321,0,0,0,0,0
"84961",42480500,1000,0.00260531,0,0,0,0,0
"84962",42481000,1000,0.00269834,0,0,0,2,2
"84963",42481500,1000,0.0027285,0,0,0,2,2
"84964",42482000,1000,0.00270922,0,0,0,1,1
"84965",42482500,1000,0.002921,0,0,2,2,4
"84966",42483000,1000,0.00285638,0,0,2,1,3
"84967",42483500,1000,0.00279067,0,0,0,3,3
"84968",42484000,1000,0.00269908,0,0,0,3,3
"84969",42484500,1000,0.00255,0,0,0,1,1
"84970",42485000,1000,0.00287294,0,1,0,4,5
"84971",42485500,1000,0.00294141,0,1,1,3,5
"84972",42486000,1000,0.00263913,0,0,1,1,2
"84973",42486500,1000,0.00260118,0,0,0,2,2
"84974",42487000,1000,0.00264732,0,0,0,1,1
"84975",42487500,1000,0.00258328,0,0,1,0,1
"84976",42488000,1000,0.00267347,0,0,1,1,2
"84977",42488500,1000,0.00283498,0,0,0,3,3
"84978",42489000,1000,0.0029634,0,0,1,3,4
"84979",42489500,1000,0.00299475,0,1,1,1,3
"84980",42490000,1000,0.0028056,0,1,0,0,1
"84981",42490500,1000,0.00267427,0,0,0,0,0
"84982",42491000,1000,0.00259768,0,0,0,0,0
"84983",42491500,1000,0.00280209,0,0,1,1,2
"84984",42492000,1000,0.00311271,0,0,2,4,6
"84985",42492500,1000,0.00304631,0,0,2,4,6
"84986",42493000,1000,0.00281176,0,0,1,1,2
"84987",42493500,1000,0.00264508,0,0,0,0,0
"84988",42494000,1000,0.00263546,0,0,0,1,1
"84989",42494500,1000,0.00263874,0,0,0,1,1
"84990",42495000,1000,0.00261494,0,0,0,0,0
"84991",42495500,1000,0.0026337,0,0,1,0,1
"84992",42496000,1000,0.00253114,0,0,1,0,1
"84993",42496500,1000,0.00258811,0,0,1,1,2
"84994",42497000,1000,0.0027553,0,0,1,3,4
"84995",42497500,1000,0.00273041,0,0,1,2,3
"84996",42498000,1000,0.0027077,0,0,1,2,3
"84997",42498500,1000,0.00259853,0,0,0,2,2
"84998",42499000,1000,0.00261003,0,0,1,0,1
"84999",42499500,1000,0.00280634,0,0,1,2,3
"85000",42500000,1000,0.00279472,0,0,0,4,4
"85001",42500500,1000,0.00272672,0,0,1,2,3
"85002",42501000,1000,0.00258816,0,0,1,0,1
"85003",42501500,1000,0.00259264,0,0,0,2,2
"85004",42502000,1000,0.0027423,0,0,0,2,2
"85005",42502500,1000,0.00266816,0,0,0,0,0
"85006",42503000,1000,0.00257145,0,0,0,0,0
"85007",42503500,1000,0.00252571,0,0,0,0,0
"85008",42504000,1000,0.00256531,0,0,0,0,0
"85009",42504500,1000,0.00283163,0,0,1,1,2
"85010",42505000,1000,0.00298651,0,0,1,3,4
"85011",42505500,1000,0.00288852,0,0,1,3,4
"85012",42506000,1000,0.00287293,0,0,2,2,4
"85013",42506500,1000,0.00282247,0,0,1,2,3
"85014",42507000,1000,0.00274284,0,0,0,1,1
"85015",42507500,1000,0.00286532,0,0,1,2,3
"85016",42508000,1000,0.00280988,0,0,1,2,3
"85017",42508500,1000,0.00271859,0,0,0,1,1
"85018",42509000,1000,0.00273747,0,0,0,1,1
"85019",42509500,1000,0.00259374,0,0,0,0,0
"85020",42510000,1000,0.00279077,0,0,0,0,0
"85021",42510500,1000,0.00299101,0,0,0,0,0
"85022",42511000,1000,0.00295664,0,0,0,2,2
"85023",42511500,1000,0.00293565,0,1,0,3,4
"85024",42512000,1000,0.00281382,0,1,0,1,2
"85025",42512500,1000,0.00273434,0,0,1,0,1
"85026",42513000,1000,0.00267682,0,0,1,0,1
"85027",42513500,1000,0.00265876,0,0,0,0,0
"85028",42514000,1000,0.00278344,0,0,0,0,0
"85029",42514500,1000,0.00273196,0,0,0,0,0
"85030",42515000,1000,0.00274927,0,1,0,0,1
"85031",42515500,1000,0.00281477,0,1,0,0,1
"85032",42516000,1000,0.00275732,0,0,0,0,0
"85033",42516500,1000,0.00280011,0,0,0,2,2
"85034",42517000,1000,0.00285467,0,0,1,3,4
"85035",42517500,1000,0.00281433,0,0,1,1,2
"85036",42518000,1000,0.00266588,0,0,0,0,0
"85037",42518500,1000,0.00269306,0,0,0,1,1
"85038",42519000,1000,0.0027573,0,0,1,1,2
"85039",42519500,1000,0.00268383,0,0,1,0,1
"85040",42520000,1000,0.00268595,0,0,1,0,1
"85041",42520500,1000,0.00261593,0,0,1,0,1
"85042",42521000,1000,0.00256421,0,0,0,0,0
"85043",42521500,1000,0.00260413,0,0,0,0,0
"85044",42522000,1000,0.00274984,0,0,2,0,2
"85045",42522500,1000,0.0027766,0,0,2,0,2
"85046",42523000,1000,0.00265289,0,0,0,1,1
"85047",42523500,1000,0.00267052,0,0,0,3,3
"85048",42524000,1000,0.00261223,0,0,0,3,3
"85049",42524500,1000,0.00276502,0,0,1,3,4
"85050",42525000,1000,0.0027554,0,0,1,2,3
"85051",42525500,1000,0.00260269,0,0,0,0,0
"85052",42526000,1000,0.00278962,0,0,1,1,2
"85053",42526500,1000,0.00289777,0,0,1,5,6
"85054",42527000,1000,0.00283714,0,0,0,4,4
"85055",42527500,1000,0.00277957,0,0,0,2,2
"85056",42528000,1000,0.00264902,0,0,0,3,3
"85057",42528500,1000,0.00257114,0,0,0,1,1
"85058",42529000,1000,0.00277254,0,0,0,2,2
"85059",42529500,1000,0.00290306,0,0,0,4,4
"85060",42530000,1000,0.00267028,0,0,0,2,2
"85061",42530500,1000,0.00249529,0,0,0,0,0
"85062",42531000,1000,0.00265035,0,0,0,2,2
"85063",42531500,1000,0.0028705,0,0,0,5,5
"85064",42532000,1000,0.0027288,0,0,1,3,4
"85065",42532500,1000,0.00261569,0,0,2,1,3
"85066",42533000,1000,0.0029012,0,1,2,1,4
"85067",42533500,1000,0.00285145,0,1,1,1,3
"85068",42534000,1000,0.00260932,0,0,0,1,1
"85069",42534500,1000,0.00264804,0,0,0,1,1
"85070",42535000,1000,0.0028307,0,0,1,3,4
"85071",42535500,1000,0.00278619,0,0,1,3,4
"85072",42536000,1000,0.00249744,0,0,0,1,1
"85073",42536500,1000,0.00245275,0,0,0,0,0
"85074",42537000,1000,0.00260726,0,0,0,1,1
"85075",42537500,1000,0.0027094,0,0,0,2,2
"85076",42538000,1000,0.0026792,0,0,0,1,1
"85077",42538500,1000,0.00277274,0,0,1,1,2
"85078",42539000,1000,0.00289739,0,0,2,1,3
"85079",42539500,1000,0.00275193,0,0,1,1,2
"85080",42540000,1000,0.00278228,0,0,1,2,3
"85081",42540500,1000,0.00307006,0,1,1,1,3
"85082",42541000,1000,0.00293327,0,1,0,0,1
"85083",42541500,1000,0.00270719,0,0,0,0,0
"85084",42542000,1000,0.00290108,0,0,0,4,4
"85085",42542500,1000,0.00291501,0,0,0,6,6
"85086",42543000,1000,0.00268411,0,0,0,2,2
"85087",42543500,1000,0.00275828,0,0,0,1,1
"85088",42544000,1000,0.00295452,0,0,0,3,3
"85089",42544500,1000,0.00278715,0,0,0,3,3
"85090",42545000,1000,0.00265953,0,0,1,1,2
"85091",42545500,1000,0.00275451,0,0,1,3,4
"85092",42546000,1000,0.002967,0,1,0,3,4
"85093",42546500,1000,0.00293445,0,1,0,0,1
"85094",42547000,1000,0.00269859,0,0,0,0,0
"85095",42547500,1000,0.0029286,0,1,2,0,3
"85096",42548000,1000,0.00296459,0,1,2,0,3
"85097",42548500,1000,0.00269277,0,0,0,1,1
"85098",42549000,1000,0.00266195,0,0,0,2,2
"85099",42549500,1000,0.00265638,0,0,0,1,1
"85100",42550000,1000,0.00280243,0,0,1,0,1
"85101",42550500,1000,0.00290212,0,0,1,1,2
"85102",42551000,1000,0.00278576,0,0,0,1,1
"85103",42551500,1000,0.0026647,0,0,0,1,1
"85104",42552000,1000,0.00291518,0,1,0,1,2
"85105",42552500,1000,0.00295678,0,1,0,0,1
"85106",42553000,1000,0.00260333,0,0,0,0,0
"85107",42553500,1000,0.00260263,0,0,1,0,1
"85108",42554000,1000,0.00279348,0,0,3,0,3
"85109",42554500,1000,0.00273873,0,0,2,0,2
"85110",42555000,1000,0.00259729,0,0,0,0,0
"85111",42555500,1000,0.00258236,0,0,0,0,0
"85112",42556000,1000,0.00263053,0,0,0,0,0
"85113",42556500,1000,0.00281914,0,0,1,1,2
"85114",42557000,1000,0.00297641,0,0,1,4,5
"85115",42557500,1000,0.00286819,0,0,0,5,5
"85116",42558000,1000,0.00260766,0,0,0,3,3
"85117",42558500,1000,0.00268623,0,0,0,3,3
"85118",42559000,1000,0.00294504,0,0,1,2,3
"85119",42559500,1000,0.00284124,0,0,1,1,2
"85120",42560000,1000,0.00267657,0,0,0,2,2
"85121",42560500,1000,0.00263733,0,0,0,1,1
"85122",42561000,1000,0.00268848,0,0,1,1,2
"85123",42561500,1000,0.00268151,0,0,1,1,2
"85124",42562000,1000,0.00260478,0,0,0,1,1
"85125",42562500,1000,0.00270118,0,0,0,2,2
"85126",42563000,1000,0.00275108,0,0,0,1,1
"85127",42563500,1000,0.00278585,0,0,0,0,0
"85128",42564000,1000,0.00275816,0,0,0,0,0
"85129",42564500,1000,0.00272649,0,0,0,2,2
"85130",42565000,1000,0.00269298,0,0,0,2,2
"85131",42565500,1000,0.00273658,0,0,0,0,0
"85132",42566000,1000,0.00274328,0,0,0,0,0
"85133",42566500,1000,0.00253052,0,0,0,0,0
"85134",42567000,1000,0.0024023,0,0,0,0,0
"85135",42567500,1000,0.00257425,0,0,0,0,0
"85136",42568000,1000,0.00271218,0,0,0,2,2
"85137",42568500,1000,0.00279813,0,0,1,2,3
"85138",42569000,1000,0.00289817,0,0,2,0,2
"85139",42569500,1000,0.00286112,0,0,1,0,1
"85140",42570000,1000,0.00286307,0,0,1,0,1
"85141",42570500,1000,0.0028878,0,0,2,1,3
"85142",42571000,1000,0.00272549,0,0,1,1,2
"85143",42571500,1000,0.00257426,0,0,0,1,1
"85144",42572000,1000,0.00255829,0,0,0,1,1
"85145",42572500,1000,0.0025603,0,0,0,0,0
"85146",42573000,1000,0.00279218,0,0,0,0,0
"85147",42573500,1000,0.00278432,0,0,0,0,0
"85148",42574000,1000,0.00286569,0,0,2,1,3
"85149",42574500,1000,0.00284034,0,0,2,2,4
"85150",42575000,1000,0.00264815,0,0,0,1,1
"85151",42575500,1000,0.00276603,0,0,0,2,2
"85152",42576000,1000,0.00277816,0,0,0,2,2
"85153",42576500,1000,0.00273633,0,0,0,0,0
"85154",42577000,1000,0.00275317,0,0,0,0,0
"85155",42577500,1000,0.0026557,0,0,0,0,0
"85156",42578000,1000,0.00253824,0,0,0,0,0
"85157",42578500,1000,0.00257941,0,0,0,0,0
"85158",42579000,1000,0.00273032,0,0,1,1,2
"85159",42579500,1000,0.0027828,0,0,1,1,2
"85160",42580000,1000,0.00271779,0,0,0,0,0
"85161",42580500,1000,0.00273521,0,0,0,1,1
"85162",42581000,1000,0.00270022,0,0,0,3,3
"85163",42581500,1000,0.00270989,0,0,0,2,2
"85164",42582000,1000,0.00278235,0,0,0,0,0
"85165",42582500,1000,0.0027752,0,0,1,0,1
"85166",42583000,1000,0.00264979,0,0,1,0,1
"85167",42583500,1000,0.00259743,0,0,0,0,0
"85168",42584000,1000,0.00280473,0,0,1,3,4
"85169",42584500,1000,0.00278301,0,0,1,3,4
"85170",42585000,1000,0.00271631,0,0,0,0,0
"85171",42585500,1000,0.00282713,0,0,1,1,2
"85172",42586000,1000,0.00274293,0,0,1,2,3
"85173",42586500,1000,0.00266268,0,0,0,2,2
"85174",42587000,1000,0.00284288,0,1,1,1,3
"85175",42587500,1000,0.00285304,0,1,1,0,2
"85176",42588000,1000,0.00271838,0,0,0,1,1
"85177",42588500,1000,0.00281495,0,0,0,3,3
"85178",42589000,1000,0.00274203,0,0,0,3,3
"85179",42589500,1000,0.00283422,0,0,1,3,4
"85180",42590000,1000,0.00283103,0,0,1,2,3
"85181",42590500,1000,0.00270881,0,0,1,0,1
"85182",42591000,1000,0.00274225,0,0,1,0,1
"85183",42591500,1000,0.00269484,0,0,1,0,1
"85184",42592000,1000,0.00266393,0,0,1,0,1
"85185",42592500,1000,0.0026791,0,0,0,1,1
"85186",42593000,1000,0.00271838,0,0,1,2,3
"85187",42593500,1000,0.00266955,0,0,1,1,2
"85188",42594000,1000,0.00264323,0,0,0,0,0
"85189",42594500,1000,0.00272097,0,0,1,1,2
"85190",42595000,1000,0.0029826,0,1,2,1,4
"85191",42595500,1000,0.0028624,0,1,1,0,2
"85192",42596000,1000,0.0025178,0,0,0,1,1
"85193",42596500,1000,0.00262634,0,0,1,1,2
"85194",42597000,1000,0.00277424,0,0,2,1,3
"85195",42597500,1000,0.00264069,0,0,1,1,2
"85196",42598000,1000,0.00263677,0,0,1,0,1
"85197",42598500,1000,0.00261396,0,0,1,0,1
"85198",42599000,1000,0.00253915,0,0,0,0,0
"85199",42599500,1000,0.0026971,0,0,1,0,1
"85200",42600000,1000,0.00268647,0,0,1,0,1
"85201",42600500,1000,0.00253008,0,0,0,1,1
"85202",42601000,1000,0.00262989,0,0,0,3,3
"85203",42601500,1000,0.0026653,0,0,0,2,2
"85204",42602000,1000,0.00258547,0,0,0,1,1
"85205",42602500,1000,0.00268396,0,0,0,3,3
"85206",42603000,1000,0.00263927,0,0,0,2,2
"85207",42603500,1000,0.00258547,0,0,0,2,2
"85208",42604000,1000,0.00259118,0,0,0,3,3
"85209",42604500,1000,0.00260676,0,0,0,1,1
"85210",42605000,1000,0.00253534,0,0,0,0,0
"85211",42605500,1000,0.0025821,0,0,0,2,2
"85212",42606000,1000,0.0028749,0,0,0,6,6
"85213",42606500,1000,0.00289047,0,0,0,6,6
"85214",42607000,1000,0.00268708,0,0,0,3,3
"85215",42607500,1000,0.00260745,0,0,0,1,1
"85216",42608000,1000,0.00257293,0,0,0,0,0
"85217",42608500,1000,0.00250073,0,0,0,0,0
"85218",42609000,1000,0.00244388,0,0,0,0,0
"85219",42609500,1000,0.00247231,0,0,0,0,0
"85220",42610000,1000,0.00257637,0,0,0,0,0
"85221",42610500,1000,0.00265353,0,0,0,1,1
"85222",42611000,1000,0.00266704,0,0,0,3,3
"85223",42611500,1000,0.00270032,0,0,0,4,4
"85224",42612000,1000,0.00275662,0,0,0,4,4
"85225",42612500,1000,0.00271123,0,0,0,2,2
"85226",42613000,1000,0.00270126,0,0,0,2,2
"85227",42613500,1000,0.00281577,0,0,0,2,2
"85228",42614000,1000,0.00289569,0,0,0,1,1
"85229",42614500,1000,0.00286922,0,0,0,1,1
"85230",42615000,1000,0.00269924,0,0,0,0,0
"85231",42615500,1000,0.00264506,0,0,0,0,0
"85232",42616000,1000,0.00276664,0,0,1,1,2
"85233",42616500,1000,0.00278779,0,0,2,2,4
"85234",42617000,1000,0.00263404,0,0,1,1,2
"85235",42617500,1000,0.00251784,0,0,0,0,0
"85236",42618000,1000,0.00265089,0,0,0,0,0
"85237",42618500,1000,0.00274846,0,0,0,0,0
"85238",42619000,1000,0.00299324,0,0,1,2,3
"85239",42619500,1000,0.00300431,0,0,2,3,5
"85240",42620000,1000,0.00261935,0,0,1,1,2
"85241",42620500,1000,0.00260552,0,0,0,2,2
"85242",42621000,1000,0.00267998,0,0,0,2,2
"85243",42621500,1000,0.00264808,0,0,0,1,1
"85244",42622000,1000,0.00259309,0,0,0,1,1
"85245",42622500,1000,0.0025729,0,0,0,1,1
"85246",42623000,1000,0.00267211,0,0,0,1,1
"85247",42623500,1000,0.00265619,0,0,0,0,0
"85248",42624000,1000,0.00294985,0,1,1,1,3
"85249",42624500,1000,0.00306874,0,1,1,3,5
"85250",42625000,1000,0.0028146,0,0,0,4,4
"85251",42625500,1000,0.00282535,0,0,1,3,4
"85252",42626000,1000,0.0026716,0,0,1,1,2
"85253",42626500,1000,0.00273386,0,0,1,1,2
"85254",42627000,1000,0.00284957,0,0,1,1,2
"85255",42627500,1000,0.00273547,0,0,0,1,1
"85256",42628000,1000,0.00287413,0,1,0,1,2
"85257",42628500,1000,0.00291723,0,1,0,2,3
"85258",42629000,1000,0.00284517,0,0,0,5,5
"85259",42629500,1000,0.00282108,0,0,0,4,4
"85260",42630000,1000,0.00279348,0,0,1,2,3
"85261",42630500,1000,0.00271749,0,0,1,3,4
"85262",42631000,1000,0.002698,0,0,0,4,4
"85263",42631500,1000,0.00267879,0,0,0,3,3
"85264",42632000,1000,0.00260038,0,0,0,2,2
"85265",42632500,1000,0.00253151,0,0,0,2,2
"85266",42633000,1000,0.00252115,0,0,0,2,2
"85267",42633500,1000,0.00251483,0,0,0,1,1
"85268",42634000,1000,0.00256335,0,0,1,0,1
"85269",42634500,1000,0.00265692,0,0,1,2,3
"85270",42635000,1000,0.00265721,0,0,1,3,4
"85271",42635500,1000,0.00263117,0,0,1,1,2
"85272",42636000,1000,0.00258016,0,0,0,0,0
"85273",42636500,1000,0.00273204,0,0,1,0,1
"85274",42637000,1000,0.00283497,0,0,2,1,3
"85275",42637500,1000,0.00277664,0,0,1,3,4
"85276",42638000,1000,0.00274393,0,0,0,3,3
"85277",42638500,1000,0.00276533,0,0,0,3,3
"85278",42639000,1000,0.00270351,0,0,0,3,3
"85279",42639500,1000,0.00259018,0,0,0,1,1
"85280",42640000,1000,0.00256626,0,0,0,0,0
"85281",42640500,1000,0.00271679,0,0,1,0,1
"85282",42641000,1000,0.00296951,0,1,1,0,2
"85283",42641500,1000,0.00293243,0,1,0,1,2
"85284",42642000,1000,0.0028235,0,0,1,2,3
"85285",42642500,1000,0.00272294,0,0,1,1,2
"85286",42643000,1000,0.00251386,0,0,0,0,0
"85287",42643500,1000,0.0025394,0,0,0,1,1
"85288",42644000,1000,0.00265657,0,0,0,1,1
"85289",42644500,1000,0.00276036,0,0,0,4,4
"85290",42645000,1000,0.00282743,0,0,0,5,5
"85291",42645500,1000,0.0027314,0,0,0,1,1
"85292",42646000,1000,0.00268187,0,0,0,0,0
"85293",42646500,1000,0.00259155,0,0,0,0,0
"85294",42647000,1000,0.00253988,0,0,0,1,1
"85295",42647500,1000,0.00259599,0,0,0,2,2
"85296",42648000,1000,0.00265784,0,0,0,2,2
"85297",42648500,1000,0.00280304,0,0,0,3,3
"85298",42649000,1000,0.00277484,0,0,0,3,3
"85299",42649500,1000,0.00268961,0,0,1,2,3
"85300",42650000,1000,0.00268035,0,0,1,2,3
"85301",42650500,1000,0.00281629,0,0,1,3,4
"85302",42651000,1000,0.00290338,0,0,1,4,5
"85303",42651500,1000,0.00279861,0,0,0,3,3
"85304",42652000,1000,0.00282954,0,0,1,2,3
"85305",42652500,1000,0.00285893,0,0,2,2,4
"85306",42653000,1000,0.002714,0,0,1,1,2
"85307",42653500,1000,0.00257558,0,0,0,0,0
"85308",42654000,1000,0.00263343,0,0,0,1,1
"85309",42654500,1000,0.00281262,0,1,0,1,2
"85310",42655000,1000,0.00287629,0,1,1,1,3
"85311",42655500,1000,0.00273017,0,0,1,1,2
"85312",42656000,1000,0.00274218,0,0,0,2,2
"85313",42656500,1000,0.00283248,0,0,0,4,4
"85314",42657000,1000,0.00274719,0,0,0,2,2
"85315",42657500,1000,0.0026155,0,0,0,0,0
"85316",42658000,1000,0.00247282,0,0,0,0,0
"85317",42658500,1000,0.00246283,0,0,0,0,0
"85318",42659000,1000,0.0026022,0,0,0,1,1
"85319",42659500,1000,0.00262345,0,0,0,1,1
"85320",42660000,1000,0.00267676,0,0,0,0,0
"85321",42660500,1000,0.00283277,0,0,1,0,1
"85322",42661000,1000,0.00277799,0,0,1,1,2
"85323",42661500,1000,0.00269459,0,0,0,1,1
"85324",42662000,1000,0.00266197,0,0,0,2,2
"85325",42662500,1000,0.00263551,0,0,0,3,3
"85326",42663000,1000,0.00264178,0,0,0,1,1
"85327",42663500,1000,0.00266707,0,0,0,0,0
"85328",42664000,1000,0.00270015,0,0,0,1,1
"85329",42664500,1000,0.00262431,0,0,0,2,2
"85330",42665000,1000,0.002686,0,0,1,2,3
"85331",42665500,1000,0.00279744,0,0,1,1,2
"85332",42666000,1000,0.00288689,0,0,0,1,1
"85333",42666500,1000,0.00300271,0,0,0,1,1
"85334",42667000,1000,0.00288768,0,0,0,0,0
"85335",42667500,1000,0.00280667,0,0,1,0,1
"85336",42668000,1000,0.00290885,0,0,1,1,2
"85337",42668500,1000,0.00297488,0,0,1,2,3
"85338",42669000,1000,0.00296582,0,0,2,2,4
"85339",42669500,1000,0.00285012,0,0,1,2,3
"85340",42670000,1000,0.00254138,0,0,0,1,1
"85341",42670500,1000,0.0026456,0,0,0,2,2
"85342",42671000,1000,0.00287807,0,0,0,4,4
"85343",42671500,1000,0.0026778,0,0,0,2,2
"85344",42672000,1000,0.00266588,0,0,0,1,1
"85345",42672500,1000,0.00274675,0,0,0,1,1
"85346",42673000,1000,0.00268357,0,0,0,0,0
"85347",42673500,1000,0.00256006,0,0,0,0,0
"85348",42674000,1000,0.00257226,0,0,1,0,1
"85349",42674500,1000,0.0026679,0,0,1,0,1
"85350",42675000,1000,0.00270594,0,0,0,0,0
"85351",42675500,1000,0.00266288,0,0,0,1,1
"85352",42676000,1000,0.00253993,0,0,0,1,1
"85353",42676500,1000,0.00242279,0,0,0,0,0
"85354",42677000,1000,0.00244984,0,0,0,1,1
"85355",42677500,1000,0.00272275,0,0,0,3,3
"85356",42678000,1000,0.00264389,0,0,0,2,2
"85357",42678500,1000,0.00246404,0,0,0,0,0
"85358",42679000,1000,0.00253724,0,0,0,0,0
"85359",42679500,1000,0.0025848,0,0,0,0,0
"85360",42680000,1000,0.00264626,0,0,0,0,0
"85361",42680500,1000,0.0026822,0,0,0,1,1
"85362",42681000,1000,0.00273475,0,0,1,2,3
"85363",42681500,1000,0.00271064,0,0,1,1,2
"85364",42682000,1000,0.00259226,0,0,0,1,1
"85365",42682500,1000,0.00254174,0,0,0,1,1
"85366",42683000,1000,0.0025154,0,0,0,1,1
"85367",42683500,1000,0.00249523,0,0,0,1,1
"85368",42684000,1000,0.0025497,0,0,0,0,0
"85369",42684500,1000,0.00266324,0,0,0,2,2
"85370",42685000,1000,0.00277202,0,0,0,2,2
"85371",42685500,1000,0.00283112,0,0,0,1,1
"85372",42686000,1000,0.0027443,0,0,0,1,1
"85373",42686500,1000,0.00258254,0,0,0,0,0
"85374",42687000,1000,0.00258945,0,0,0,0,0
"85375",42687500,1000,0.00293441,0,1,1,0,2
"85376",42688000,1000,0.00292817,0,1,1,0,2
"85377",42688500,1000,0.00287346,0,1,1,0,2
"85378",42689000,1000,0.00277388,0,1,1,0,2
"85379",42689500,1000,0.00273636,0,0,2,1,3
"85380",42690000,1000,0.00279991,0,0,2,1,3
"85381",42690500,1000,0.00264424,0,0,0,0,0
"85382",42691000,1000,0.00281079,0,0,0,1,1
"85383",42691500,1000,0.00284616,0,0,0,1,1
"85384",42692000,1000,0.00261806,0,0,0,0,0
"85385",42692500,1000,0.00256984,0,0,0,0,0
"85386",42693000,1000,0.00293287,0,1,1,1,3
"85387",42693500,1000,0.00291309,0,1,1,2,4
"85388",42694000,1000,0.00278835,0,0,1,1,2
"85389",42694500,1000,0.00277984,0,0,1,0,1
"85390",42695000,1000,0.0027932,0,0,1,1,2
"85391",42695500,1000,0.00281768,0,0,1,2,3
"85392",42696000,1000,0.00272686,0,0,0,1,1
"85393",42696500,1000,0.00281051,0,0,0,1,1
"85394",42697000,1000,0.00277184,0,0,0,1,1
"85395",42697500,1000,0.0027299,0,0,0,1,1
"85396",42698000,1000,0.00264694,0,0,0,1,1
"85397",42698500,1000,0.00260059,0,0,0,0,0
"85398",42699000,1000,0.00268886,0,0,0,1,1
"85399",42699500,1000,0.0027209,0,0,1,2,3
"85400",42700000,1000,0.00273533,0,0,1,2,3
"85401",42700500,1000,0.00276347,0,0,0,2,2
"85402",42701000,1000,0.00270179,0,0,0,1,1
"85403",42701500,1000,0.00264275,0,0,0,0,0
"85404",42702000,1000,0.00267344,0,0,0,0,0
"85405",42702500,1000,0.00277228,0,0,0,1,1
"85406",42703000,1000,0.00275751,0,0,0,2,2
"85407",42703500,1000,0.00257961,0,0,0,1,1
"85408",42704000,1000,0.00262973,0,0,0,0,0
"85409",42704500,1000,0.00271371,0,0,0,0,0
"85410",42705000,1000,0.00270903,0,0,0,0,0
"85411",42705500,1000,0.00274702,0,0,1,0,1
"85412",42706000,1000,0.002927,0,1,1,3,5
"85413",42706500,1000,0.00281689,0,1,0,3,4
"85414",42707000,1000,0.00255017,0,0,0,0,0
"85415",42707500,1000,0.00266998,0,0,0,2,2
"85416",42708000,1000,0.00287645,0,0,1,3,4
"85417",42708500,1000,0.00293434,0,0,1,1,2
"85418",42709000,1000,0.00276632,0,0,0,0,0
"85419",42709500,1000,0.00266627,0,0,0,0,0
"85420",42710000,1000,0.00264429,0,0,0,0,0
"85421",42710500,1000,0.00261418,0,0,0,0,0
"85422",42711000,1000,0.00280321,0,0,0,4,4
"85423",42711500,1000,0.0028769,0,0,0,4,4
"85424",42712000,1000,0.00271596,0,0,0,0,0
"85425",42712500,1000,0.0027094,0,0,0,2,2
"85426",42713000,1000,0.00276533,0,0,0,3,3
"85427",42713500,1000,0.00264179,0,0,0,1,1
"85428",42714000,1000,0.00252204,0,0,0,0,0
"85429",42714500,1000,0.00238481,0,0,0,0,0
"85430",42715000,1000,0.00227631,0,0,0,1,1
"85431",42715500,1000,0.0023747,0,0,0,1,1
"85432",42716000,1000,0.00248062,0,0,0,0,0
"85433",42716500,1000,0.0026194,0,0,0,2,2
"85434",42717000,1000,0.00257061,0,0,0,2,2
"85435",42717500,1000,0.00259228,0,0,0,0,0
"85436",42718000,1000,0.00263401,0,0,0,0,0
"85437",42718500,1000,0.00253212,0,0,0,0,0
"85438",42719000,1000,0.00261228,0,0,0,0,0
"85439",42719500,1000,0.00259948,0,0,0,1,1
"85440",42720000,1000,0.00260446,0,0,0,2,2
"85441",42720500,1000,0.0026766,0,0,0,1,1
"85442",42721000,1000,0.00271081,0,0,0,1,1
"85443",42721500,1000,0.00272771,0,0,1,3,4
"85444",42722000,1000,0.00282047,0,1,1,2,4
"85445",42722500,1000,0.00276973,0,1,0,0,1
"85446",42723000,1000,0.0026959,0,0,1,1,2
"85447",42723500,1000,0.00268428,0,0,1,1,2
"85448",42724000,1000,0.00258151,0,0,0,1,1
"85449",42724500,1000,0.00255189,0,0,0,1,1
"85450",42725000,1000,0.00257711,0,0,0,2,2
"85451",42725500,1000,0.00267114,0,0,0,2,2
"85452",42726000,1000,0.0027084,0,0,0,2,2
"85453",42726500,1000,0.00273237,0,0,0,3,3
"85454",42727000,1000,0.00275533,0,0,0,3,3
"85455",42727500,1000,0.00263345,0,0,0,2,2
"85456",42728000,1000,0.00266092,0,0,1,1,2
"85457",42728500,1000,0.0027498,0,0,2,2,4
"85458",42729000,1000,0.00267135,0,0,1,1,2
"85459",42729500,1000,0.00271229,0,0,0,3,3
"85460",42730000,1000,0.00270275,0,0,0,3,3
"85461",42730500,1000,0.00272036,0,0,1,1,2
"85462",42731000,1000,0.00274073,0,0,1,2,3
"85463",42731500,1000,0.00270629,0,0,1,1,2
"85464",42732000,1000,0.00268343,0,0,1,0,1
"85465",42732500,1000,0.00273238,0,0,1,0,1
"85466",42733000,1000,0.00283611,0,0,2,1,3
"85467",42733500,1000,0.00266232,0,0,1,1,2
"85468",42734000,1000,0.00254245,0,0,0,1,1
"85469",42734500,1000,0.00267032,0,0,1,1,2
"85470",42735000,1000,0.00267538,0,0,1,0,1
"85471",42735500,1000,0.00285134,0,0,1,1,2
"85472",42736000,1000,0.00283859,0,0,1,2,3
"85473",42736500,1000,0.0026593,0,0,0,2,2
"85474",42737000,1000,0.00274726,0,0,0,3,3
"85475",42737500,1000,0.00269344,0,0,0,4,4
"85476",42738000,1000,0.0025393,0,0,0,2,2
"85477",42738500,1000,0.00266258,0,0,1,2,3
"85478",42739000,1000,0.0027499,0,0,1,2,3
"85479",42739500,1000,0.00264151,0,0,0,0,0
"85480",42740000,1000,0.00269912,0,0,1,0,1
"85481",42740500,1000,0.00269509,0,0,1,0,1
"85482",42741000,1000,0.00259496,0,0,0,0,0
"85483",42741500,1000,0.00252207,0,0,0,0,0
"85484",42742000,1000,0.00257846,0,0,0,0,0
"85485",42742500,1000,0.00257391,0,0,0,0,0
"85486",42743000,1000,0.00263303,0,0,0,2,2
"85487",42743500,1000,0.00278548,0,0,0,3,3
"85488",42744000,1000,0.00266671,0,0,0,1,1
"85489",42744500,1000,0.00248526,0,0,0,0,0
"85490",42745000,1000,0.00241787,0,0,0,0,0
"85491",42745500,1000,0.00257621,0,0,0,3,3
"85492",42746000,1000,0.00268169,0,0,0,4,4
"85493",42746500,1000,0.00257002,0,0,0,1,1
"85494",42747000,1000,0.00258586,0,0,0,0,0
"85495",42747500,1000,0.00277339,0,0,0,0,0
"85496",42748000,1000,0.00277021,0,0,0,0,0
"85497",42748500,1000,0.00269444,0,0,0,2,2
"85498",42749000,1000,0.00271272,0,0,0,3,3
"85499",42749500,1000,0.00266493,0,0,0,2,2
"85500",42750000,1000,0.00264862,0,0,0,1,1
"85501",42750500,1000,0.00279587,0,1,0,1,2
"85502",42751000,1000,0.00279136,0,1,0,1,2
"85503",42751500,1000,0.00255608,0,0,0,0,0
"85504",42752000,1000,0.00260976,0,0,0,1,1
"85505",42752500,1000,0.00268232,0,0,0,1,1
"85506",42753000,1000,0.00256525,0,0,0,0,0
"85507",42753500,1000,0.00252142,0,0,0,0,0
"85508",42754000,1000,0.00277703,0,0,1,3,4
"85509",42754500,1000,0.00274663,0,0,1,3,4
"85510",42755000,1000,0.00262324,0,0,0,0,0
"85511",42755500,1000,0.00290034,0,0,1,1,2
"85512",42756000,1000,0.00288217,0,0,1,1,2
"85513",42756500,1000,0.00276799,0,0,1,1,2
"85514",42757000,1000,0.00260351,0,0,1,1,2
"85515",42757500,1000,0.00258543,0,0,0,2,2
"85516",42758000,1000,0.00264899,0,0,0,2,2
"85517",42758500,1000,0.00262615,0,0,0,1,1
"85518",42759000,1000,0.00261822,0,0,0,1,1
"85519",42759500,1000,0.0026076,0,0,0,0,0
"85520",42760000,1000,0.00289843,0,0,1,0,1
"85521",42760500,1000,0.00277967,0,0,1,1,2
"85522",42761000,1000,0.00238044,0,0,0,1,1
"85523",42761500,1000,0.0024264,0,0,0,1,1
"85524",42762000,1000,0.00260639,0,0,0,1,1
"85525",42762500,1000,0.0027565,0,0,0,1,1
"85526",42763000,1000,0.00274219,0,0,0,1,1
"85527",42763500,1000,0.00257947,0,0,0,0,0
"85528",42764000,1000,0.00274798,0,0,1,0,1
"85529",42764500,1000,0.00277456,0,0,1,0,1
"85530",42765000,1000,0.00268309,0,0,0,2,2
"85531",42765500,1000,0.00270517,0,0,0,2,2
"85532",42766000,1000,0.0027612,0,0,1,1,2
"85533",42766500,1000,0.00275578,0,0,1,1,2
"85534",42767000,1000,0.00264503,0,0,0,0,0
"85535",42767500,1000,0.0026535,0,0,0,0,0
"85536",42768000,1000,0.00269085,0,0,0,2,2
"85537",42768500,1000,0.00279908,0,0,0,6,6
"85538",42769000,1000,0.00284613,0,0,1,5,6
"85539",42769500,1000,0.00271395,0,0,1,2,3
"85540",42770000,1000,0.0028401,0,0,1,3,4
"85541",42770500,1000,0.00298676,0,1,1,3,5
"85542",42771000,1000,0.00275024,0,1,0,1,2
"85543",42771500,1000,0.0026838,0,0,0,3,3
"85544",42772000,1000,0.00269028,0,0,0,3,3
"85545",42772500,1000,0.0026711,0,0,0,1,1
"85546",42773000,1000,0.00268406,0,0,0,2,2
"85547",42773500,1000,0.00267026,0,0,0,2,2
"85548",42774000,1000,0.00259218,0,0,0,1,1
"85549",42774500,1000,0.00247655,0,0,0,0,0
"85550",42775000,1000,0.00258508,0,0,0,0,0
"85551",42775500,1000,0.00266759,0,0,0,1,1
"85552",42776000,1000,0.00273749,0,0,1,1,2
"85553",42776500,1000,0.00270346,0,0,1,0,1
"85554",42777000,1000,0.00276104,0,0,1,3,4
"85555",42777500,1000,0.00279678,0,0,1,4,5
"85556",42778000,1000,0.00268913,0,0,0,3,3
"85557",42778500,1000,0.00276351,0,0,0,3,3
"85558",42779000,1000,0.00268135,0,0,0,1,1
"85559",42779500,1000,0.00263655,0,0,0,0,0
"85560",42780000,1000,0.00264093,0,0,0,0,0
"85561",42780500,1000,0.00250409,0,0,0,0,0
"85562",42781000,1000,0.00255814,0,0,0,0,0
"85563",42781500,1000,0.00286787,0,0,0,1,1
"85564",42782000,1000,0.00273863,0,0,0,1,1
"85565",42782500,1000,0.00263593,0,0,0,1,1
"85566",42783000,1000,0.00279608,0,0,0,1,1
"85567",42783500,1000,0.00260489,0,0,0,0,0
"85568",42784000,1000,0.00256896,0,0,0,0,0
"85569",42784500,1000,0.0026999,0,0,0,1,1
"85570",42785000,1000,0.00280722,0,0,0,2,2
"85571",42785500,1000,0.00282973,0,0,0,2,2
"85572",42786000,1000,0.00274158,0,0,0,1,1
"85573",42786500,1000,0.00290007,0,0,2,2,4
"85574",42787000,1000,0.0029063,0,0,2,2,4
"85575",42787500,1000,0.00277579,0,0,0,1,1
"85576",42788000,1000,0.00286974,0,0,1,2,3
"85577",42788500,1000,0.00301307,0,0,3,1,4
"85578",42789000,1000,0.00297303,0,0,2,3,5
"85579",42789500,1000,0.00269807,0,0,0,3,3
"85580",42790000,1000,0.00280745,0,1,0,0,1
"85581",42790500,1000,0.00297727,0,1,0,1,2
"85582",42791000,1000,0.00278422,0,0,0,1,1
"85583",42791500,1000,0.00276624,0,0,1,1,2
"85584",42792000,1000,0.00270075,0,0,1,1,2
"85585",42792500,1000,0.00256744,0,0,0,0,0
"85586",42793000,1000,0.00255534,0,0,0,1,1
"85587",42793500,1000,0.0026428,0,0,0,1,1
"85588",42794000,1000,0.00281616,0,0,1,1,2
"85589",42794500,1000,0.00291647,0,0,1,2,3
"85590",42795000,1000,0.00295307,0,0,1,1,2
"85591",42795500,1000,0.00294791,0,0,1,0,1
"85592",42796000,1000,0.00284192,0,0,0,1,1
"85593",42796500,1000,0.00260922,0,0,0,1,1
"85594",42797000,1000,0.00258406,0,0,0,1,1
"85595",42797500,1000,0.00266674,0,0,0,1,1
"85596",42798000,1000,0.0026136,0,0,0,0,0
"85597",42798500,1000,0.0025957,0,0,0,1,1
"85598",42799000,1000,0.00264546,0,0,0,1,1
"85599",42799500,1000,0.002878,0,0,2,2,4
"85600",42800000,1000,0.00280124,0,0,2,2,4
"85601",42800500,1000,0.00263023,0,0,1,0,1
"85602",42801000,1000,0.00261042,0,0,1,0,1
"85603",42801500,1000,0.00274502,0,1,0,0,1
"85604",42802000,1000,0.00283001,0,1,0,1,2
"85605",42802500,1000,0.0025523,0,0,0,1,1
"85606",42803000,1000,0.002858,0,1,0,0,1
"85607",42803500,1000,0.00294113,0,1,0,0,1
"85608",42804000,1000,0.00270431,0,0,0,1,1
"85609",42804500,1000,0.00277415,0,0,0,2,2
"85610",42805000,1000,0.00264025,0,0,0,1,1
"85611",42805500,1000,0.00259501,0,0,0,1,1
"85612",42806000,1000,0.00271206,0,0,0,2,2
"85613",42806500,1000,0.00278086,0,0,0,1,1
"85614",42807000,1000,0.00277422,0,0,1,1,2
"85615",42807500,1000,0.00267183,0,0,1,2,3
"85616",42808000,1000,0.00268249,0,0,0,4,4
"85617",42808500,1000,0.0027369,0,0,0,3,3
"85618",42809000,1000,0.00261848,0,0,0,0,0
"85619",42809500,1000,0.00256014,0,0,0,1,1
"85620",42810000,1000,0.00256214,0,0,0,1,1
"85621",42810500,1000,0.00252446,0,0,0,0,0
"85622",42811000,1000,0.00260002,0,0,0,0,0
"85623",42811500,1000,0.00274272,0,0,0,1,1
"85624",42812000,1000,0.00279826,0,0,0,2,2
"85625",42812500,1000,0.00262244,0,0,0,2,2
"85626",42813000,1000,0.00272241,0,0,1,4,5
"85627",42813500,1000,0.0028602,0,0,1,4,5
"85628",42814000,1000,0.00266068,0,0,0,1,1
"85629",42814500,1000,0.00255893,0,0,0,0,0
"85630",42815000,1000,0.00259312,0,0,0,0,0
"85631",42815500,1000,0.00272224,0,0,0,0,0
"85632",42816000,1000,0.00284775,0,0,1,1,2
"85633",42816500,1000,0.0028057,0,0,1,2,3
"85634",42817000,1000,0.00270768,0,0,0,1,1
"85635",42817500,1000,0.00285577,0,1,0,1,2
"85636",42818000,1000,0.00299852,0,1,0,4,5
"85637",42818500,1000,0.00299012,0,0,0,3,3
"85638",42819000,1000,0.00281753,0,0,0,1,1
"85639",42819500,1000,0.00262268,0,0,0,1,1
"85640",42820000,1000,0.00268744,0,0,0,1,1
"85641",42820500,1000,0.00278896,0,0,0,1,1
"85642",42821000,1000,0.00272301,0,0,0,2,2
"85643",42821500,1000,0.00265883,0,0,1,2,3
"85644",42822000,1000,0.00262018,0,0,1,0,1
"85645",42822500,1000,0.00266909,0,0,0,2,2
"85646",42823000,1000,0.00275721,0,0,1,3,4
"85647",42823500,1000,0.00290156,0,1,1,1,3
"85648",42824000,1000,0.0028397,0,1,0,0,1
"85649",42824500,1000,0.00285605,0,0,2,2,4
"85650",42825000,1000,0.00283978,0,0,2,2,4
"85651",42825500,1000,0.00256191,0,0,0,1,1
"85652",42826000,1000,0.00251275,0,0,0,1,1
"85653",42826500,1000,0.00261514,0,0,0,3,3
"85654",42827000,1000,0.00268652,0,0,0,3,3
"85655",42827500,1000,0.00277865,0,0,1,0,1
"85656",42828000,1000,0.00276704,0,0,1,0,1
"85657",42828500,1000,0.00261807,0,0,0,0,0
"85658",42829000,1000,0.00273154,0,0,0,1,1
"85659",42829500,1000,0.0027187,0,0,0,1,1
"85660",42830000,1000,0.00271946,0,0,0,2,2
"85661",42830500,1000,0.00278532,0,0,0,2,2
"85662",42831000,1000,0.00261438,0,0,0,0,0
"85663",42831500,1000,0.00254002,0,0,0,0,0
"85664",42832000,1000,0.00264019,0,0,0,1,1
"85665",42832500,1000,0.00265013,0,0,0,1,1
"85666",42833000,1000,0.00246977,0,0,0,0,0
"85667",42833500,1000,0.00239642,0,0,0,0,0
"85668",42834000,1000,0.00249686,0,0,0,0,0
"85669",42834500,1000,0.00270153,0,0,0,1,1
"85670",42835000,1000,0.00280041,0,0,0,1,1
"85671",42835500,1000,0.00275545,0,0,0,2,2
"85672",42836000,1000,0.00276879,0,0,1,3,4
"85673",42836500,1000,0.00273622,0,0,1,1,2
"85674",42837000,1000,0.00275544,0,0,0,2,2
"85675",42837500,1000,0.00274511,0,0,0,2,2
"85676",42838000,1000,0.00272534,0,0,0,1,1
"85677",42838500,1000,0.00301451,0,1,1,2,4
"85678",42839000,1000,0.0029161,0,1,1,1,3
"85679",42839500,1000,0.00275068,0,0,1,2,3
"85680",42840000,1000,0.00288377,0,0,2,4,6
"85681",42840500,1000,0.00283657,0,0,2,3,5
"85682",42841000,1000,0.00275967,0,0,1,1,2
"85683",42841500,1000,0.00268296,0,0,0,0,0
"85684",42842000,1000,0.00273825,0,0,0,0,0
"85685",42842500,1000,0.00271969,0,0,0,0,0
"85686",42843000,1000,0.0026169,0,0,0,0,0
"85687",42843500,1000,0.00261236,0,0,0,0,0
"85688",42844000,1000,0.00267142,0,0,0,1,1
"85689",42844500,1000,0.00268141,0,0,0,1,1
"85690",42845000,1000,0.00266041,0,0,0,0,0
"85691",42845500,1000,0.00264716,0,0,0,0,0
"85692",42846000,1000,0.00271305,0,0,1,1,2
"85693",42846500,1000,0.00275383,0,0,1,2,3
"85694",42847000,1000,0.0027395,0,0,0,1,1
"85695",42847500,1000,0.00270434,0,0,0,0,0
"85696",42848000,1000,0.00262953,0,0,0,0,0
"85697",42848500,1000,0.00263999,0,0,0,1,1
"85698",42849000,1000,0.00273197,0,0,0,1,1
"85699",42849500,1000,0.0028059,0,0,0,1,1
"85700",42850000,1000,0.00272558,0,0,0,1,1
"85701",42850500,1000,0.00267397,0,0,0,2,2
"85702",42851000,1000,0.00263541,0,0,0,2,2
"85703",42851500,1000,0.0027325,0,0,0,1,1
"85704",42852000,1000,0.0027487,0,0,0,1,1
"85705",42852500,1000,0.00265822,0,0,0,0,0
"85706",42853000,1000,0.00310432,0,2,0,0,2
"85707",42853500,1000,0.00336377,0,3,0,0,3
"85708",42854000,1000,0.00296425,0,1,0,0,1
"85709",42854500,1000,0.00282099,0,0,0,1,1
"85710",42855000,1000,0.00296619,0,0,1,2,3
"85711",42855500,1000,0.00293023,0,0,1,2,3
"85712",42856000,1000,0.00283131,0,0,0,1,1
"85713",42856500,1000,0.00271274,0,0,0,0,0
"85714",42857000,1000,0.00270595,0,0,0,1,1
"85715",42857500,1000,0.00265028,0,0,0,1,1
"85716",42858000,1000,0.00263029,0,0,0,1,1
"85717",42858500,1000,0.00284476,0,0,0,3,3
"85718",42859000,1000,0.00286653,0,0,1,3,4
"85719",42859500,1000,0.00274862,0,0,1,1,2
"85720",42860000,1000,0.00286374,0,0,1,1,2
"85721",42860500,1000,0.00289421,0,0,1,4,5
"85722",42861000,1000,0.00270611,0,0,0,4,4
"85723",42861500,1000,0.00270685,0,0,0,4,4
"85724",42862000,1000,0.00281269,0,0,0,5,5
"85725",42862500,1000,0.00440496,1,0,0,2,3
"85726",42863000,1000,0.00426178,1,0,0,0,1
"85727",42863500,1000,0.00254219,0,0,0,2,2
"85728",42864000,1000,0.00259069,0,0,0,2,2
"85729",42864500,1000,0.00271169,0,0,0,0,0
"85730",42865000,1000,0.00272525,0,0,0,1,1
"85731",42865500,1000,0.00273274,0,0,0,3,3
"85732",42866000,1000,0.00288017,0,0,1,2,3
"85733",42866500,1000,0.00281396,0,0,1,0,1
"85734",42867000,1000,0.0027011,0,0,0,0,0
"85735",42867500,1000,0.00282917,0,0,0,1,1
"85736",42868000,1000,0.00274356,0,0,0,1,1
"85737",42868500,1000,0.00260737,0,0,0,0,0
"85738",42869000,1000,0.00261548,0,0,0,1,1
"85739",42869500,1000,0.00256248,0,0,0,1,1
"85740",42870000,1000,0.00255713,0,0,0,1,1
"85741",42870500,1000,0.00255865,0,0,0,1,1
"85742",42871000,1000,0.0027233,0,0,1,1,2
"85743",42871500,1000,0.00276838,0,0,1,1,2
"85744",42872000,1000,0.00265078,0,0,0,1,1
"85745",42872500,1000,0.00267238,0,0,0,1,1
"85746",42873000,1000,0.00287351,0,1,0,0,1
"85747",42873500,1000,0.00285992,0,1,0,1,2
"85748",42874000,1000,0.0027581,0,0,0,2,2
"85749",42874500,1000,0.00278033,0,0,0,2,2
"85750",42875000,1000,0.00271224,0,0,0,3,3
"85751",42875500,1000,0.00260637,0,0,0,2,2
"85752",42876000,1000,0.00254702,0,0,0,0,0
"85753",42876500,1000,0.00282605,0,0,1,2,3
"85754",42877000,1000,0.0029445,0,0,1,4,5
"85755",42877500,1000,0.00276357,0,0,0,2,2
"85756",42878000,1000,0.00266434,0,0,0,0,0
"85757",42878500,1000,0.00276654,0,0,0,1,1
"85758",42879000,1000,0.00272805,0,0,0,1,1
"85759",42879500,1000,0.00267797,0,0,0,0,0
"85760",42880000,1000,0.00285395,0,0,1,1,2
"85761",42880500,1000,0.00289046,0,0,1,3,4
"85762",42881000,1000,0.00276214,0,0,0,2,2
"85763",42881500,1000,0.00273609,0,0,0,1,1
"85764",42882000,1000,0.0028992,0,1,0,1,2
"85765",42882500,1000,0.00293769,0,1,1,1,3
"85766",42883000,1000,0.00275319,0,0,1,1,2
"85767",42883500,1000,0.00266181,0,0,0,1,1
"85768",42884000,1000,0.0026575,0,0,0,2,2
"85769",42884500,1000,0.00281837,0,0,0,2,2
"85770",42885000,1000,0.00302069,0,1,0,1,2
"85771",42885500,1000,0.00284893,0,1,0,1,2
"85772",42886000,1000,0.00264497,0,0,0,2,2
"85773",42886500,1000,0.00263889,0,0,0,1,1
"85774",42887000,1000,0.00284137,0,0,2,0,2
"85775",42887500,1000,0.00283759,0,0,2,0,2
"85776",42888000,1000,0.0027304,0,0,0,4,4
"85777",42888500,1000,0.00274255,0,0,0,5,5
"85778",42889000,1000,0.00266954,0,0,0,3,3
"85779",42889500,1000,0.00281122,0,0,1,3,4
"85780",42890000,1000,0.0028444,0,0,1,1,2
"85781",42890500,1000,0.00275752,0,0,0,3,3
"85782",42891000,1000,0.00266742,0,0,0,3,3
"85783",42891500,1000,0.002607,0,0,0,0,0
"85784",42892000,1000,0.00267762,0,0,0,0,0
"85785",42892500,1000,0.0025937,0,0,0,0,0
"85786",42893000,1000,0.00256103,0,0,0,0,0
"85787",42893500,1000,0.00269615,0,0,0,2,2
"85788",42894000,1000,0.00270653,0,0,0,4,4
"85789",42894500,1000,0.00274865,0,0,1,4,5
"85790",42895000,1000,0.00273274,0,0,1,2,3
"85791",42895500,1000,0.0025762,0,0,0,0,0
"85792",42896000,1000,0.00276837,0,0,1,3,4
"85793",42896500,1000,0.00282857,0,0,1,3,4
"85794",42897000,1000,0.00287084,0,1,0,1,2
"85795",42897500,1000,0.00281516,0,1,0,1,2
"85796",42898000,1000,0.00265279,0,0,0,0,0
"85797",42898500,1000,0.00271131,0,0,0,0,0
"85798",42899000,1000,0.00259968,0,0,0,0,0
"85799",42899500,1000,0.00268893,0,0,1,0,1
"85800",42900000,1000,0.00276093,0,0,1,1,2
"85801",42900500,1000,0.00273777,0,0,0,1,1
"85802",42901000,1000,0.00276462,0,0,0,1,1
"85803",42901500,1000,0.00272001,0,0,0,2,2
"85804",42902000,1000,0.00279837,0,0,1,2,3
"85805",42902500,1000,0.00277215,0,0,1,1,2
"85806",42903000,1000,0.00272514,0,0,0,2,2
"85807",42903500,1000,0.00290073,0,1,0,3,4
"85808",42904000,1000,0.00291605,0,1,1,2,4
"85809",42904500,1000,0.00280558,0,0,1,3,4
"85810",42905000,1000,0.00268467,0,0,0,3,3
"85811",42905500,1000,0.00266332,0,0,0,3,3
"85812",42906000,1000,0.00270773,0,0,0,2,2
"85813",42906500,1000,0.00263741,0,0,0,0,0
"85814",42907000,1000,0.00261969,0,0,0,0,0
"85815",42907500,1000,0.00269297,0,0,0,0,0
"85816",42908000,1000,0.00263633,0,0,0,0,0
"85817",42908500,1000,0.00278376,0,0,0,4,4
"85818",42909000,1000,0.00282607,0,0,0,4,4
"85819",42909500,1000,0.00256822,0,0,0,0,0
"85820",42910000,1000,0.00260149,0,0,0,2,2
"85821",42910500,1000,0.00267687,0,0,0,2,2
"85822",42911000,1000,0.00290912,0,0,0,2,2
"85823",42911500,1000,0.00290446,0,0,0,2,2
"85824",42912000,1000,0.00270611,0,0,0,1,1
"85825",42912500,1000,0.00274687,0,0,0,1,1
"85826",42913000,1000,0.00269497,0,0,1,1,2
"85827",42913500,1000,0.00269266,0,0,1,1,2
"85828",42914000,1000,0.002695,0,0,0,1,1
"85829",42914500,1000,0.00264682,0,0,0,2,2
"85830",42915000,1000,0.00263184,0,0,0,1,1
"85831",42915500,1000,0.00261835,0,0,0,1,1
"85832",42916000,1000,0.00260967,0,0,0,1,1
"85833",42916500,1000,0.00252636,0,0,0,0,0
"85834",42917000,1000,0.00255507,0,0,0,1,1
"85835",42917500,1000,0.00265179,0,0,0,2,2
"85836",42918000,1000,0.00282754,0,0,1,3,4
"85837",42918500,1000,0.00281175,0,0,1,2,3
"85838",42919000,1000,0.00263191,0,0,0,1,1
"85839",42919500,1000,0.00271801,0,0,1,2,3
"85840",42920000,1000,0.00268477,0,0,1,1,2
"85841",42920500,1000,0.00265804,0,0,0,1,1
"85842",42921000,1000,0.00275371,0,0,0,1,1
"85843",42921500,1000,0.00275601,0,0,1,1,2
"85844",42922000,1000,0.00266033,0,0,1,2,3
"85845",42922500,1000,0.0025664,0,0,0,1,1
"85846",42923000,1000,0.00252705,0,0,0,0,0
"85847",42923500,1000,0.00255824,0,0,0,1,1
"85848",42924000,1000,0.00273815,0,0,1,2,3
"85849",42924500,1000,0.00267835,0,0,1,1,2
"85850",42925000,1000,0.00251344,0,0,0,1,1
"85851",42925500,1000,0.00269275,0,0,0,3,3
"85852",42926000,1000,0.00272807,0,0,0,2,2
"85853",42926500,1000,0.00266465,0,0,0,2,2
"85854",42927000,1000,0.00257386,0,0,0,3,3
"85855",42927500,1000,0.00249113,0,0,0,2,2
"85856",42928000,1000,0.00266446,0,0,0,3,3
"85857",42928500,1000,0.00277758,0,0,0,3,3
"85858",42929000,1000,0.0027516,0,0,0,1,1
"85859",42929500,1000,0.00274915,0,0,1,1,2
"85860",42930000,1000,0.00286413,0,0,2,1,3
"85861",42930500,1000,0.00280023,0,0,1,0,1
"85862",42931000,1000,0.00270648,0,0,0,1,1
"85863",42931500,1000,0.0027469,0,0,0,4,4
"85864",42932000,1000,0.00264076,0,0,0,3,3
"85865",42932500,1000,0.00261065,0,0,0,1,1
"85866",42933000,1000,0.00266276,0,0,0,1,1
"85867",42933500,1000,0.00273513,0,0,0,2,2
"85868",42934000,1000,0.00275567,0,0,0,2,2
"85869",42934500,1000,0.00267275,0,0,0,0,0
"85870",42935000,1000,0.0027104,0,0,0,2,2
"85871",42935500,1000,0.00267336,0,0,0,3,3
"85872",42936000,1000,0.00261642,0,0,0,2,2
"85873",42936500,1000,0.00269993,0,0,0,3,3
"85874",42937000,1000,0.00283632,0,1,0,2,3
"85875",42937500,1000,0.00280433,0,1,0,0,1
"85876",42938000,1000,0.00275981,0,0,0,2,2
"85877",42938500,1000,0.00278646,0,0,0,2,2
"85878",42939000,1000,0.00260822,0,0,0,0,0
"85879",42939500,1000,0.00260076,0,0,0,2,2
"85880",42940000,1000,0.00271416,0,0,0,3,3
"85881",42940500,1000,0.00273216,0,0,0,1,1
"85882",42941000,1000,0.0026048,0,0,0,0,0
"85883",42941500,1000,0.00262213,0,0,0,1,1
"85884",42942000,1000,0.00285051,0,0,1,2,3
"85885",42942500,1000,0.00292036,0,0,1,4,5
"85886",42943000,1000,0.00281764,0,0,0,4,4
"85887",42943500,1000,0.00279395,0,0,0,2,2
"85888",42944000,1000,0.00278663,0,0,0,1,1
"85889",42944500,1000,0.00263996,0,0,0,1,1
"85890",42945000,1000,0.0027336,0,0,0,2,2
"85891",42945500,1000,0.00279493,0,0,0,1,1
"85892",42946000,1000,0.00272246,0,0,0,0,0
"85893",42946500,1000,0.00270174,0,0,0,0,0
"85894",42947000,1000,0.00275476,0,0,0,1,1
"85895",42947500,1000,0.00288003,0,0,1,2,3
"85896",42948000,1000,0.0027278,0,0,1,1,2
"85897",42948500,1000,0.0027632,0,1,0,0,1
"85898",42949000,1000,0.00284981,0,1,0,0,1
"85899",42949500,1000,0.00277628,0,1,0,0,1
"85900",42950000,1000,0.0026858,0,1,0,0,1
"85901",42950500,1000,0.00275251,0,0,0,3,3
"85902",42951000,1000,0.00294948,0,0,1,4,5
"85903",42951500,1000,0.00281733,0,0,1,1,2
"85904",42952000,1000,0.00272351,0,0,0,0,0
"85905",42952500,1000,0.00266389,0,0,0,0,0
"85906",42953000,1000,0.002673,0,0,0,1,1
"85907",42953500,1000,0.00278671,0,0,0,1,1
"85908",42954000,1000,0.00278899,0,0,0,1,1
"85909",42954500,1000,0.0028649,0,0,1,1,2
"85910",42955000,1000,0.00299112,0,0,1,0,1
"85911",42955500,1000,0.00304683,0,0,0,3,3
"85912",42956000,1000,0.003016,0,0,0,4,4
"85913",42956500,1000,0.00285399,0,0,1,2,3
"85914",42957000,1000,0.00268909,0,0,1,1,2
"85915",42957500,1000,0.00273528,0,0,0,1,1
"85916",42958000,1000,0.00278071,0,0,0,2,2
"85917",42958500,1000,0.00281569,0,0,0,5,5
"85918",42959000,1000,0.00289101,0,0,1,5,6
"85919",42959500,1000,0.00272798,0,0,1,1,2
"85920",42960000,1000,0.00265907,0,0,0,1,1
"85921",42960500,1000,0.00274494,0,0,0,3,3
"85922",42961000,1000,0.00273964,0,0,0,3,3
"85923",42961500,1000,0.0026925,0,0,0,2,2
"85924",42962000,1000,0.00273878,0,0,0,4,4
"85925",42962500,1000,0.00275114,0,0,0,3,3
"85926",42963000,1000,0.00264467,0,0,0,0,0
"85927",42963500,1000,0.00264347,0,0,0,0,0
"85928",42964000,1000,0.0026253,0,0,0,0,0
"85929",42964500,1000,0.00255159,0,0,0,1,1
"85930",42965000,1000,0.00269409,0,1,0,1,2
"85931",42965500,1000,0.00269841,0,1,0,0,1
"85932",42966000,1000,0.00271151,0,1,0,2,3
"85933",42966500,1000,0.00263688,0,1,0,2,3
"85934",42967000,1000,0.00217143,0,0,0,1,1
"85935",42967500,1000,0.00230213,0,0,1,2,3
"85936",42968000,1000,0.00279854,0,0,2,2,4
"85937",42968500,1000,0.00273991,0,0,1,1,2
"85938",42969000,1000,0.0025795,0,0,0,0,0
"85939",42969500,1000,0.0027124,0,0,0,2,2
"85940",42970000,1000,0.00278638,0,0,1,2,3
"85941",42970500,1000,0.00269956,0,0,1,1,2
"85942",42971000,1000,0.00277436,0,0,1,1,2
"85943",42971500,1000,0.00294224,0,0,2,1,3
"85944",42972000,1000,0.0028257,0,0,1,1,2
"85945",42972500,1000,0.00263349,0,0,0,0,0
"85946",42973000,1000,0.0025475,0,0,0,0,0
"85947",42973500,1000,0.00257984,0,0,0,0,0
"85948",42974000,1000,0.00267343,0,0,1,1,2
"85949",42974500,1000,0.00266368,0,0,1,2,3
"85950",42975000,1000,0.0026617,0,0,0,1,1
"85951",42975500,1000,0.00267375,0,0,0,0,0
"85952",42976000,1000,0.00278322,0,0,0,2,2
"85953",42976500,1000,0.0028562,0,0,1,4,5
"85954",42977000,1000,0.00281712,0,0,1,4,5
"85955",42977500,1000,0.0027319,0,0,0,3,3
"85956",42978000,1000,0.00271515,0,0,1,1,2
"85957",42978500,1000,0.00274534,0,0,1,0,1
"85958",42979000,1000,0.00270879,0,0,0,0,0
"85959",42979500,1000,0.00294637,0,1,0,1,2
"85960",42980000,1000,0.00294215,0,1,1,1,3
"85961",42980500,1000,0.00252886,0,0,1,0,1
"85962",42981000,1000,0.00251117,0,0,0,0,0
"85963",42981500,1000,0.00267898,0,0,0,1,1
"85964",42982000,1000,0.00267059,0,0,0,2,2
"85965",42982500,1000,0.0026461,0,0,0,1,1
"85966",42983000,1000,0.00263228,0,0,0,1,1
"85967",42983500,1000,0.00280554,0,0,1,3,4
"85968",42984000,1000,0.00297031,0,0,2,4,6
"85969",42984500,1000,0.00275166,0,0,1,2,3
"85970",42985000,1000,0.00273984,0,0,1,1,2
"85971",42985500,1000,0.00272355,0,0,1,1,2
"85972",42986000,1000,0.0026752,0,0,0,1,1
"85973",42986500,1000,0.00270915,0,0,0,2,2
"85974",42987000,1000,0.00263207,0,0,0,2,2
"85975",42987500,1000,0.00265511,0,0,0,1,1
"85976",42988000,1000,0.00273197,0,0,1,0,1
"85977",42988500,1000,0.0027467,0,0,1,0,1
"85978",42989000,1000,0.00266405,0,0,0,0,0
"85979",42989500,1000,0.00271828,0,0,1,1,2
"85980",42990000,1000,0.00271313,0,0,1,1,2
"85981",42990500,1000,0.00265456,0,0,0,0,0
"85982",42991000,1000,0.00269604,0,0,0,1,1
"85983",42991500,1000,0.00294323,0,0,1,1,2
"85984",42992000,1000,0.00298078,0,0,1,3,4
"85985",42992500,1000,0.00273171,0,0,0,3,3
"85986",42993000,1000,0.00271582,0,0,0,1,1
"85987",42993500,1000,0.00270126,0,0,0,1,1
"85988",42994000,1000,0.00263952,0,0,1,0,1
"85989",42994500,1000,0.00259863,0,0,1,0,1
"85990",42995000,1000,0.00258584,0,0,0,0,0
"85991",42995500,1000,0.00269444,0,0,0,2,2
"85992",42996000,1000,0.00283473,0,0,1,3,4
"85993",42996500,1000,0.00267161,0,0,1,1,2
"85994",42997000,1000,0.00257734,0,0,0,1,1
"85995",42997500,1000,0.00284297,0,0,1,2,3
"85996",42998000,1000,0.00274632,0,0,1,1,2
"85997",42998500,1000,0.00256435,0,0,0,0,0
"85998",42999000,1000,0.00275091,0,0,1,0,1
"85999",42999500,1000,0.0027958,0,0,1,0,1
"86000",43000000,1000,0.00269461,0,0,0,0,0
"86001",43000500,1000,0.00283502,0,0,1,2,3
"86002",43001000,1000,0.0030768,0,0,3,3,6
"86003",43001500,1000,0.00301742,0,0,2,2,4
"86004",43002000,1000,0.00271231,0,0,0,2,2
"86005",43002500,1000,0.0025605,0,0,0,1,1
"86006",43003000,1000,0.00266273,0,0,0,1,1
"86007",43003500,1000,0.0028904,0,0,0,3,3
"86008",43004000,1000,0.00293538,0,0,1,4,5
"86009",43004500,1000,0.00272775,0,0,1,2,3
"86010",43005000,1000,0.00267831,0,0,0,2,2
"86011",43005500,1000,0.00270614,0,0,0,2,2
"86012",43006000,1000,0.00269181,0,0,0,2,2
"86013",43006500,1000,0.00267364,0,0,0,2,2
"86014",43007000,1000,0.00267487,0,0,0,0,0
"86015",43007500,1000,0.00265538,0,0,0,1,1
"86016",43008000,1000,0.00269159,0,0,0,2,2
"86017",43008500,1000,0.00289376,0,0,2,3,5
"86018",43009000,1000,0.00275422,0,0,2,3,5
"86019",43009500,1000,0.00262198,0,0,0,2,2
"86020",43010000,1000,0.00268886,0,0,0,2,2
"86021",43010500,1000,0.00275946,0,0,0,1,1
"86022",43011000,1000,0.00282235,0,0,0,2,2
"86023",43011500,1000,0.00267627,0,0,0,2,2
"86024",43012000,1000,0.002735,0,0,0,2,2
"86025",43012500,1000,0.00279171,0,0,1,2,3
"86026",43013000,1000,0.00274917,0,0,1,0,1
"86027",43013500,1000,0.00282857,0,0,0,0,0
"86028",43014000,1000,0.00276837,0,0,0,0,0
"86029",43014500,1000,0.00281545,0,0,1,0,1
"86030",43015000,1000,0.00287479,0,0,1,0,1
"86031",43015500,1000,0.00282869,0,0,1,0,1
"86032",43016000,1000,0.00286965,0,0,1,1,2
"86033",43016500,1000,0.00295284,0,0,1,3,4
"86034",43017000,1000,0.00281063,0,0,1,3,4
"86035",43017500,1000,0.00268542,0,0,0,1,1
"86036",43018000,1000,0.00271923,0,0,0,1,1
"86037",43018500,1000,0.00275953,0,0,0,2,2
"86038",43019000,1000,0.00277284,0,0,0,1,1
"86039",43019500,1000,0.0026949,0,0,0,0,0
"86040",43020000,1000,0.00268413,0,0,0,0,0
"86041",43020500,1000,0.00268709,0,0,0,0,0
"86042",43021000,1000,0.00271466,0,0,0,0,0
"86043",43021500,1000,0.00265684,0,0,0,0,0
"86044",43022000,1000,0.00243183,0,0,0,0,0
"86045",43022500,1000,0.00262029,0,1,0,2,3
"86046",43023000,1000,0.00279181,0,1,0,3,4
"86047",43023500,1000,0.00263038,0,0,0,1,1
"86048",43024000,1000,0.0027058,0,0,1,0,1
"86049",43024500,1000,0.00269952,0,0,1,0,1
"86050",43025000,1000,0.00246697,0,0,0,0,0
"86051",43025500,1000,0.00251197,0,0,0,0,0
"86052",43026000,1000,0.00272354,0,0,0,2,2
"86053",43026500,1000,0.00275524,0,0,1,2,3
"86054",43027000,1000,0.00269763,0,0,1,1,2
"86055",43027500,1000,0.00261872,0,0,0,1,1
"86056",43028000,1000,0.00275953,0,0,1,0,1
"86057",43028500,1000,0.0028954,0,0,2,1,3
"86058",43029000,1000,0.00294847,0,1,1,3,5
"86059",43029500,1000,0.00293018,0,1,0,4,5
"86060",43030000,1000,0.00279722,0,0,0,3,3
"86061",43030500,1000,0.0027064,0,0,0,1,1
"86062",43031000,1000,0.00263076,0,0,0,0,0
"86063",43031500,1000,0.00261372,0,0,0,0,0
"86064",43032000,1000,0.00262089,0,0,0,0,0
"86065",43032500,1000,0.00280656,0,0,2,1,3
"86066",43033000,1000,0.0029898,0,0,3,3,6
"86067",43033500,1000,0.00285331,0,0,1,2,3
"86068",43034000,1000,0.00274651,0,0,0,0,0
"86069",43034500,1000,0.00270053,0,0,0,0,0
"86070",43035000,1000,0.0026214,0,0,0,0,0
"86071",43035500,1000,0.00263877,0,0,0,0,0
"86072",43036000,1000,0.00264904,0,0,0,0,0
"86073",43036500,1000,0.0025282,0,0,0,0,0
"86074",43037000,1000,0.00261544,0,0,1,1,2
"86075",43037500,1000,0.00271913,0,0,1,2,3
"86076",43038000,1000,0.00275677,0,0,1,1,2
"86077",43038500,1000,0.00280291,0,0,1,1,2
"86078",43039000,1000,0.0026566,0,0,0,1,1
"86079",43039500,1000,0.00265544,0,0,0,0,0
"86080",43040000,1000,0.00277269,0,0,1,1,2
"86081",43040500,1000,0.00277063,0,0,1,1,2
"86082",43041000,1000,0.00257094,0,0,0,0,0
"86083",43041500,1000,0.00256188,0,0,0,1,1
"86084",43042000,1000,0.00269513,0,0,0,2,2
"86085",43042500,1000,0.0027509,0,0,1,1,2
"86086",43043000,1000,0.00275809,0,0,1,1,2
"86087",43043500,1000,0.00270762,0,0,0,1,1
"86088",43044000,1000,0.00261471,0,0,0,0,0
"86089",43044500,1000,0.00258642,0,0,0,0,0
"86090",43045000,1000,0.00271954,0,0,1,0,1
"86091",43045500,1000,0.00276932,0,0,1,0,1
"86092",43046000,1000,0.00285028,0,0,1,1,2
"86093",43046500,1000,0.00277269,0,0,1,2,3
"86094",43047000,1000,0.00273292,0,0,0,4,4
"86095",43047500,1000,0.00276741,0,0,0,4,4
"86096",43048000,1000,0.00272866,0,0,1,1,2
"86097",43048500,1000,0.00273848,0,0,1,1,2
"86098",43049000,1000,0.00264274,0,0,0,1,1
"86099",43049500,1000,0.0026778,0,0,0,0,0
"86100",43050000,1000,0.0027138,0,0,0,1,1
"86101",43050500,1000,0.00266145,0,0,0,1,1
"86102",43051000,1000,0.00280517,0,0,1,0,1
"86103",43051500,1000,0.00291739,0,0,2,1,3
"86104",43052000,1000,0.00281924,0,0,1,1,2
"86105",43052500,1000,0.00267662,0,0,0,0,0
"86106",43053000,1000,0.00275282,0,0,1,2,3
"86107",43053500,1000,0.00281528,0,0,1,2,3
"86108",43054000,1000,0.00277881,0,0,1,0,1
"86109",43054500,1000,0.00284953,0,0,2,1,3
"86110",43055000,1000,0.00277952,0,0,1,1,2
"86111",43055500,1000,0.00266061,0,0,0,0,0
"86112",43056000,1000,0.00256835,0,0,0,0,0
"86113",43056500,1000,0.00262112,0,0,0,1,1
"86114",43057000,1000,0.00278759,0,0,1,2,3
"86115",43057500,1000,0.00283381,0,0,2,2,4
"86116",43058000,1000,0.00273249,0,0,1,1,2
"86117",43058500,1000,0.00260544,0,0,0,0,0
"86118",43059000,1000,0.00276349,0,0,0,1,1
"86119",43059500,1000,0.0027916,0,0,0,1,1
"86120",43060000,1000,0.00274775,0,0,0,3,3
"86121",43060500,1000,0.0029038,0,0,1,5,6
"86122",43061000,1000,0.00276177,0,0,1,2,3
"86123",43061500,1000,0.00271489,0,0,1,1,2
"86124",43062000,1000,0.00274657,0,0,1,1,2
"86125",43062500,1000,0.00271223,0,0,0,0,0
"86126",43063000,1000,0.00275469,0,0,0,1,1
"86127",43063500,1000,0.00276354,0,0,0,1,1
"86128",43064000,1000,0.00266189,0,0,0,0,0
"86129",43064500,1000,0.00257827,0,0,0,0,0
"86130",43065000,1000,0.00275083,0,0,1,1,2
"86131",43065500,1000,0.00284996,0,0,1,1,2
"86132",43066000,1000,0.00275284,0,0,0,1,1
"86133",43066500,1000,0.00280395,0,0,1,2,3
"86134",43067000,1000,0.00290347,0,0,2,3,5
"86135",43067500,1000,0.00269887,0,0,1,2,3
"86136",43068000,1000,0.00263357,0,0,1,2,3
"86137",43068500,1000,0.00261183,0,0,1,2,3
"86138",43069000,1000,0.00256852,0,0,0,1,1
"86139",43069500,1000,0.00267642,0,0,0,1,1
"86140",43070000,1000,0.0027038,0,0,0,2,2
"86141",43070500,1000,0.00260165,0,0,0,2,2
"86142",43071000,1000,0.00249328,0,0,0,0,0
"86143",43071500,1000,0.00259612,0,0,0,2,2
"86144",43072000,1000,0.00277352,0,1,0,2,3
"86145",43072500,1000,0.00278664,0,1,0,0,1
"86146",43073000,1000,0.00258257,0,0,0,1,1
"86147",43073500,1000,0.0026007,0,0,0,4,4
"86148",43074000,1000,0.00274171,0,0,0,3,3
"86149",43074500,1000,0.00283749,0,0,2,0,2
"86150",43075000,1000,0.00268491,0,0,2,1,3
"86151",43075500,1000,0.00257279,0,0,0,2,2
"86152",43076000,1000,0.0026901,0,0,0,2,2
"86153",43076500,1000,0.00251789,0,0,0,1,1
"86154",43077000,1000,0.00249243,0,0,0,0,0
"86155",43077500,1000,0.00270944,0,0,1,0,1
"86156",43078000,1000,0.00272808,0,0,1,1,2
"86157",43078500,1000,0.00266647,0,0,0,3,3
"86158",43079000,1000,0.00261508,0,0,0,2,2
"86159",43079500,1000,0.00250982,0,0,0,0,0
"86160",43080000,1000,0.00253401,0,0,0,0,0
"86161",43080500,1000,0.00274491,0,0,0,3,3
"86162",43081000,1000,0.00272654,0,0,0,3,3
"86163",43081500,1000,0.00263189,0,0,0,0,0
"86164",43082000,1000,0.00268059,0,0,0,0,0
"86165",43082500,1000,0.00266001,0,0,0,0,0
"86166",43083000,1000,0.00267202,0,0,0,3,3
"86167",43083500,1000,0.0026719,0,0,0,3,3
"86168",43084000,1000,0.00274161,0,0,0,3,3
"86169",43084500,1000,0.00276581,0,0,0,3,3
"86170",43085000,1000,0.00266105,0,0,0,0,0
"86171",43085500,1000,0.0026479,0,0,0,0,0
"86172",43086000,1000,0.00264728,0,0,1,0,1
"86173",43086500,1000,0.00261608,0,0,1,1,2
"86174",43087000,1000,0.00268179,0,0,1,2,3
"86175",43087500,1000,0.00270496,0,0,1,1,2
"86176",43088000,1000,0.00253389,0,0,0,0,0
"86177",43088500,1000,0.00249011,0,0,0,0,0
"86178",43089000,1000,0.00269758,0,0,1,1,2
"86179",43089500,1000,0.00274902,0,0,1,1,2
"86180",43090000,1000,0.00268439,0,0,0,1,1
"86181",43090500,1000,0.00267742,0,0,0,2,2
"86182",43091000,1000,0.00262259,0,0,0,1,1
"86183",43091500,1000,0.00255947,0,0,0,0,0
"86184",43092000,1000,0.00263653,0,0,0,1,1
"86185",43092500,1000,0.00269895,0,0,0,1,1
"86186",43093000,1000,0.00265331,0,0,0,0,0
"86187",43093500,1000,0.00263354,0,0,0,0,0
"86188",43094000,1000,0.00267391,0,0,0,0,0
"86189",43094500,1000,0.00262384,0,0,0,0,0
"86190",43095000,1000,0.00259727,0,0,0,1,1
"86191",43095500,1000,0.00257828,0,0,0,1,1
"86192",43096000,1000,0.00260474,0,0,0,1,1
"86193",43096500,1000,0.00262,0,0,0,1,1
"86194",43097000,1000,0.00250222,0,0,0,0,0
"86195",43097500,1000,0.00254892,0,0,0,1,1
"86196",43098000,1000,0.00266265,0,0,0,3,3
"86197",43098500,1000,0.00266108,0,0,0,3,3
"86198",43099000,1000,0.00264523,0,0,0,1,1
"86199",43099500,1000,0.00264111,0,0,0,0,0
"86200",43100000,1000,0.00263522,0,0,0,1,1
"86201",43100500,1000,0.00256422,0,0,0,2,2
"86202",43101000,1000,0.00249763,0,0,0,1,1
"86203",43101500,1000,0.0026362,0,0,0,2,2
"86204",43102000,1000,0.00276121,0,0,0,3,3
"86205",43102500,1000,0.0028481,0,0,0,4,4
"86206",43103000,1000,0.00289992,0,0,1,5,6
"86207",43103500,1000,0.00272712,0,0,1,3,4
"86208",43104000,1000,0.00255511,0,0,0,1,1
"86209",43104500,1000,0.00262045,0,0,0,0,0
"86210",43105000,1000,0.00259809,0,0,0,0,0
"86211",43105500,1000,0.00252677,0,0,0,0,0
"86212",43106000,1000,0.0024473,0,0,0,0,0
"86213",43106500,1000,0.00233163,0,0,0,0,0
"86214",43107000,1000,0.00255859,0,0,1,1,2
"86215",43107500,1000,0.00273096,0,0,1,1,2
"86216",43108000,1000,0.00268467,0,0,0,2,2
"86217",43108500,1000,0.00274713,0,0,0,4,4
"86218",43109000,1000,0.00289252,0,1,1,3,5
"86219",43109500,1000,0.00278326,0,1,1,1,3
"86220",43110000,1000,0.00274006,0,0,1,1,2
"86221",43110500,1000,0.00288848,0,0,2,1,3
"86222",43111000,1000,0.00275112,0,0,1,0,1
"86223",43111500,1000,0.0026671,0,0,1,1,2
"86224",43112000,1000,0.00276367,0,0,2,2,4
"86225",43112500,1000,0.00270202,0,0,1,1,2
"86226",43113000,1000,0.00271253,0,0,1,0,1
"86227",43113500,1000,0.00284177,0,0,1,2,3
"86228",43114000,1000,0.00264576,0,0,0,2,2
"86229",43114500,1000,0.00246126,0,0,0,0,0
"86230",43115000,1000,0.00264645,0,0,1,1,2
"86231",43115500,1000,0.00264997,0,0,1,1,2
"86232",43116000,1000,0.00254358,0,0,1,0,1
"86233",43116500,1000,0.00271896,0,0,1,2,3
"86234",43117000,1000,0.00265484,0,0,0,2,2
"86235",43117500,1000,0.00271453,0,1,0,1,2
"86236",43118000,1000,0.0028258,0,1,0,2,3
"86237",43118500,1000,0.00277625,0,0,0,3,3
"86238",43119000,1000,0.00274419,0,0,0,2,2
"86239",43119500,1000,0.00251205,0,0,0,0,0
"86240",43120000,1000,0.00237632,0,0,0,0,0
"86241",43120500,1000,0.00282291,0,1,0,1,2
"86242",43121000,1000,0.00320546,0,1,2,3,6
"86243",43121500,1000,0.00281299,0,0,2,2,4
"86244",43122000,1000,0.00246293,0,0,0,0,0
"86245",43122500,1000,0.00268725,0,0,0,3,3
"86246",43123000,1000,0.00277619,0,0,0,3,3
"86247",43123500,1000,0.00275571,0,0,1,1,2
"86248",43124000,1000,0.00270299,0,0,1,1,2
"86249",43124500,1000,0.00272406,0,0,1,1,2
"86250",43125000,1000,0.00276174,0,0,1,1,2
"86251",43125500,1000,0.00264441,0,0,1,0,1
"86252",43126000,1000,0.00263967,0,0,1,0,1
"86253",43126500,1000,0.00260359,0,0,0,1,1
"86254",43127000,1000,0.00264891,0,0,0,1,1
"86255",43127500,1000,0.00272999,0,0,1,0,1
"86256",43128000,1000,0.00277842,0,0,1,0,1
"86257",43128500,1000,0.00280182,0,0,0,1,1
"86258",43129000,1000,0.00272599,0,0,0,1,1
"86259",43129500,1000,0.00279274,0,0,2,0,2
"86260",43130000,1000,0.00273469,0,0,2,1,3
"86261",43130500,1000,0.00253988,0,0,0,2,2
"86262",43131000,1000,0.00254615,0,0,0,1,1
"86263",43131500,1000,0.00249931,0,0,0,0,0
"86264",43132000,1000,0.00255666,0,0,1,0,1
"86265",43132500,1000,0.0025931,0,0,1,0,1
"86266",43133000,1000,0.00251483,0,0,0,0,0
"86267",43133500,1000,0.00261709,0,0,0,2,2
"86268",43134000,1000,0.00275254,0,0,0,2,2
"86269",43134500,1000,0.00271433,0,0,0,1,1
"86270",43135000,1000,0.0026022,0,0,0,1,1
"86271",43135500,1000,0.00270522,0,0,0,1,1
"86272",43136000,1000,0.00274251,0,0,0,1,1
"86273",43136500,1000,0.00255437,0,0,0,1,1
"86274",43137000,1000,0.00260904,0,0,0,1,1
"86275",43137500,1000,0.00297789,0,1,0,3,4
"86276",43138000,1000,0.00292474,0,1,0,3,4
"86277",43138500,1000,0.00270285,0,0,0,0,0
"86278",43139000,1000,0.00258727,0,0,0,0,0
"86279",43139500,1000,0.00259822,0,0,1,1,2
"86280",43140000,1000,0.00281966,0,0,1,2,3
"86281",43140500,1000,0.00274741,0,0,0,1,1
"86282",43141000,1000,0.0026869,0,0,0,0,0
"86283",43141500,1000,0.00273037,0,0,1,1,2
"86284",43142000,1000,0.00286308,0,0,1,3,4
"86285",43142500,1000,0.00280167,0,0,0,3,3
"86286",43143000,1000,0.00258757,0,0,0,1,1
"86287",43143500,1000,0.00258977,0,0,0,0,0
"86288",43144000,1000,0.00273348,0,0,1,1,2
"86289",43144500,1000,0.00282919,0,0,2,2,4
"86290",43145000,1000,0.00269047,0,0,1,1,2
"86291",43145500,1000,0.00264613,0,0,1,1,2
"86292",43146000,1000,0.00265765,0,0,1,1,2
"86293",43146500,1000,0.00267806,0,0,1,1,2
"86294",43147000,1000,0.0028073,0,0,2,2,4
"86295",43147500,1000,0.00271752,0,0,1,1,2
"86296",43148000,1000,0.00254791,0,0,0,0,0
"86297",43148500,1000,0.00264464,0,0,0,1,1
"86298",43149000,1000,0.00271766,0,0,0,2,2
"86299",43149500,1000,0.0026238,0,0,0,1,1
"86300",43150000,1000,0.00275028,0,0,0,3,3
"86301",43150500,1000,0.00284674,0,0,0,4,4
"86302",43151000,1000,0.00281788,0,0,1,3,4
"86303",43151500,1000,0.00264817,0,0,1,2,3
"86304",43152000,1000,0.00259021,0,0,0,0,0
"86305",43152500,1000,0.0028143,0,0,1,2,3
"86306",43153000,1000,0.00291218,0,0,1,4,5
"86307",43153500,1000,0.00275143,0,0,0,2,2
"86308",43154000,1000,0.00275033,0,1,0,0,1
"86309",43154500,1000,0.0026964,0,1,0,0,1
"86310",43155000,1000,0.00263992,0,0,0,1,1
"86311",43155500,1000,0.00277203,0,0,0,2,2
"86312",43156000,1000,0.00285402,0,0,0,4,4
"86313",43156500,1000,0.00264729,0,0,0,3,3
"86314",43157000,1000,0.00256421,0,0,0,2,2
"86315",43157500,1000,0.00275981,0,0,0,2,2
"86316",43158000,1000,0.00259297,0,0,0,0,0
"86317",43158500,1000,0.00257934,0,0,1,0,1
"86318",43159000,1000,0.00273782,0,0,1,3,4
"86319",43159500,1000,0.0026975,0,0,0,3,3
"86320",43160000,1000,0.00257208,0,0,0,0,0
"86321",43160500,1000,0.00248097,0,0,0,0,0
"86322",43161000,1000,0.00256348,0,0,0,1,1
"86323",43161500,1000,0.00269539,0,0,0,1,1
"86324",43162000,1000,0.00264036,0,0,1,0,1
"86325",43162500,1000,0.00275115,0,0,1,2,3
"86326",43163000,1000,0.00281084,0,0,0,3,3
"86327",43163500,1000,0.00272288,0,0,0,1,1
"86328",43164000,1000,0.00267143,0,0,0,0,0
"86329",43164500,1000,0.00270284,0,0,0,0,0
"86330",43165000,1000,0.0025814,0,0,0,0,0
"86331",43165500,1000,0.002333,0,0,0,0,0
"86332",43166000,1000,0.00248298,0,0,0,0,0
"86333",43166500,1000,0.00275312,0,0,0,4,4
"86334",43167000,1000,0.00266388,0,0,0,4,4
"86335",43167500,1000,0.00275718,0,0,1,2,3
"86336",43168000,1000,0.00288511,0,0,1,3,4
"86337",43168500,1000,0.00258038,0,0,0,1,1
"86338",43169000,1000,0.00269706,0,0,1,1,2
"86339",43169500,1000,0.00274363,0,0,1,1,2
"86340",43170000,1000,0.00275785,0,1,0,1,2
"86341",43170500,1000,0.00275551,0,1,0,1,2
"86342",43171000,1000,0.00255444,0,0,0,0,0
"86343",43171500,1000,0.00268089,0,0,0,1,1
"86344",43172000,1000,0.0027093,0,0,0,1,1
"86345",43172500,1000,0.00251402,0,0,0,0,0
"86346",43173000,1000,0.00259437,0,0,1,2,3
"86347",43173500,1000,0.00274576,0,0,1,3,4
"86348",43174000,1000,0.00267614,0,0,1,2,3
"86349",43174500,1000,0.00271285,0,0,2,2,4
"86350",43175000,1000,0.00259927,0,0,1,1,2
"86351",43175500,1000,0.00246344,0,0,0,0,0
"86352",43176000,1000,0.00255903,0,0,0,0,0
"86353",43176500,1000,0.00254066,0,0,0,0,0
"86354",43177000,1000,0.00258562,0,0,0,1,1
"86355",43177500,1000,0.0026132,0,0,0,1,1
"86356",43178000,1000,0.00254234,0,0,0,0,0
"86357",43178500,1000,0.00261991,0,0,0,2,2
"86358",43179000,1000,0.00267837,0,0,0,2,2
"86359",43179500,1000,0.00266856,0,0,0,0,0
"86360",43180000,1000,0.00263824,0,0,0,0,0
"86361",43180500,1000,0.00259128,0,0,0,0,0
"86362",43181000,1000,0.0026981,0,0,0,2,2
"86363",43181500,1000,0.0027862,0,0,0,4,4
"86364",43182000,1000,0.00270747,0,0,0,3,3
"86365",43182500,1000,0.00272576,0,0,1,1,2
"86366",43183000,1000,0.00278655,0,0,1,1,2
"86367",43183500,1000,0.00272963,0,0,0,2,2
"86368",43184000,1000,0.00259851,0,0,0,1,1
"86369",43184500,1000,0.00275114,0,0,1,2,3
"86370",43185000,1000,0.00276783,0,0,1,3,4
"86371",43185500,1000,0.00258503,0,0,0,1,1
"86372",43186000,1000,0.00253949,0,0,0,0,0
"86373",43186500,1000,0.00258158,0,0,0,0,0
"86374",43187000,1000,0.0027649,0,0,1,2,3
"86375",43187500,1000,0.00286696,0,0,2,3,5
"86376",43188000,1000,0.00284656,0,0,1,3,4
"86377",43188500,1000,0.00268782,0,0,0,2,2
"86378",43189000,1000,0.00259485,0,0,0,0,0
"86379",43189500,1000,0.00270266,0,0,0,0,0
"86380",43190000,1000,0.00267499,0,0,0,0,0
"86381",43190500,1000,0.00266038,0,0,0,0,0
"86382",43191000,1000,0.00264908,0,0,0,0,0
"86383",43191500,1000,0.00267874,0,0,1,0,1
"86384",43192000,1000,0.0028328,0,0,2,1,3
"86385",43192500,1000,0.00282516,0,0,2,2,4
"86386",43193000,1000,0.00276727,0,0,1,1,2
"86387",43193500,1000,0.00266731,0,0,0,0,0
"86388",43194000,1000,0.00259446,0,0,0,0,0
"86389",43194500,1000,0.00260325,0,0,0,0,0
"86390",43195000,1000,0.00262444,0,0,0,0,0
"86391",43195500,1000,0.00269892,0,0,0,2,2
"86392",43196000,1000,0.00269849,0,0,0,2,2
"86393",43196500,1000,0.00262958,0,0,0,1,1
"86394",43197000,1000,0.0027266,0,0,0,3,3
"86395",43197500,1000,0.00276607,0,0,0,2,2
"86396",43198000,1000,0.00263,0,0,0,1,1
"86397",43198500,1000,0.00266898,0,0,0,2,2
"86398",43199000,1000,0.00268132,0,0,0,1,1
"86399",43199500,1000,0.0026758,0,0,1,0,1
"86400",43200000,1000,0.00276489,0,0,1,0,1
"86401",43200500,1000,0.00272558,0,0,0,0,0
"86402",43201000,1000,0.00264232,0,0,0,1,1
"86403",43201500,1000,0.00264199,0,0,0,2,2
"86404",43202000,1000,0.00266676,0,0,0,2,2
"86405",43202500,1000,0.0027116,0,0,0,2,2
"86406",43203000,1000,0.00275648,0,0,0,1,1
"86407",43203500,1000,0.00280633,0,0,1,0,1
"86408",43204000,1000,0.00278089,0,0,1,2,3
"86409",43204500,1000,0.00277406,0,0,1,3,4
"86410",43205000,1000,0.00290801,0,0,2,3,5
"86411",43205500,1000,0.00294362,0,0,2,4,6
"86412",43206000,1000,0.00280425,0,0,1,4,5
"86413",43206500,1000,0.00266757,0,0,0,3,3
"86414",43207000,1000,0.00270378,0,0,0,1,1
"86415",43207500,1000,0.00257733,0,0,0,0,0
"86416",43208000,1000,0.0024885,0,0,0,1,1
"86417",43208500,1000,0.0025863,0,0,0,1,1
"86418",43209000,1000,0.00266187,0,0,0,2,2
"86419",43209500,1000,0.00256909,0,0,0,2,2
"86420",43210000,1000,0.00251908,0,0,0,0,0
"86421",43210500,1000,0.00249103,0,0,0,0,0
"86422",43211000,1000,0.00252367,0,0,0,0,0
"86423",43211500,1000,0.00255958,0,0,0,0,0
"86424",43212000,1000,0.00260711,0,0,0,1,1
"86425",43212500,1000,0.00268965,0,0,0,1,1
"86426",43213000,1000,0.00270677,0,0,1,0,1
"86427",43213500,1000,0.00275962,0,0,1,0,1
"86428",43214000,1000,0.00274889,0,0,0,2,2
"86429",43214500,1000,0.00281667,0,0,0,4,4
"86430",43215000,1000,0.00280738,0,0,0,4,4
"86431",43215500,1000,0.00279482,0,0,0,3,3
"86432",43216000,1000,0.00277569,0,0,0,1,1
"86433",43216500,1000,0.00273523,0,0,1,0,1
"86434",43217000,1000,0.002753,0,0,1,1,2
"86435",43217500,1000,0.002919,0,0,1,3,4
"86436",43218000,1000,0.00305402,0,1,1,3,5
"86437",43218500,1000,0.00284518,0,1,0,1,2
"86438",43219000,1000,0.00278062,0,0,0,0,0
"86439",43219500,1000,0.00289106,0,0,1,0,1
"86440",43220000,1000,0.00279928,0,0,1,1,2
"86441",43220500,1000,0.00273607,0,0,0,1,1
"86442",43221000,1000,0.00277163,0,0,0,0,0
"86443",43221500,1000,0.00274633,0,0,0,0,0
"86444",43222000,1000,0.00273412,0,0,0,0,0
"86445",43222500,1000,0.00276801,0,0,0,1,1
"86446",43223000,1000,0.00270752,0,0,0,1,1
"86447",43223500,1000,0.00271862,0,0,0,0,0
"86448",43224000,1000,0.00270578,0,0,0,0,0
"86449",43224500,1000,0.00266753,0,0,0,0,0
"86450",43225000,1000,0.00275099,0,0,1,1,2
"86451",43225500,1000,0.00281364,0,0,2,2,4
"86452",43226000,1000,0.00277293,0,0,1,2,3
"86453",43226500,1000,0.00267775,0,0,0,2,2
"86454",43227000,1000,0.00269939,0,0,0,3,3
"86455",43227500,1000,0.00294841,0,0,1,4,5
"86456",43228000,1000,0.00292597,0,0,1,3,4
"86457",43228500,1000,0.0026239,0,0,0,2,2
"86458",43229000,1000,0.00259017,0,0,0,1,1
"86459",43229500,1000,0.00267148,0,0,0,1,1
"86460",43230000,1000,0.00272967,0,0,0,3,3
"86461",43230500,1000,0.00280394,0,0,1,4,5
"86462",43231000,1000,0.00271402,0,0,1,3,4
"86463",43231500,1000,0.00261633,0,0,0,1,1
"86464",43232000,1000,0.00251151,0,0,0,0,0
"86465",43232500,1000,0.00268142,0,1,0,0,1
"86466",43233000,1000,0.00294776,0,1,0,0,1
"86467",43233500,1000,0.00273461,0,0,0,0,0
"86468",43234000,1000,0.00246225,0,0,0,0,0
"86469",43234500,1000,0.00247753,0,0,0,0,0
"86470",43235000,1000,0.00248399,0,0,0,0,0
"86471",43235500,1000,0.00253961,0,0,0,0,0
"86472",43236000,1000,0.00274418,0,0,0,0,0
"86473",43236500,1000,0.00270323,0,0,0,0,0
"86474",43237000,1000,0.00273458,0,1,0,0,1
"86475",43237500,1000,0.00287664,0,1,0,1,2
"86476",43238000,1000,0.00275725,0,0,0,1,1
"86477",43238500,1000,0.00258166,0,0,0,0,0
"86478",43239000,1000,0.00284947,0,1,0,0,1
"86479",43239500,1000,0.0028626,0,1,0,0,1
"86480",43240000,1000,0.00257413,0,0,0,0,0
"86481",43240500,1000,0.00271236,0,0,0,0,0
"86482",43241000,1000,0.00267454,0,0,0,0,0
"86483",43241500,1000,0.00245679,0,0,0,0,0
"86484",43242000,1000,0.00248414,0,0,0,0,0
"86485",43242500,1000,0.0024593,0,0,0,0,0
"86486",43243000,1000,0.00256004,0,0,0,0,0
"86487",43243500,1000,0.00279335,0,0,0,0,0
"86488",43244000,1000,0.0026755,0,0,0,0,0
"86489",43244500,1000,0.00273616,0,1,0,0,1
"86490",43245000,1000,0.00291181,0,1,0,0,1
"86491",43245500,1000,0.0026673,0,0,0,0,0
"86492",43246000,1000,0.00246345,0,0,0,0,0
"86493",43246500,1000,0.00248704,0,0,0,0,0
"86494",43247000,1000,0.00246641,0,0,0,0,0
"86495",43247500,1000,0.00257476,0,0,0,0,0
"86496",43248000,1000,0.00278238,0,0,0,0,0
"86497",43248500,1000,0.00266022,0,0,0,0,0
"86498",43249000,1000,0.00270207,0,1,0,0,1
"86499",43249500,1000,0.00289869,0,1,0,2,3
"86500",43250000,1000,0.00270873,0,0,0,2,2
"86501",43250500,1000,0.00264242,0,1,0,0,1
"86502",43251000,1000,0.00283457,0,1,0,0,1
"86503",43251500,1000,0.00276135,0,0,0,0,0
"86504",43252000,1000,0.00245793,0,0,0,0,0
"86505",43252500,1000,0.00238611,0,0,0,0,0
"86506",43253000,1000,0.00265091,0,0,0,0,0
"86507",43253500,1000,0.00277838,0,0,0,0,0
"86508",43254000,1000,0.00264322,0,0,0,0,0
"86509",43254500,1000,0.00272147,0,1,0,0,1
"86510",43255000,1000,0.00286354,0,1,0,2,3
"86511",43255500,1000,0.00281078,0,0,0,2,2
"86512",43256000,1000,0.00269499,0,0,0,0,0
"86513",43256500,1000,0.00274519,0,1,0,0,1
"86514",43257000,1000,0.00270546,0,1,0,0,1
"86515",43257500,1000,0.00261138,0,0,0,0,0
"86516",43258000,1000,0.00275796,0,0,0,0,0
"86517",43258500,1000,0.00271266,0,0,0,0,0
"86518",43259000,1000,0.00256005,0,0,0,0,0
"86519",43259500,1000,0.00271587,0,1,0,0,1
"86520",43260000,1000,0.00278984,0,1,0,0,1
"86521",43260500,1000,0.00275327,0,1,0,0,1
"86522",43261000,1000,0.0027635,0,1,0,1,2
"86523",43261500,1000,0.00258924,0,0,0,1,1
"86524",43262000,1000,0.00260965,0,0,0,0,0
"86525",43262500,1000,0.00277594,0,0,0,0,0
"86526",43263000,1000,0.00269068,0,0,0,0,0
"86527",43263500,1000,0.00254407,0,0,0,0,0
"86528",43264000,1000,0.00277295,0,1,0,1,2
"86529",43264500,1000,0.00292051,0,1,0,2,3
"86530",43265000,1000,0.00266326,0,0,0,1,1
"86531",43265500,1000,0.00271303,0,1,0,0,1
"86532",43266000,1000,0.00291917,0,1,0,1,2
"86533",43266500,1000,0.00270325,0,0,0,1,1
"86534",43267000,1000,0.00251136,0,0,0,0,0
"86535",43267500,1000,0.00251783,0,0,0,0,0
"86536",43268000,1000,0.00246063,0,0,0,0,0
"86537",43268500,1000,0.00251383,0,0,0,0,0
"86538",43269000,1000,0.00270828,0,0,0,0,0
"86539",43269500,1000,0.00269434,0,0,0,0,0
"86540",43270000,1000,0.00255126,0,0,0,0,0
"86541",43270500,1000,0.00286328,0,1,0,0,1
"86542",43271000,1000,0.00294906,0,1,0,1,2
"86543",43271500,1000,0.00254831,0,0,0,1,1
"86544",43272000,1000,0.00265509,0,1,0,0,1
"86545",43272500,1000,0.00284627,0,1,0,0,1
"86546",43273000,1000,0.0026425,0,0,0,0,0
"86547",43273500,1000,0.00249001,0,0,0,0,0
"86548",43274000,1000,0.00247187,0,0,0,0,0
"86549",43274500,1000,0.00245397,0,0,0,0,0
"86550",43275000,1000,0.00259542,0,0,0,1,1
"86551",43275500,1000,0.00286899,0,0,1,3,4
"86552",43276000,1000,0.0028022,0,0,1,2,3
"86553",43276500,1000,0.00258622,0,0,0,0,0
"86554",43277000,1000,0.00284056,0,1,0,0,1
"86555",43277500,1000,0.00287673,0,1,0,0,1
"86556",43278000,1000,0.00251529,0,0,0,0,0
"86557",43278500,1000,0.00250047,0,0,0,0,0
"86558",43279000,1000,0.00248822,0,0,0,0,0
"86559",43279500,1000,0.00248123,0,0,0,0,0
"86560",43280000,1000,0.00270589,0,0,0,0,0
"86561",43280500,1000,0.00278195,0,0,0,0,0
"86562",43281000,1000,0.00263109,0,0,0,0,0
"86563",43281500,1000,0.00277547,0,1,0,1,2
"86564",43282000,1000,0.00289591,0,1,0,2,3
"86565",43282500,1000,0.00263679,0,0,0,1,1
"86566",43283000,1000,0.00271623,0,1,0,0,1
"86567",43283500,1000,0.00287274,0,1,0,0,1
"86568",43284000,1000,0.00265431,0,0,0,0,0
"86569",43284500,1000,0.00246388,0,0,0,0,0
"86570",43285000,1000,0.00248267,0,0,0,0,0
"86571",43285500,1000,0.00247118,0,0,0,0,0
"86572",43286000,1000,0.00258175,0,0,0,0,0
"86573",43286500,1000,0.00278243,0,0,0,0,0
"86574",43287000,1000,0.00266549,0,0,0,0,0
"86575",43287500,1000,0.00268757,0,1,0,0,1
"86576",43288000,1000,0.00287594,0,1,0,2,3
"86577",43288500,1000,0.00270735,0,0,0,2,2
"86578",43289000,1000,0.00269247,0,1,0,0,1
"86579",43289500,1000,0.00287556,0,1,0,0,1
"86580",43290000,1000,0.00272763,0,0,0,0,0
"86581",43290500,1000,0.00246222,0,0,0,0,0
"86582",43291000,1000,0.00250716,0,0,0,0,0
"86583",43291500,1000,0.00253904,0,0,0,0,0
"86584",43292000,1000,0.00256691,0,0,0,0,0
"86585",43292500,1000,0.00273589,0,0,0,0,0
"86586",43293000,1000,0.00269785,0,0,0,0,0
"86587",43293500,1000,0.00275112,0,1,0,0,1
"86588",43294000,1000,0.00287916,0,1,0,2,3
"86589",43294500,1000,0.0027126,0,0,0,2,2
"86590",43295000,1000,0.00254159,0,0,0,0,0
"86591",43295500,1000,0.00282811,0,1,0,0,1
"86592",43296000,1000,0.00286937,0,1,0,0,1
"86593",43296500,1000,0.00251045,0,0,0,0,0
"86594",43297000,1000,0.00247814,0,0,0,0,0
"86595",43297500,1000,0.00250501,0,0,0,0,0
"86596",43298000,1000,0.0025918,0,0,0,0,0
"86597",43298500,1000,0.00262929,0,0,0,0,0
"86598",43299000,1000,0.00284808,0,1,0,0,1
"86599",43299500,1000,0.00288851,0,1,0,0,1
"86600",43300000,1000,0.00252434,0,0,0,0,0
"86601",43300500,1000,0.00249364,0,0,0,0,0
"86602",43301000,1000,0.00249055,0,0,0,0,0
"86603",43301500,1000,0.00255536,0,0,0,0,0
"86604",43302000,1000,0.00285494,0,0,1,3,4
"86605",43302500,1000,0.00288592,0,0,1,3,4
"86606",43303000,1000,0.00267202,0,0,0,2,2
"86607",43303500,1000,0.00257046,0,0,0,2,2
"86608",43304000,1000,0.00261036,0,0,0,0,0
"86609",43304500,1000,0.00273628,0,0,0,2,2
"86610",43305000,1000,0.00286203,0,0,1,5,6
"86611",43305500,1000,0.00275784,0,0,1,3,4
"86612",43306000,1000,0.00255394,0,0,0,1,1
"86613",43306500,1000,0.00262519,0,0,0,3,3
"86614",43307000,1000,0.00272731,0,0,0,3,3
"86615",43307500,1000,0.00271925,0,0,0,2,2
"86616",43308000,1000,0.00266513,0,0,0,1,1
"86617",43308500,1000,0.00273106,0,0,0,2,2
"86618",43309000,1000,0.0027006,0,0,0,2,2
"86619",43309500,1000,0.00262515,0,0,0,2,2
"86620",43310000,1000,0.0027856,0,0,1,3,4
"86621",43310500,1000,0.00273527,0,0,1,2,3
"86622",43311000,1000,0.00263933,0,0,1,2,3
"86623",43311500,1000,0.00285205,0,1,1,3,5
"86624",43312000,1000,0.0028837,0,1,0,2,3
"86625",43312500,1000,0.00269973,0,0,0,1,1
"86626",43313000,1000,0.00264491,0,0,0,1,1
"86627",43313500,1000,0.00256499,0,0,0,0,0
"86628",43314000,1000,0.00257667,0,0,1,0,1
"86629",43314500,1000,0.00275658,0,0,1,1,2
"86630",43315000,1000,0.00263836,0,0,0,1,1
"86631",43315500,1000,0.00247908,0,0,0,0,0
"86632",43316000,1000,0.00253609,0,0,0,0,0
"86633",43316500,1000,0.00262486,0,0,0,0,0
"86634",43317000,1000,0.00264906,0,0,0,0,0
"86635",43317500,1000,0.00280194,0,0,0,2,2
"86636",43318000,1000,0.00275397,0,0,0,2,2
"86637",43318500,1000,0.00250425,0,0,0,0,0
"86638",43319000,1000,0.0026468,0,0,1,1,2
"86639",43319500,1000,0.00279201,0,0,1,2,3
"86640",43320000,1000,0.00272625,0,0,0,1,1
"86641",43320500,1000,0.00281346,0,0,0,2,2
"86642",43321000,1000,0.00278743,0,0,0,3,3
"86643",43321500,1000,0.00268098,0,0,0,3,3
"86644",43322000,1000,0.00285035,0,0,1,3,4
"86645",43322500,1000,0.00272609,0,0,1,1,2
"86646",43323000,1000,0.00265753,0,0,0,0,0
"86647",43323500,1000,0.0027774,0,0,0,0,0
"86648",43324000,1000,0.00262055,0,0,0,0,0
"86649",43324500,1000,0.00266061,0,0,0,0,0
"86650",43325000,1000,0.00270831,0,0,0,0,0
"86651",43325500,1000,0.00264347,0,0,0,0,0
"86652",43326000,1000,0.00262004,0,0,0,0,0
"86653",43326500,1000,0.0025535,0,0,0,0,0
"86654",43327000,1000,0.00272317,0,0,0,2,2
"86655",43327500,1000,0.00275129,0,0,0,2,2
"86656",43328000,1000,0.00262133,0,0,0,0,0
"86657",43328500,1000,0.00262217,0,0,0,1,1
"86658",43329000,1000,0.0026637,0,0,0,1,1
"86659",43329500,1000,0.00261123,0,0,0,0,0
"86660",43330000,1000,0.00261825,0,0,0,0,0
"86661",43330500,1000,0.00270997,0,0,0,1,1
"86662",43331000,1000,0.00273855,0,0,0,2,2
"86663",43331500,1000,0.00290587,0,0,1,2,3
"86664",43332000,1000,0.00294385,0,0,1,1,2
"86665",43332500,1000,0.00270255,0,0,0,0,0
"86666",43333000,1000,0.00262483,0,0,0,0,0
"86667",43333500,1000,0.0027437,0,0,0,0,0
"86668",43334000,1000,0.00282132,0,0,0,0,0
"86669",43334500,1000,0.00268312,0,0,0,0,0
"86670",43335000,1000,0.0026137,0,0,0,0,0
"86671",43335500,1000,0.00261428,0,0,0,0,0
"86672",43336000,1000,0.00256988,0,0,0,0,0
"86673",43336500,1000,0.00263125,0,0,0,0,0
"86674",43337000,1000,0.00271472,0,0,0,1,1
"86675",43337500,1000,0.00290051,0,0,0,3,3
"86676",43338000,1000,0.0028264,0,0,0,2,2
"86677",43338500,1000,0.00279835,0,0,0,1,1
"86678",43339000,1000,0.00273499,0,0,0,1,1
"86679",43339500,1000,0.00250857,0,0,0,0,0
"86680",43340000,1000,0.00256101,0,0,0,1,1
"86681",43340500,1000,0.00264609,0,0,0,1,1
"86682",43341000,1000,0.00281772,0,0,1,0,1
"86683",43341500,1000,0.00279135,0,0,1,0,1
"86684",43342000,1000,0.00264712,0,0,0,0,0
"86685",43342500,1000,0.00265191,0,0,0,0,0
"86686",43343000,1000,0.00267734,0,0,0,1,1
"86687",43343500,1000,0.0027039,0,0,0,1,1
"86688",43344000,1000,0.00264709,0,0,0,0,0
"86689",43344500,1000,0.00263271,0,0,0,0,0
"86690",43345000,1000,0.00266223,0,0,0,1,1
"86691",43345500,1000,0.00266967,0,0,0,1,1
"86692",43346000,1000,0.00250412,0,0,0,0,0
"86693",43346500,1000,0.0024057,0,0,0,0,0
"86694",43347000,1000,0.00271827,0,0,0,1,1
"86695",43347500,1000,0.00281533,0,0,1,1,2
"86696",43348000,1000,0.00262253,0,0,1,0,1
"86697",43348500,1000,0.0026396,0,0,0,1,1
"86698",43349000,1000,0.00269527,0,0,0,1,1
"86699",43349500,1000,0.00277298,0,0,1,0,1
"86700",43350000,1000,0.00273783,0,0,1,1,2
"86701",43350500,1000,0.00275872,0,0,1,2,3
"86702",43351000,1000,0.00287191,0,0,1,1,2
"86703",43351500,1000,0.00273385,0,0,0,1,1
"86704",43352000,1000,0.00267047,0,0,0,1,1
"86705",43352500,1000,0.0026438,0,0,0,0,0
"86706",43353000,1000,0.00266249,0,0,0,1,1
"86707",43353500,1000,0.00267415,0,0,0,2,2
"86708",43354000,1000,0.00257589,0,0,0,2,2
"86709",43354500,1000,0.00258921,0,0,0,2,2
"86710",43355000,1000,0.00263888,0,0,0,2,2
"86711",43355500,1000,0.0027356,0,0,0,2,2
"86712",43356000,1000,0.00259579,0,0,0,1,1
"86713",43356500,1000,0.00267908,0,0,0,2,2
"86714",43357000,1000,0.00285619,0,0,0,2,2
"86715",43357500,1000,0.00274407,0,0,0,2,2
"86716",43358000,1000,0.00281061,0,0,0,2,2
"86717",43358500,1000,0.00275708,0,0,0,1,1
"86718",43359000,1000,0.00269765,0,0,0,2,2
"86719",43359500,1000,0.00264931,0,0,0,1,1
"86720",43360000,1000,0.00253741,0,0,0,0,0
"86721",43360500,1000,0.00253391,0,0,0,0,0
"86722",43361000,1000,0.00266406,0,0,1,0,1
"86723",43361500,1000,0.00277079,0,0,2,0,2
"86724",43362000,1000,0.00277574,0,0,2,1,3
"86725",43362500,1000,0.00282147,0,1,1,1,3
"86726",43363000,1000,0.002682,0,1,0,0,1
"86727",43363500,1000,0.00264316,0,0,0,0,0
"86728",43364000,1000,0.00272379,0,0,0,1,1
"86729",43364500,1000,0.0026834,0,0,0,1,1
"86730",43365000,1000,0.00263881,0,0,0,0,0
"86731",43365500,1000,0.00253602,0,0,0,0,0
"86732",43366000,1000,0.00251772,0,0,0,0,0
"86733",43366500,1000,0.00263563,0,0,0,0,0
"86734",43367000,1000,0.00261095,0,0,0,0,0
"86735",43367500,1000,0.00250576,0,0,0,0,0
"86736",43368000,1000,0.00255452,0,0,1,0,1
"86737",43368500,1000,0.00270413,0,0,2,1,3
"86738",43369000,1000,0.00269562,0,0,1,1,2
"86739",43369500,1000,0.00270606,0,0,0,2,2
"86740",43370000,1000,0.00287443,0,0,1,2,3
"86741",43370500,1000,0.00284769,0,0,1,2,3
"86742",43371000,1000,0.00269846,0,0,0,2,2
"86743",43371500,1000,0.00263253,0,0,0,0,0
"86744",43372000,1000,0.00273792,0,0,1,0,1
"86745",43372500,1000,0.00280041,0,0,1,0,1
"86746",43373000,1000,0.00276745,0,0,0,3,3
"86747",43373500,1000,0.00276043,0,0,0,5,5
"86748",43374000,1000,0.00270761,0,0,0,2,2
"86749",43374500,1000,0.00269125,0,0,0,2,2
"86750",43375000,1000,0.00274551,0,0,0,2,2
"86751",43375500,1000,0.00276605,0,0,0,2,2
"86752",43376000,1000,0.00280574,0,0,0,4,4
"86753",43376500,1000,0.00270055,0,0,0,2,2
"86754",43377000,1000,0.00269476,0,0,0,1,1
"86755",43377500,1000,0.00279045,0,0,0,2,2
"86756",43378000,1000,0.00268988,0,0,0,1,1
"86757",43378500,1000,0.00276595,0,0,0,3,3
"86758",43379000,1000,0.0026986,0,0,0,3,3
"86759",43379500,1000,0.00259179,0,0,0,1,1
"86760",43380000,1000,0.00274372,0,0,0,2,2
"86761",43380500,1000,0.0027063,0,0,0,1,1
"86762",43381000,1000,0.00267985,0,0,0,0,0
"86763",43381500,1000,0.00272252,0,0,0,1,1
"86764",43382000,1000,0.00269286,0,0,0,1,1
"86765",43382500,1000,0.00282713,0,0,0,4,4
"86766",43383000,1000,0.00287106,0,0,0,4,4
"86767",43383500,1000,0.00277896,0,0,0,0,0
"86768",43384000,1000,0.00274933,0,0,0,0,0
"86769",43384500,1000,0.00280175,0,0,0,1,1
"86770",43385000,1000,0.00277348,0,0,0,1,1
"86771",43385500,1000,0.00270774,0,0,0,0,0
"86772",43386000,1000,0.00260011,0,0,0,0,0
"86773",43386500,1000,0.00277189,0,0,1,1,2
"86774",43387000,1000,0.0028556,0,0,1,1,2
"86775",43387500,1000,0.00280015,0,0,1,3,4
"86776",43388000,1000,0.00276606,0,0,1,3,4
"86777",43388500,1000,0.0026467,0,0,0,0,0
"86778",43389000,1000,0.0026181,0,0,0,0,0
"86779",43389500,1000,0.00253413,0,0,0,1,1
"86780",43390000,1000,0.00259128,0,0,0,2,2
"86781",43390500,1000,0.00259883,0,0,0,2,2
"86782",43391000,1000,0.0025955,0,0,0,1,1
"86783",43391500,1000,0.00260993,0,0,0,0,0
"86784",43392000,1000,0.00289344,0,1,0,2,3
"86785",43392500,1000,0.003131,0,1,1,3,5
"86786",43393000,1000,0.00287865,0,0,1,1,2
"86787",43393500,1000,0.00266705,0,0,0,1,1
"86788",43394000,1000,0.00264097,0,0,0,1,1
"86789",43394500,1000,0.00263442,0,0,0,1,1
"86790",43395000,1000,0.00270897,0,0,0,1,1
"86791",43395500,1000,0.00272077,0,0,0,2,2
"86792",43396000,1000,0.00261533,0,0,0,2,2
"86793",43396500,1000,0.00261334,0,0,0,0,0
"86794",43397000,1000,0.00265127,0,0,0,0,0
"86795",43397500,1000,0.00270282,0,0,0,2,2
"86796",43398000,1000,0.00283675,0,0,2,3,5
"86797",43398500,1000,0.00295969,0,1,2,1,4
"86798",43399000,1000,0.00280188,0,1,0,0,1
"86799",43399500,1000,0.00257794,0,0,0,0,0
"86800",43400000,1000,0.0029285,0,1,0,0,1
"86801",43400500,1000,0.00289147,0,1,0,1,2
"86802",43401000,1000,0.00253357,0,0,0,1,1
"86803",43401500,1000,0.00268976,0,0,0,1,1
"86804",43402000,1000,0.00277589,0,0,0,1,1
"86805",43402500,1000,0.00272361,0,0,0,0,0
"86806",43403000,1000,0.00269583,0,0,0,1,1
"86807",43403500,1000,0.00271385,0,0,0,1,1
"86808",43404000,1000,0.00278541,0,0,0,0,0
"86809",43404500,1000,0.00287658,0,0,2,1,3
"86810",43405000,1000,0.00281961,0,0,2,3,5
"86811",43405500,1000,0.00257981,0,0,0,2,2
"86812",43406000,1000,0.00255226,0,0,0,0,0
"86813",43406500,1000,0.00264862,0,0,0,0,0
"86814",43407000,1000,0.00262684,0,0,0,0,0
"86815",43407500,1000,0.00262239,0,0,0,0,0
"86816",43408000,1000,0.00273625,0,0,0,0,0
"86817",43408500,1000,0.00269412,0,0,0,1,1
"86818",43409000,1000,0.00274859,0,0,0,2,2
"86819",43409500,1000,0.00280904,0,0,0,1,1
"86820",43410000,1000,0.0027395,0,0,1,0,1
"86821",43410500,1000,0.0027623,0,0,1,0,1
"86822",43411000,1000,0.00271613,0,0,0,1,1
"86823",43411500,1000,0.00271261,0,0,0,1,1
"86824",43412000,1000,0.00280204,0,0,0,1,1
"86825",43412500,1000,0.00272066,0,0,0,1,1
"86826",43413000,1000,0.0025739,0,0,0,1,1
"86827",43413500,1000,0.0026022,0,0,0,2,2
"86828",43414000,1000,0.00267841,0,0,0,3,3
"86829",43414500,1000,0.00273774,0,0,0,2,2
"86830",43415000,1000,0.00262336,0,0,0,0,0
"86831",43415500,1000,0.00264763,0,0,0,2,2
"86832",43416000,1000,0.00276968,0,0,0,2,2
"86833",43416500,1000,0.00277984,0,0,0,1,1
"86834",43417000,1000,0.00278279,0,0,0,1,1
"86835",43417500,1000,0.00273823,0,0,0,1,1
"86836",43418000,1000,0.00287384,0,1,0,1,2
"86837",43418500,1000,0.00286271,0,1,0,2,3
"86838",43419000,1000,0.00273963,0,0,0,2,2
"86839",43419500,1000,0.00279738,0,1,0,0,1
"86840",43420000,1000,0.00287156,0,1,0,3,4
"86841",43420500,1000,0.00279786,0,0,0,3,3
"86842",43421000,1000,0.00260382,0,0,0,1,1
"86843",43421500,1000,0.00273343,0,0,1,3,4
"86844",43422000,1000,0.00278629,0,0,1,4,5
"86845",43422500,1000,0.00266474,0,0,0,4,4
"86846",43423000,1000,0.00282562,0,1,0,3,4
"86847",43423500,1000,0.00283309,0,1,0,1,2
"86848",43424000,1000,0.00269605,0,0,0,2,2
"86849",43424500,1000,0.00265291,0,0,0,2,2
"86850",43425000,1000,0.0027089,0,0,0,2,2
"86851",43425500,1000,0.00270576,0,0,0,2,2
"86852",43426000,1000,0.00270971,0,0,0,2,2
"86853",43426500,1000,0.00267864,0,0,0,2,2
"86854",43427000,1000,0.00271455,0,0,2,0,2
"86855",43427500,1000,0.00271517,0,0,2,0,2
"86856",43428000,1000,0.00256259,0,0,0,0,0
"86857",43428500,1000,0.00261477,0,0,0,1,1
"86858",43429000,1000,0.002724,0,0,0,2,2
"86859",43429500,1000,0.00272238,0,0,0,2,2
"86860",43430000,1000,0.0025903,0,0,0,1,1
"86861",43430500,1000,0.00262827,0,0,0,0,0
"86862",43431000,1000,0.0027406,0,0,0,0,0
"86863",43431500,1000,0.00269472,0,0,0,0,0
"86864",43432000,1000,0.0028883,0,1,0,0,1
"86865",43432500,1000,0.00301636,0,1,0,2,3
"86866",43433000,1000,0.00281935,0,0,0,4,4
"86867",43433500,1000,0.00276694,0,0,0,3,3
"86868",43434000,1000,0.00277182,0,0,1,2,3
"86869",43434500,1000,0.00271768,0,0,1,1,2
"86870",43435000,1000,0.00273787,0,0,0,0,0
"86871",43435500,1000,0.00273041,0,0,0,1,1
"86872",43436000,1000,0.00262631,0,0,0,1,1
"86873",43436500,1000,0.00266823,0,0,0,1,1
"86874",43437000,1000,0.00264745,0,0,0,3,3
"86875",43437500,1000,0.00255099,0,0,0,3,3
"86876",43438000,1000,0.00253452,0,0,0,1,1
"86877",43438500,1000,0.00269861,0,0,1,0,1
"86878",43439000,1000,0.00281388,0,0,1,2,3
"86879",43439500,1000,0.00275466,0,0,1,3,4
"86880",43440000,1000,0.00265392,0,0,1,1,2
"86881",43440500,1000,0.00280523,0,1,0,0,1
"86882",43441000,1000,0.00285944,0,1,0,2,3
"86883",43441500,1000,0.00273757,0,0,1,2,3
"86884",43442000,1000,0.0027469,0,0,1,1,2
"86885",43442500,1000,0.00261185,0,0,0,1,1
"86886",43443000,1000,0.00262958,0,0,0,1,1
"86887",43443500,1000,0.0027799,0,0,0,1,1
"86888",43444000,1000,0.00281102,0,0,0,1,1
"86889",43444500,1000,0.00277602,0,0,0,2,2
"86890",43445000,1000,0.00255661,0,0,0,1,1
"86891",43445500,1000,0.00255418,0,0,0,2,2
"86892",43446000,1000,0.00279834,0,1,0,3,4
"86893",43446500,1000,0.00264553,0,1,0,1,2
"86894",43447000,1000,0.00254595,0,0,0,1,1
"86895",43447500,1000,0.00257524,0,0,0,1,1
"86896",43448000,1000,0.00258593,0,0,0,0,0
"86897",43448500,1000,0.00277565,0,0,0,3,3
"86898",43449000,1000,0.00274714,0,0,0,3,3
"86899",43449500,1000,0.00257307,0,0,0,0,0
"86900",43450000,1000,0.00259698,0,0,0,1,1
"86901",43450500,1000,0.00263617,0,0,0,3,3
"86902",43451000,1000,0.00257311,0,0,0,2,2
"86903",43451500,1000,0.00258168,0,0,0,0,0
"86904",43452000,1000,0.00247795,0,0,0,0,0
"86905",43452500,1000,0.00244429,0,0,0,0,0
"86906",43453000,1000,0.0025895,0,0,0,0,0
"86907",43453500,1000,0.00273378,0,0,0,1,1
"86908",43454000,1000,0.002642,0,0,0,1,1
"86909",43454500,1000,0.00261525,0,0,0,1,1
"86910",43455000,1000,0.00267698,0,0,0,1,1
"86911",43455500,1000,0.00260015,0,0,0,0,0
"86912",43456000,1000,0.00265828,0,0,0,1,1
"86913",43456500,1000,0.00267112,0,0,0,1,1
"86914",43457000,1000,0.00268415,0,0,0,1,1
"86915",43457500,1000,0.00263544,0,0,0,1,1
"86916",43458000,1000,0.00271165,0,0,1,1,2
"86917",43458500,1000,0.0027311,0,0,1,1,2
"86918",43459000,1000,0.00270816,0,0,0,1,1
"86919",43459500,1000,0.00277706,0,0,0,3,3
"86920",43460000,1000,0.00267462,0,0,0,2,2
"86921",43460500,1000,0.00265349,0,0,1,0,1
"86922",43461000,1000,0.00271868,0,0,1,1,2
"86923",43461500,1000,0.00277905,0,0,1,2,3
"86924",43462000,1000,0.00278488,0,0,1,1,2
"86925",43462500,1000,0.00272718,0,0,0,0,0
"86926",43463000,1000,0.00269806,0,0,0,2,2
"86927",43463500,1000,0.00263756,0,0,0,3,3
"86928",43464000,1000,0.00256845,0,0,0,1,1
"86929",43464500,1000,0.00278733,0,1,0,1,2
"86930",43465000,1000,0.00293873,0,1,1,2,4
"86931",43465500,1000,0.00283747,0,0,1,1,2
"86932",43466000,1000,0.00278666,0,0,0,1,1
"86933",43466500,1000,0.00277635,0,0,0,3,3
"86934",43467000,1000,0.00268988,0,0,0,3,3
"86935",43467500,1000,0.0027281,0,0,1,1,2
"86936",43468000,1000,0.00279903,0,0,1,0,1
"86937",43468500,1000,0.00261831,0,0,0,0,0
"86938",43469000,1000,0.0025846,0,0,0,0,0
"86939",43469500,1000,0.00259418,0,0,0,0,0
"86940",43470000,1000,0.00269319,0,0,1,1,2
"86941",43470500,1000,0.00272144,0,0,1,3,4
"86942",43471000,1000,0.00256649,0,0,0,2,2
"86943",43471500,1000,0.00254535,0,0,0,0,0
"86944",43472000,1000,0.00258048,0,0,0,0,0
"86945",43472500,1000,0.00261901,0,0,0,1,1
"86946",43473000,1000,0.00281611,0,0,0,5,5
"86947",43473500,1000,0.00282143,0,0,0,4,4
"86948",43474000,1000,0.00277697,0,0,1,1,2
"86949",43474500,1000,0.00278433,0,0,1,1,2
"86950",43475000,1000,0.00264522,0,0,0,1,1
"86951",43475500,1000,0.00265651,0,0,0,2,2
"86952",43476000,1000,0.00278342,0,0,0,1,1
"86953",43476500,1000,0.00271646,0,0,0,0,0
"86954",43477000,1000,0.00267043,0,0,0,2,2
"86955",43477500,1000,0.00268151,0,0,0,2,2
"86956",43478000,1000,0.00257712,0,0,0,0,0
"86957",43478500,1000,0.00264582,0,0,0,1,1
"86958",43479000,1000,0.00290982,0,0,2,3,5
"86959",43479500,1000,0.00281801,0,0,2,2,4
"86960",43480000,1000,0.00257897,0,0,0,1,1
"86961",43480500,1000,0.00264239,0,0,0,2,2
"86962",43481000,1000,0.00268079,0,0,1,2,3
"86963",43481500,1000,0.00259282,0,0,1,1,2
"86964",43482000,1000,0.00270178,0,0,0,1,1
"86965",43482500,1000,0.00280788,0,0,0,3,3
"86966",43483000,1000,0.00283469,0,0,2,3,5
"86967",43483500,1000,0.00273598,0,0,2,1,3
"86968",43484000,1000,0.00256427,0,0,0,0,0
"86969",43484500,1000,0.00272902,0,0,0,1,1
"86970",43485000,1000,0.00283262,0,0,1,1,2
"86971",43485500,1000,0.00276523,0,0,1,2,3
"86972",43486000,1000,0.00260732,0,0,0,2,2
"86973",43486500,1000,0.00267315,0,0,1,1,2
"86974",43487000,1000,0.0028242,0,1,1,1,3
"86975",43487500,1000,0.00286803,0,1,0,3,4
"86976",43488000,1000,0.0028107,0,0,0,5,5
"86977",43488500,1000,0.00263663,0,0,0,2,2
"86978",43489000,1000,0.00257555,0,0,0,0,0
"86979",43489500,1000,0.0026192,0,0,1,1,2
"86980",43490000,1000,0.00262161,0,0,1,1,2
"86981",43490500,1000,0.00262175,0,0,0,2,2
"86982",43491000,1000,0.00255652,0,0,0,2,2
"86983",43491500,1000,0.002483,0,0,0,0,0
"86984",43492000,1000,0.00263498,0,0,0,1,1
"86985",43492500,1000,0.0026895,0,0,0,1,1
"86986",43493000,1000,0.00257452,0,0,0,0,0
"86987",43493500,1000,0.00270988,0,0,0,1,1
"86988",43494000,1000,0.00279109,0,0,0,2,2
"86989",43494500,1000,0.00267973,0,0,0,2,2
"86990",43495000,1000,0.00262244,0,0,0,1,1
"86991",43495500,1000,0.00263795,0,0,0,1,1
"86992",43496000,1000,0.00257407,0,0,0,1,1
"86993",43496500,1000,0.0025108,0,0,0,0,0
"86994",43497000,1000,0.0024542,0,0,0,0,0
"86995",43497500,1000,0.00244984,0,0,0,1,1
"86996",43498000,1000,0.00270945,0,0,1,1,2
"86997",43498500,1000,0.00287576,0,0,1,1,2
"86998",43499000,1000,0.00267327,0,0,0,1,1
"86999",43499500,1000,0.00253173,0,0,0,0,0
"87000",43500000,1000,0.00267154,0,0,1,0,1
"87001",43500500,1000,0.00279367,0,0,2,1,3
"87002",43501000,1000,0.00273295,0,0,1,1,2
"87003",43501500,1000,0.00268548,0,0,0,1,1
"87004",43502000,1000,0.00269057,0,0,0,2,2
"87005",43502500,1000,0.00266222,0,0,1,1,2
"87006",43503000,1000,0.00268614,0,0,1,2,3
"87007",43503500,1000,0.00261662,0,0,0,2,2
"87008",43504000,1000,0.00266483,0,0,1,2,3
"87009",43504500,1000,0.00264099,0,0,1,2,3
"87010",43505000,1000,0.00262261,0,0,0,1,1
"87011",43505500,1000,0.00266613,0,0,0,1,1
"87012",43506000,1000,0.00276101,0,0,1,2,3
"87013",43506500,1000,0.00265978,0,0,1,2,3
"87014",43507000,1000,0.00255071,0,0,0,0,0
"87015",43507500,1000,0.00283539,0,0,0,2,2
"87016",43508000,1000,0.00276425,0,0,0,2,2
"87017",43508500,1000,0.00271894,0,0,2,1,3
"87018",43509000,1000,0.00273937,0,0,2,1,3
"87019",43509500,1000,0.00272864,0,0,1,1,2
"87020",43510000,1000,0.00279526,0,0,2,2,4
"87021",43510500,1000,0.00264464,0,0,1,2,3
"87022",43511000,1000,0.00259829,0,0,0,3,3
"87023",43511500,1000,0.00266171,0,0,0,3,3
"87024",43512000,1000,0.00277685,0,0,1,2,3
"87025",43512500,1000,0.00278662,0,0,1,1,2
"87026",43513000,1000,0.00260916,0,0,0,0,0
"87027",43513500,1000,0.00253245,0,0,0,0,0
"87028",43514000,1000,0.00246268,0,0,0,0,0
"87029",43514500,1000,0.00244517,0,0,0,0,0
"87030",43515000,1000,0.00254554,0,0,0,1,1
"87031",43515500,1000,0.00253658,0,0,0,1,1
"87032",43516000,1000,0.00245836,0,0,0,0,0
"87033",43516500,1000,0.00253008,0,0,0,0,0
"87034",43517000,1000,0.00257009,0,0,0,0,0
"87035",43517500,1000,0.00259914,0,0,0,1,1
"87036",43518000,1000,0.002628,0,0,0,1,1
"87037",43518500,1000,0.00257768,0,0,1,0,1
"87038",43519000,1000,0.00262988,0,0,1,0,1
"87039",43519500,1000,0.00266964,0,0,0,2,2
"87040",43520000,1000,0.00268792,0,0,0,3,3
"87041",43520500,1000,0.00273469,0,0,0,2,2
"87042",43521000,1000,0.00278668,0,0,0,2,2
"87043",43521500,1000,0.00273945,0,0,0,1,1
"87044",43522000,1000,0.0026449,0,0,0,0,0
"87045",43522500,1000,0.00279286,0,1,0,0,1
"87046",43523000,1000,0.00277902,0,1,0,0,1
"87047",43523500,1000,0.00270358,0,0,0,1,1
"87048",43524000,1000,0.00285556,0,0,0,3,3
"87049",43524500,1000,0.00269934,0,0,0,2,2
"87050",43525000,1000,0.00262127,0,0,0,0,0
"87051",43525500,1000,0.00269031,0,0,0,0,0
"87052",43526000,1000,0.00273386,0,0,0,0,0
"87053",43526500,1000,0.00277668,0,0,0,1,1
"87054",43527000,1000,0.00270257,0,0,0,1,1
"87055",43527500,1000,0.0027129,0,0,0,0,0
"87056",43528000,1000,0.00270565,0,0,0,0,0
"87057",43528500,1000,0.00269357,0,0,0,0,0
"87058",43529000,1000,0.00288985,0,1,0,0,1
"87059",43529500,1000,0.00287682,0,1,0,1,2
"87060",43530000,1000,0.0027294,0,0,0,2,2
"87061",43530500,1000,0.00278428,0,0,0,3,3
"87062",43531000,1000,0.00275126,0,0,1,2,3
"87063",43531500,1000,0.00265976,0,0,1,0,1
"87064",43532000,1000,0.00262115,0,0,0,1,1
"87065",43532500,1000,0.00260877,0,0,0,1,1
"87066",43533000,1000,0.00262687,0,0,0,1,1
"87067",43533500,1000,0.00273586,0,0,0,1,1
"87068",43534000,1000,0.00267823,0,0,0,1,1
"87069",43534500,1000,0.00254467,0,0,0,1,1
"87070",43535000,1000,0.00258358,0,0,0,2,2
"87071",43535500,1000,0.00287645,0,1,0,3,4
"87072",43536000,1000,0.00300128,0,1,0,1,2
"87073",43536500,1000,0.00276286,0,0,0,0,0
"87074",43537000,1000,0.00268265,0,0,0,1,1
"87075",43537500,1000,0.00276682,0,0,0,3,3
"87076",43538000,1000,0.00271821,0,0,0,2,2
"87077",43538500,1000,0.00269737,0,0,0,1,1
"87078",43539000,1000,0.00269793,0,0,0,1,1
"87079",43539500,1000,0.00257045,0,0,0,0,0
"87080",43540000,1000,0.00262168,0,0,0,0,0
"87081",43540500,1000,0.00264502,0,0,0,0,0
"87082",43541000,1000,0.00260988,0,0,0,0,0
"87083",43541500,1000,0.00267129,0,0,0,1,1
"87084",43542000,1000,0.00264565,0,0,0,2,2
"87085",43542500,1000,0.00263802,0,0,1,1,2
"87086",43543000,1000,0.00266356,0,0,1,0,1
"87087",43543500,1000,0.00269104,0,0,0,0,0
"87088",43544000,1000,0.00265946,0,0,0,1,1
"87089",43544500,1000,0.00258518,0,0,0,1,1
"87090",43545000,1000,0.00257208,0,0,0,0,0
"87091",43545500,1000,0.00250277,0,0,0,0,0
"87092",43546000,1000,0.00240212,0,0,0,0,0
"87093",43546500,1000,0.00244209,0,0,0,0,0
"87094",43547000,1000,0.00253381,0,0,0,0,0
"87095",43547500,1000,0.00261369,0,0,0,0,0
"87096",43548000,1000,0.00268051,0,0,0,0,0
"87097",43548500,1000,0.00270578,0,0,0,2,2
"87098",43549000,1000,0.00307312,0,1,0,3,4
"87099",43549500,1000,0.00335604,0,2,0,3,5
"87100",43550000,1000,0.00306842,0,1,1,2,4
"87101",43550500,1000,0.00278749,0,0,1,0,1
"87102",43551000,1000,0.00287661,0,0,1,2,3
"87103",43551500,1000,0.00285815,0,1,1,2,4
"87104",43552000,1000,0.00281862,0,1,1,1,3
"87105",43552500,1000,0.0027354,0,0,1,2,3
"87106",43553000,1000,0.00261476,0,0,0,3,3
"87107",43553500,1000,0.00273894,0,0,0,2,2
"87108",43554000,1000,0.00264097,0,0,0,0,0
"87109",43554500,1000,0.00249045,0,0,0,0,0
"87110",43555000,1000,0.00260012,0,0,0,0,0
"87111",43555500,1000,0.00283403,0,0,0,4,4
"87112",43556000,1000,0.00287279,0,0,1,5,6
"87113",43556500,1000,0.00287829,0,1,1,1,3
"87114",43557000,1000,0.00288205,0,1,1,0,2
"87115",43557500,1000,0.00289623,0,0,2,2,4
"87116",43558000,1000,0.0027871,0,0,1,2,3
"87117",43558500,1000,0.00260386,0,0,0,1,1
"87118",43559000,1000,0.00263272,0,0,0,2,2
"87119",43559500,1000,0.00265554,0,0,1,1,2
"87120",43560000,1000,0.00269432,0,0,1,1,2
"87121",43560500,1000,0.00279683,0,0,0,2,2
"87122",43561000,1000,0.00272137,0,0,0,1,1
"87123",43561500,1000,0.00271607,0,0,1,1,2
"87124",43562000,1000,0.00278144,0,0,1,2,3
"87125",43562500,1000,0.00266287,0,0,0,2,2
"87126",43563000,1000,0.00257163,0,0,0,1,1
"87127",43563500,1000,0.00272567,0,0,0,0,0
"87128",43564000,1000,0.00278067,0,0,0,1,1
"87129",43564500,1000,0.00262942,0,0,0,1,1
"87130",43565000,1000,0.0027102,0,0,0,2,2
"87131",43565500,1000,0.00269758,0,0,0,3,3
"87132",43566000,1000,0.00258501,0,0,0,1,1
"87133",43566500,1000,0.00270517,0,0,0,2,2
"87134",43567000,1000,0.00283478,0,0,1,3,4
"87135",43567500,1000,0.00284232,0,0,1,2,3
"87136",43568000,1000,0.00274476,0,0,0,2,2
"87137",43568500,1000,0.00271302,0,0,0,1,1
"87138",43569000,1000,0.00272498,0,0,0,0,0
"87139",43569500,1000,0.00260737,0,0,0,0,0
"87140",43570000,1000,0.00272882,0,0,1,0,1
"87141",43570500,1000,0.00286947,0,0,1,2,3
"87142",43571000,1000,0.00285924,0,0,1,4,5
"87143",43571500,1000,0.00296089,0,1,2,3,6
"87144",43572000,1000,0.00288725,0,1,1,1,3
"87145",43572500,1000,0.00271628,0,0,0,1,1
"87146",43573000,1000,0.00276102,0,0,1,2,3
"87147",43573500,1000,0.00269622,0,0,1,1,2
"87148",43574000,1000,0.00272879,0,0,0,1,1
"87149",43574500,1000,0.00288347,0,0,0,1,1
"87150",43575000,1000,0.0027985,0,0,0,0,0
"87151",43575500,1000,0.00271647,0,0,0,0,0
"87152",43576000,1000,0.00260578,0,0,0,0,0
"87153",43576500,1000,0.00263026,0,0,0,1,1
"87154",43577000,1000,0.00271603,0,0,0,1,1
"87155",43577500,1000,0.00269479,0,0,0,0,0
"87156",43578000,1000,0.00272745,0,0,0,0,0
"87157",43578500,1000,0.00267242,0,0,0,0,0
"87158",43579000,1000,0.0026559,0,0,0,0,0
"87159",43579500,1000,0.00284773,0,0,0,2,2
"87160",43580000,1000,0.00270902,0,0,0,2,2
"87161",43580500,1000,0.00260151,0,0,1,0,1
"87162",43581000,1000,0.00280313,0,0,1,0,1
"87163",43581500,1000,0.00269164,0,0,0,0,0
"87164",43582000,1000,0.00266879,0,0,0,1,1
"87165",43582500,1000,0.0027023,0,0,0,2,2
"87166",43583000,1000,0.00261675,0,0,0,1,1
"87167",43583500,1000,0.00269329,0,0,0,1,1
"87168",43584000,1000,0.00274792,0,0,0,2,2
"87169",43584500,1000,0.00263738,0,0,0,1,1
"87170",43585000,1000,0.00255581,0,0,0,0,0
"87171",43585500,1000,0.00269561,0,0,1,1,2
"87172",43586000,1000,0.00273988,0,0,1,1,2
"87173",43586500,1000,0.00267231,0,0,0,1,1
"87174",43587000,1000,0.00278538,0,0,1,4,5
"87175",43587500,1000,0.00277203,0,0,1,3,4
"87176",43588000,1000,0.00263453,0,0,0,1,1
"87177",43588500,1000,0.00277183,0,0,0,1,1
"87178",43589000,1000,0.00286033,0,0,1,2,3
"87179",43589500,1000,0.00268746,0,0,2,2,4
"87180",43590000,1000,0.00262227,0,0,1,0,1
"87181",43590500,1000,0.0026683,0,0,0,2,2
"87182",43591000,1000,0.00274898,0,0,0,3,3
"87183",43591500,1000,0.00259331,0,0,0,1,1
"87184",43592000,1000,0.00253239,0,0,0,1,1
"87185",43592500,1000,0.00263088,0,0,0,2,2
"87186",43593000,1000,0.00271135,0,0,0,3,3
"87187",43593500,1000,0.0028925,0,0,1,3,4
"87188",43594000,1000,0.00288741,0,0,1,3,4
"87189",43594500,1000,0.00285298,0,0,1,3,4
"87190",43595000,1000,0.00281987,0,0,1,3,4
"87191",43595500,1000,0.00276043,0,0,0,2,2
"87192",43596000,1000,0.00269487,0,0,0,0,0
"87193",43596500,1000,0.0027249,0,0,0,0,0
"87194",43597000,1000,0.00270508,0,0,0,0,0
"87195",43597500,1000,0.00270517,0,0,1,1,2
"87196",43598000,1000,0.00270248,0,0,1,1,2
"87197",43598500,1000,0.00256452,0,0,0,0,0
"87198",43599000,1000,0.00291614,0,1,0,1,2
"87199",43599500,1000,0.0030388,0,1,1,2,4
"87200",43600000,1000,0.0028157,0,0,2,1,3
"87201",43600500,1000,0.0027509,0,0,1,0,1
"87202",43601000,1000,0.00272242,0,0,0,1,1
"87203",43601500,1000,0.00270978,0,0,0,2,2
"87204",43602000,1000,0.00270622,0,0,0,3,3
"87205",43602500,1000,0.00270073,0,0,0,3,3
"87206",43603000,1000,0.00275216,0,0,0,3,3
"87207",43603500,1000,0.00275675,0,0,0,2,2
"87208",43604000,1000,0.00265563,0,0,0,0,0
"87209",43604500,1000,0.00272272,0,0,0,1,1
"87210",43605000,1000,0.00274142,0,0,0,1,1
"87211",43605500,1000,0.0026341,0,0,0,0,0
"87212",43606000,1000,0.00272077,0,0,0,2,2
"87213",43606500,1000,0.00271979,0,0,0,2,2
"87214",43607000,1000,0.00264196,0,0,0,1,1
"87215",43607500,1000,0.00272065,0,0,0,3,3
"87216",43608000,1000,0.00285282,0,0,1,4,5
"87217",43608500,1000,0.00285978,0,0,1,4,5
"87218",43609000,1000,0.00277411,0,0,0,3,3
"87219",43609500,1000,0.00272691,0,0,0,1,1
"87220",43610000,1000,0.00279434,0,0,0,2,2
"87221",43610500,1000,0.00282917,0,0,0,4,4
"87222",43611000,1000,0.00277473,0,0,0,2,2
"87223",43611500,1000,0.00278602,0,0,0,0,0
"87224",43612000,1000,0.00262918,0,0,0,0,0
"87225",43612500,1000,0.002783,0,1,0,0,1
"87226",43613000,1000,0.002765,0,1,0,0,1
"87227",43613500,1000,0.00266445,0,0,1,1,2
"87228",43614000,1000,0.00274556,0,0,1,2,3
"87229",43614500,1000,0.00259116,0,0,0,1,1
"87230",43615000,1000,0.00256287,0,0,0,0,0
"87231",43615500,1000,0.00260743,0,0,0,0,0
"87232",43616000,1000,0.00265215,0,0,0,1,1
"87233",43616500,1000,0.00276959,0,0,0,1,1
"87234",43617000,1000,0.0027027,0,0,0,0,0
"87235",43617500,1000,0.0026903,0,0,0,3,3
"87236",43618000,1000,0.00274351,0,0,0,3,3
"87237",43618500,1000,0.00279016,0,0,0,0,0
"87238",43619000,1000,0.00282501,0,0,0,1,1
"87239",43619500,1000,0.0026991,0,0,0,1,1
"87240",43620000,1000,0.00254684,0,0,0,1,1
"87241",43620500,1000,0.00252461,0,0,0,1,1
"87242",43621000,1000,0.00270815,0,0,0,1,1
"87243",43621500,1000,0.00276545,0,0,0,3,3
"87244",43622000,1000,0.00290398,0,0,1,3,4
"87245",43622500,1000,0.00282977,0,0,1,1,2
"87246",43623000,1000,0.00267459,0,0,0,1,1
"87247",43623500,1000,0.00264041,0,0,0,1,1
"87248",43624000,1000,0.00267629,0,0,1,1,2
"87249",43624500,1000,0.0027069,0,0,1,1,2
"87250",43625000,1000,0.00266337,0,0,0,1,1
"87251",43625500,1000,0.00266294,0,0,0,1,1
"87252",43626000,1000,0.00259641,0,0,0,1,1
"87253",43626500,1000,0.00261881,0,0,0,1,1
"87254",43627000,1000,0.00268624,0,0,0,2,2
"87255",43627500,1000,0.00273244,0,0,0,2,2
"87256",43628000,1000,0.00271827,0,0,0,0,0
"87257",43628500,1000,0.00275829,0,0,0,1,1
"87258",43629000,1000,0.00276958,0,0,0,3,3
"87259",43629500,1000,0.00276548,0,0,0,2,2
"87260",43630000,1000,0.00274303,0,0,0,0,0
"87261",43630500,1000,0.00278484,0,0,0,1,1
"87262",43631000,1000,0.00292588,0,0,0,3,3
"87263",43631500,1000,0.0028224,0,0,0,2,2
"87264",43632000,1000,0.00260717,0,0,0,0,0
"87265",43632500,1000,0.00261286,0,0,0,0,0
"87266",43633000,1000,0.00268194,0,0,0,0,0
"87267",43633500,1000,0.00273621,0,0,0,1,1
"87268",43634000,1000,0.0027446,0,0,0,1,1
"87269",43634500,1000,0.00269055,0,0,0,0,0
"87270",43635000,1000,0.00272436,0,0,0,1,1
"87271",43635500,1000,0.00263658,0,0,0,1,1
"87272",43636000,1000,0.00263092,0,0,1,0,1
"87273",43636500,1000,0.0027897,0,0,1,2,3
"87274",43637000,1000,0.00273578,0,0,0,3,3
"87275",43637500,1000,0.00269699,0,0,0,2,2
"87276",43638000,1000,0.00277587,0,0,0,1,1
"87277",43638500,1000,0.00272847,0,0,0,2,2
"87278",43639000,1000,0.00266058,0,0,0,2,2
"87279",43639500,1000,0.0027863,0,1,0,0,1
"87280",43640000,1000,0.00269187,0,1,0,1,2
"87281",43640500,1000,0.00278358,0,1,0,1,2
"87282",43641000,1000,0.00289257,0,1,0,0,1
"87283",43641500,1000,0.00294679,0,1,0,1,2
"87284",43642000,1000,0.00324056,0,2,0,3,5
"87285",43642500,1000,0.00293632,0,1,0,2,3
"87286",43643000,1000,0.00261166,0,0,0,2,2
"87287",43643500,1000,0.00260114,0,0,0,2,2
"87288",43644000,1000,0.0026164,0,0,0,0,0
"87289",43644500,1000,0.00277584,0,1,0,0,1
"87290",43645000,1000,0.00278671,0,1,1,0,2
"87291",43645500,1000,0.00253144,0,0,1,0,1
"87292",43646000,1000,0.00232267,0,0,0,0,0
"87293",43646500,1000,0.00245849,0,0,0,1,1
"87294",43647000,1000,0.00264359,0,0,0,1,1
"87295",43647500,1000,0.00262685,0,0,0,0,0
"87296",43648000,1000,0.00276137,0,0,1,2,3
"87297",43648500,1000,0.00276923,0,0,1,2,3
"87298",43649000,1000,0.00262673,0,0,0,0,0
"87299",43649500,1000,0.00284255,0,0,1,1,2
"87300",43650000,1000,0.00279005,0,0,1,1,2
"87301",43650500,1000,0.00262676,0,0,0,1,1
"87302",43651000,1000,0.0027067,0,0,0,2,2
"87303",43651500,1000,0.00272753,0,0,0,2,2
"87304",43652000,1000,0.00286415,0,0,1,1,2
"87305",43652500,1000,0.00284534,0,0,1,0,1
"87306",43653000,1000,0.00279133,0,0,0,2,2
"87307",43653500,1000,0.00280177,0,0,0,3,3
"87308",43654000,1000,0.00276779,0,0,1,2,3
"87309",43654500,1000,0.00280065,0,0,1,3,4
"87310",43655000,1000,0.00276033,0,0,1,2,3
"87311",43655500,1000,0.00264677,0,0,1,0,1
"87312",43656000,1000,0.00266232,0,0,1,0,1
"87313",43656500,1000,0.00265602,0,0,1,0,1
"87314",43657000,1000,0.00250957,0,0,0,0,0
"87315",43657500,1000,0.00255162,0,0,0,0,0
"87316",43658000,1000,0.00274716,0,0,0,2,2
"87317",43658500,1000,0.00274285,0,0,0,2,2
"87318",43659000,1000,0.00263477,0,0,0,0,0
"87319",43659500,1000,0.00269258,0,0,0,0,0
"87320",43660000,1000,0.00273526,0,0,0,0,0
"87321",43660500,1000,0.00271492,0,0,0,0,0
"87322",43661000,1000,0.00269284,0,0,0,0,0
"87323",43661500,1000,0.00267962,0,0,0,0,0
"87324",43662000,1000,0.0026278,0,0,0,0,0
"87325",43662500,1000,0.00249217,0,0,0,0,0
"87326",43663000,1000,0.00257298,0,0,0,0,0
"87327",43663500,1000,0.00276582,0,0,0,2,2
"87328",43664000,1000,0.00268235,0,0,0,3,3
"87329",43664500,1000,0.00255518,0,0,0,2,2
"87330",43665000,1000,0.00268076,0,0,1,1,2
"87331",43665500,1000,0.00270078,0,0,1,0,1
"87332",43666000,1000,0.00262459,0,0,0,1,1
"87333",43666500,1000,0.00274019,0,0,1,1,2
"87334",43667000,1000,0.00266874,0,0,1,0,1
"87335",43667500,1000,0.00257272,0,0,0,2,2
"87336",43668000,1000,0.00269073,0,0,1,3,4
"87337",43668500,1000,0.00272542,0,0,2,1,3
"87338",43669000,1000,0.00273911,0,0,1,2,3
"87339",43669500,1000,0.00271428,0,0,0,2,2
"87340",43670000,1000,0.00264427,0,0,0,0,0
"87341",43670500,1000,0.00256005,0,0,0,0,0
"87342",43671000,1000,0.00252937,0,0,0,1,1
"87343",43671500,1000,0.00265654,0,0,0,3,3
"87344",43672000,1000,0.00277187,0,0,0,3,3
"87345",43672500,1000,0.00279831,0,0,0,1,1
"87346",43673000,1000,0.00284078,0,0,0,2,2
"87347",43673500,1000,0.0027948,0,0,0,3,3
"87348",43674000,1000,0.00270256,0,0,0,2,2
"87349",43674500,1000,0.00276148,0,0,0,2,2
"87350",43675000,1000,0.00296771,0,1,0,3,4
"87351",43675500,1000,0.00290952,0,1,0,3,4
"87352",43676000,1000,0.00266399,0,0,0,1,1
"87353",43676500,1000,0.00279363,0,0,1,1,2
"87354",43677000,1000,0.0027424,0,0,1,1,2
"87355",43677500,1000,0.00255848,0,0,0,0,0
"87356",43678000,1000,0.00260248,0,0,0,1,1
"87357",43678500,1000,0.00262909,0,0,0,1,1
"87358",43679000,1000,0.00264392,0,0,0,0,0
"87359",43679500,1000,0.00286593,0,0,1,0,1
"87360",43680000,1000,0.00289176,0,0,1,0,1
"87361",43680500,1000,0.00269597,0,0,0,0,0
"87362",43681000,1000,0.00267544,0,0,0,0,0
"87363",43681500,1000,0.00272164,0,0,0,1,1
"87364",43682000,1000,0.00268119,0,0,0,2,2
"87365",43682500,1000,0.00254675,0,0,0,2,2
"87366",43683000,1000,0.00263428,0,0,0,1,1
"87367",43683500,1000,0.00257406,0,0,0,0,0
"87368",43684000,1000,0.00257801,0,0,0,1,1
"87369",43684500,1000,0.00290052,0,0,1,2,3
"87370",43685000,1000,0.00284402,0,0,1,1,2
"87371",43685500,1000,0.00274046,0,0,1,1,2
"87372",43686000,1000,0.0028534,0,0,1,3,4
"87373",43686500,1000,0.00282929,0,0,1,2,3
"87374",43687000,1000,0.00270701,0,0,1,0,1
"87375",43687500,1000,0.00278756,0,0,1,0,1
"87376",43688000,1000,0.00279333,0,0,1,2,3
"87377",43688500,1000,0.00275059,0,0,0,3,3
"87378",43689000,1000,0.00267008,0,0,0,1,1
"87379",43689500,1000,0.00260413,0,0,0,0,0
"87380",43690000,1000,0.00284603,0,0,1,0,1
"87381",43690500,1000,0.00292956,0,0,2,0,2
"87382",43691000,1000,0.00282275,0,0,1,1,2
"87383",43691500,1000,0.0028239,0,0,0,1,1
"87384",43692000,1000,0.00282161,0,0,0,2,2
"87385",43692500,1000,0.0027418,0,0,0,3,3
"87386",43693000,1000,0.00265462,0,0,0,1,1
"87387",43693500,1000,0.00245933,0,0,0,0,0
"87388",43694000,1000,0.00255926,0,0,0,1,1
"87389",43694500,1000,0.00281237,0,0,0,1,1
"87390",43695000,1000,0.00283455,0,0,0,2,2
"87391",43695500,1000,0.00274623,0,0,0,2,2
"87392",43696000,1000,0.00268394,0,0,0,0,0
"87393",43696500,1000,0.00266694,0,0,1,0,1
"87394",43697000,1000,0.00278556,0,0,1,3,4
"87395",43697500,1000,0.00273535,0,0,0,3,3
"87396",43698000,1000,0.00258548,0,0,0,0,0
"87397",43698500,1000,0.00279481,0,0,0,2,2
"87398",43699000,1000,0.00289307,0,0,0,2,2
"87399",43699500,1000,0.0028134,0,0,0,0,0
"87400",43700000,1000,0.00268963,0,0,0,0,0
"87401",43700500,1000,0.00276766,0,0,1,1,2
"87402",43701000,1000,0.00273472,0,0,1,1,2
"87403",43701500,1000,0.00253292,0,0,0,0,0
"87404",43702000,1000,0.00266087,0,0,0,1,1
"87405",43702500,1000,0.00268424,0,0,0,1,1
"87406",43703000,1000,0.00259705,0,0,0,0,0
"87407",43703500,1000,0.00269135,0,0,0,1,1
"87408",43704000,1000,0.00266184,0,0,0,1,1
"87409",43704500,1000,0.00252093,0,0,0,1,1
"87410",43705000,1000,0.00278912,0,0,1,3,4
"87411",43705500,1000,0.00324024,0,1,1,3,5
"87412",43706000,1000,0.00301834,0,1,0,1,2
"87413",43706500,1000,0.00269198,0,1,0,0,1
"87414",43707000,1000,0.00274352,0,1,0,1,2
"87415",43707500,1000,0.00275564,0,0,1,1,2
"87416",43708000,1000,0.00282283,0,0,1,2,3
"87417",43708500,1000,0.0027675,0,0,0,2,2
"87418",43709000,1000,0.00262047,0,0,0,0,0
"87419",43709500,1000,0.00273727,0,0,0,2,2
"87420",43710000,1000,0.00283978,0,0,0,2,2
"87421",43710500,1000,0.00265716,0,0,0,0,0
"87422",43711000,1000,0.00260431,0,0,0,0,0
"87423",43711500,1000,0.00274966,0,0,0,2,2
"87424",43712000,1000,0.00271741,0,0,0,2,2
"87425",43712500,1000,0.00258391,0,0,0,0,0
"87426",43713000,1000,0.00253499,0,0,0,0,0
"87427",43713500,1000,0.00242542,0,0,0,0,0
"87428",43714000,1000,0.00252134,0,0,0,0,0
"87429",43714500,1000,0.00268899,0,0,0,0,0
"87430",43715000,1000,0.00273817,0,0,0,1,1
"87431",43715500,1000,0.00281415,0,0,0,1,1
"87432",43716000,1000,0.00271998,0,0,0,0,0
"87433",43716500,1000,0.00266329,0,0,0,2,2
"87434",43717000,1000,0.0027182,0,0,0,2,2
"87435",43717500,1000,0.0027517,0,0,0,2,2
"87436",43718000,1000,0.00274471,0,0,0,2,2
"87437",43718500,1000,0.00258244,0,0,0,0,0
"87438",43719000,1000,0.00277514,0,1,0,3,4
"87439",43719500,1000,0.00291876,0,1,0,3,4
"87440",43720000,1000,0.00266019,0,0,0,0,0
"87441",43720500,1000,0.00253144,0,0,0,1,1
"87442",43721000,1000,0.00259684,0,0,1,1,2
"87443",43721500,1000,0.00275692,0,0,2,0,2
"87444",43722000,1000,0.00280019,0,0,1,0,1
"87445",43722500,1000,0.00268741,0,0,0,0,0
"87446",43723000,1000,0.00261185,0,0,0,1,1
"87447",43723500,1000,0.00265852,0,0,0,1,1
"87448",43724000,1000,0.0026864,0,0,0,1,1
"87449",43724500,1000,0.00277095,0,0,0,4,4
"87450",43725000,1000,0.00282333,0,0,0,5,5
"87451",43725500,1000,0.00270572,0,0,0,2,2
"87452",43726000,1000,0.00261333,0,0,0,0,0
"87453",43726500,1000,0.00267877,0,0,0,1,1
"87454",43727000,1000,0.0027545,0,0,0,1,1
"87455",43727500,1000,0.00272,0,0,1,2,3
"87456",43728000,1000,0.00272947,0,0,1,4,5
"87457",43728500,1000,0.00267356,0,0,0,3,3
"87458",43729000,1000,0.00258594,0,0,0,1,1
"87459",43729500,1000,0.00272831,0,0,1,1,2
"87460",43730000,1000,0.00271858,0,0,1,1,2
"87461",43730500,1000,0.00265848,0,0,1,0,1
"87462",43731000,1000,0.0027194,0,0,1,0,1
"87463",43731500,1000,0.00276212,0,0,0,2,2
"87464",43732000,1000,0.00270437,0,0,0,2,2
"87465",43732500,1000,0.00260349,0,0,0,0,0
"87466",43733000,1000,0.00284414,0,1,0,0,1
"87467",43733500,1000,0.00293755,0,1,0,0,1
"87468",43734000,1000,0.00288786,0,0,1,1,2
"87469",43734500,1000,0.00271437,0,0,1,1,2
"87470",43735000,1000,0.00258959,0,0,0,1,1
"87471",43735500,1000,0.0026561,0,0,0,2,2
"87472",43736000,1000,0.00254345,0,0,0,1,1
"87473",43736500,1000,0.00253962,0,0,0,1,1
"87474",43737000,1000,0.00257731,0,0,0,1,1
"87475",43737500,1000,0.0025977,0,0,0,0,0
"87476",43738000,1000,0.00260219,0,0,0,0,0
"87477",43738500,1000,0.00257422,0,0,0,1,1
"87478",43739000,1000,0.00270678,0,1,0,1,2
"87479",43739500,1000,0.00275599,0,1,0,0,1
"87480",43740000,1000,0.00271434,0,0,0,0,0
"87481",43740500,1000,0.00275124,0,0,0,1,1
"87482",43741000,1000,0.00266613,0,0,0,1,1
"87483",43741500,1000,0.00272584,0,0,1,1,2
"87484",43742000,1000,0.00278149,0,0,1,2,3
"87485",43742500,1000,0.00281922,0,1,0,1,2
"87486",43743000,1000,0.00283332,0,1,0,0,1
"87487",43743500,1000,0.00266139,0,0,0,0,0
"87488",43744000,1000,0.00267921,0,0,0,0,0
"87489",43744500,1000,0.00275518,0,0,0,0,0
"87490",43745000,1000,0.00274728,0,0,1,0,1
"87491",43745500,1000,0.00256553,0,0,1,0,1
"87492",43746000,1000,0.00253888,0,0,0,0,0
"87493",43746500,1000,0.00274287,0,0,0,1,1
"87494",43747000,1000,0.00262703,0,0,0,2,2
"87495",43747500,1000,0.00256156,0,0,0,2,2
"87496",43748000,1000,0.00278548,0,0,1,2,3
"87497",43748500,1000,0.0028096,0,0,1,3,4
"87498",43749000,1000,0.00264915,0,0,0,2,2
"87499",43749500,1000,0.00264073,0,0,0,0,0
"87500",43750000,1000,0.00269667,0,0,0,0,0
"87501",43750500,1000,0.00273174,0,0,0,1,1
"87502",43751000,1000,0.00269741,0,0,0,1,1
"87503",43751500,1000,0.00256519,0,0,0,0,0
"87504",43752000,1000,0.00275484,0,0,2,0,2
"87505",43752500,1000,0.00283264,0,0,2,0,2
"87506",43753000,1000,0.00263126,0,0,0,0,0
"87507",43753500,1000,0.00263863,0,0,0,0,0
"87508",43754000,1000,0.00264796,0,0,0,1,1
"87509",43754500,1000,0.00269945,0,0,1,1,2
"87510",43755000,1000,0.00265997,0,0,1,0,1
"87511",43755500,1000,0.00265527,0,0,0,0,0
"87512",43756000,1000,0.00264666,0,0,0,0,0
"87513",43756500,1000,0.00259362,0,0,0,1,1
"87514",43757000,1000,0.00269457,0,0,0,1,1
"87515",43757500,1000,0.00263262,0,0,0,1,1
"87516",43758000,1000,0.00257682,0,0,0,1,1
"87517",43758500,1000,0.00275701,0,0,0,2,2
"87518",43759000,1000,0.00271165,0,0,0,2,2
"87519",43759500,1000,0.00263846,0,0,0,0,0
"87520",43760000,1000,0.0027617,0,0,0,1,1
"87521",43760500,1000,0.00266982,0,0,0,1,1
"87522",43761000,1000,0.00267847,0,0,1,0,1
"87523",43761500,1000,0.00270918,0,0,1,0,1
"87524",43762000,1000,0.00265199,0,0,1,1,2
"87525",43762500,1000,0.00287687,0,0,2,3,5
"87526",43763000,1000,0.00283904,0,0,1,3,4
"87527",43763500,1000,0.00259844,0,0,0,1,1
"87528",43764000,1000,0.0026261,0,0,0,1,1
"87529",43764500,1000,0.00267562,0,0,0,2,2
"87530",43765000,1000,0.00255188,0,0,0,1,1
"87531",43765500,1000,0.00255693,0,0,0,0,0
"87532",43766000,1000,0.002564,0,0,0,0,0
"87533",43766500,1000,0.00254382,0,0,0,0,0
"87534",43767000,1000,0.00266085,0,0,0,0,0
"87535",43767500,1000,0.00267826,0,0,0,0,0
"87536",43768000,1000,0.00259921,0,0,0,0,0
"87537",43768500,1000,0.00256386,0,0,0,0,0
"87538",43769000,1000,0.00272026,0,0,0,1,1
"87539",43769500,1000,0.00279265,0,0,0,1,1
"87540",43770000,1000,0.00287714,0,0,1,1,2
"87541",43770500,1000,0.00284783,0,0,1,3,4
"87542",43771000,1000,0.0026896,0,0,0,2,2
"87543",43771500,1000,0.00279596,0,0,0,1,1
"87544",43772000,1000,0.002747,0,0,0,1,1
"87545",43772500,1000,0.00272062,0,0,1,1,2
"87546",43773000,1000,0.00280513,0,0,1,1,2
"87547",43773500,1000,0.00282527,0,0,1,2,3
"87548",43774000,1000,0.00282483,0,0,1,2,3
"87549",43774500,1000,0.00281327,0,0,0,1,1
"87550",43775000,1000,0.00282431,0,0,0,1,1
"87551",43775500,1000,0.00273818,0,0,0,1,1
"87552",43776000,1000,0.00274443,0,0,0,2,2
"87553",43776500,1000,0.00264753,0,0,0,1,1
"87554",43777000,1000,0.00275191,0,0,1,1,2
"87555",43777500,1000,0.00296032,0,0,2,3,5
"87556",43778000,1000,0.00270809,0,0,1,2,3
"87557",43778500,1000,0.00252763,0,0,1,0,1
"87558",43779000,1000,0.00248856,0,0,1,0,1
"87559",43779500,1000,0.00250327,0,0,0,0,0
"87560",43780000,1000,0.0027166,0,0,0,0,0
"87561",43780500,1000,0.00272471,0,0,0,0,0
"87562",43781000,1000,0.0025916,0,0,0,0,0
"87563",43781500,1000,0.00259321,0,0,0,0,0
"87564",43782000,1000,0.00259825,0,0,0,1,1
"87565",43782500,1000,0.00262029,0,0,0,1,1
"87566",43783000,1000,0.00271763,0,0,0,1,1
"87567",43783500,1000,0.00261021,0,0,0,1,1
"87568",43784000,1000,0.0025381,0,0,0,0,0
"87569",43784500,1000,0.00258618,0,0,0,0,0
"87570",43785000,1000,0.00268998,0,0,0,1,1
"87571",43785500,1000,0.00277473,0,0,0,3,3
"87572",43786000,1000,0.00266324,0,0,0,2,2
"87573",43786500,1000,0.00252343,0,0,0,0,0
"87574",43787000,1000,0.00259753,0,0,1,0,1
"87575",43787500,1000,0.00272167,0,0,2,0,2
"87576",43788000,1000,0.00266509,0,0,1,0,1
"87577",43788500,1000,0.00256032,0,0,0,0,0
"87578",43789000,1000,0.0025709,0,0,0,2,2
"87579",43789500,1000,0.00257689,0,0,0,2,2
"87580",43790000,1000,0.00261866,0,0,0,1,1
"87581",43790500,1000,0.00277672,0,0,0,2,2
"87582",43791000,1000,0.00281128,0,0,0,3,3
"87583",43791500,1000,0.00275088,0,0,0,2,2
"87584",43792000,1000,0.00272594,0,0,0,1,1
"87585",43792500,1000,0.00272017,0,0,0,1,1
"87586",43793000,1000,0.00267914,0,0,0,1,1
"87587",43793500,1000,0.00257002,0,0,0,1,1
"87588",43794000,1000,0.00257829,0,0,0,0,0
"87589",43794500,1000,0.00263188,0,0,0,0,0
"87590",43795000,1000,0.00261731,0,0,0,0,0
"87591",43795500,1000,0.0027212,0,0,0,0,0
"87592",43796000,1000,0.00265849,0,0,0,0,0
"87593",43796500,1000,0.00264424,0,0,0,0,0
"87594",43797000,1000,0.00270282,0,0,0,0,0
"87595",43797500,1000,0.00286334,0,0,0,2,2
"87596",43798000,1000,0.00295505,0,0,0,3,3
"87597",43798500,1000,0.00274763,0,0,0,3,3
"87598",43799000,1000,0.00262161,0,0,0,2,2
"87599",43799500,1000,0.00276978,0,0,0,3,3
"87600",43800000,1000,0.00280923,0,0,0,4,4
"87601",43800500,1000,0.00253176,0,0,0,1,1
"87602",43801000,1000,0.00242937,0,0,0,0,0
"87603",43801500,1000,0.00260925,0,0,0,0,0
"87604",43802000,1000,0.00269323,0,0,0,0,0
"87605",43802500,1000,0.00256981,0,0,0,0,0
"87606",43803000,1000,0.00253226,0,0,0,0,0
"87607",43803500,1000,0.00262101,0,0,0,0,0
"87608",43804000,1000,0.00265,0,0,0,0,0
"87609",43804500,1000,0.00270778,0,0,1,2,3
"87610",43805000,1000,0.00270463,0,0,1,3,4
"87611",43805500,1000,0.00249374,0,0,0,1,1
"87612",43806000,1000,0.0025449,0,0,1,0,1
"87613",43806500,1000,0.00272726,0,0,1,2,3
"87614",43807000,1000,0.0027001,0,0,0,2,2
"87615",43807500,1000,0.00264086,0,0,0,1,1
"87616",43808000,1000,0.00273218,0,0,0,2,2
"87617",43808500,1000,0.00284539,0,0,1,1,2
"87618",43809000,1000,0.0028247,0,0,1,0,1
"87619",43809500,1000,0.00277128,0,0,0,2,2
"87620",43810000,1000,0.00264884,0,0,0,2,2
"87621",43810500,1000,0.00256989,0,0,0,0,0
"87622",43811000,1000,0.00259616,0,0,0,0,0
"87623",43811500,1000,0.00263608,0,0,0,0,0
"87624",43812000,1000,0.0026973,0,0,0,0,0
"87625",43812500,1000,0.00278988,0,0,0,2,2
"87626",43813000,1000,0.00273645,0,0,0,2,2
"87627",43813500,1000,0.00271677,0,0,1,1,2
"87628",43814000,1000,0.00276699,0,0,1,1,2
"87629",43814500,1000,0.00280491,0,0,1,0,1
"87630",43815000,1000,0.00277804,0,0,1,1,2
"87631",43815500,1000,0.00274829,0,0,0,3,3
"87632",43816000,1000,0.00266861,0,0,0,2,2
"87633",43816500,1000,0.00258442,0,0,0,0,0
"87634",43817000,1000,0.00263376,0,0,0,0,0
"87635",43817500,1000,0.00284284,0,1,0,2,3
"87636",43818000,1000,0.00299817,0,1,0,2,3
"87637",43818500,1000,0.00297266,0,0,1,1,2
"87638",43819000,1000,0.00287499,0,0,2,1,3
"87639",43819500,1000,0.00268202,0,0,1,0,1
"87640",43820000,1000,0.0027338,0,0,0,2,2
"87641",43820500,1000,0.00277951,0,0,0,2,2
"87642",43821000,1000,0.00288467,0,1,0,0,1
"87643",43821500,1000,0.00279199,0,1,0,0,1
"87644",43822000,1000,0.00260313,0,0,0,0,0
"87645",43822500,1000,0.00259892,0,0,0,0,0
"87646",43823000,1000,0.00258665,0,0,0,0,0
"87647",43823500,1000,0.00264711,0,0,0,0,0
"87648",43824000,1000,0.00267028,0,0,0,0,0
"87649",43824500,1000,0.00272369,0,0,0,1,1
"87650",43825000,1000,0.00266008,0,0,0,2,2
"87651",43825500,1000,0.00271731,0,0,0,1,1
"87652",43826000,1000,0.00273348,0,0,0,0,0
"87653",43826500,1000,0.00258824,0,0,0,0,0
"87654",43827000,1000,0.00256861,0,0,0,1,1
"87655",43827500,1000,0.00260307,0,0,0,1,1
"87656",43828000,1000,0.00275406,0,0,0,1,1
"87657",43828500,1000,0.00281142,0,0,0,2,2
"87658",43829000,1000,0.00272992,0,0,0,2,2
"87659",43829500,1000,0.00268992,0,0,0,1,1
"87660",43830000,1000,0.0027819,0,0,0,1,1
"87661",43830500,1000,0.00290528,0,1,0,1,2
"87662",43831000,1000,0.00284079,0,1,0,1,2
"87663",43831500,1000,0.00277367,0,0,1,1,2
"87664",43832000,1000,0.00270954,0,0,1,0,1
"87665",43832500,1000,0.00259701,0,0,0,1,1
"87666",43833000,1000,0.0024663,0,0,0,1,1
"87667",43833500,1000,0.0025271,0,0,0,0,0
"87668",43834000,1000,0.00267725,0,0,0,1,1
"87669",43834500,1000,0.00260656,0,0,0,2,2
"87670",43835000,1000,0.00291069,0,0,3,2,5
"87671",43835500,1000,0.00297105,0,0,3,2,5
"87672",43836000,1000,0.0027261,0,0,0,2,2
"87673",43836500,1000,0.00275324,0,0,1,2,3
"87674",43837000,1000,0.00253541,0,0,1,1,2
"87675",43837500,1000,0.00253317,0,0,0,0,0
"87676",43838000,1000,0.00273029,0,0,0,0,0
"87677",43838500,1000,0.00281884,0,0,1,0,1
"87678",43839000,1000,0.00261916,0,0,1,0,1
"87679",43839500,1000,0.00261127,0,0,0,0,0
"87680",43840000,1000,0.002713,0,0,0,0,0
"87681",43840500,1000,0.00253082,0,0,0,0,0
"87682",43841000,1000,0.00252236,0,0,0,0,0
"87683",43841500,1000,0.00258948,0,0,0,3,3
"87684",43842000,1000,0.0025501,0,0,0,3,3
"87685",43842500,1000,0.00234714,0,0,0,0,0
"87686",43843000,1000,0.00250303,0,0,1,0,1
"87687",43843500,1000,0.00279782,0,0,2,2,4
"87688",43844000,1000,0.00291219,0,0,1,2,3
"87689",43844500,1000,0.00277881,0,0,0,0,0
"87690",43845000,1000,0.00251592,0,0,0,0,0
"87691",43845500,1000,0.00254938,0,0,0,0,0
"87692",43846000,1000,0.00256207,0,0,0,0,0
"87693",43846500,1000,0.00259382,0,0,0,1,1
"87694",43847000,1000,0.00261562,0,0,0,1,1
"87695",43847500,1000,0.00252842,0,0,0,0,0
"87696",43848000,1000,0.00266013,0,0,0,3,3
"87697",43848500,1000,0.00285224,0,0,0,3,3
"87698",43849000,1000,0.00288493,0,0,0,1,1
"87699",43849500,1000,0.00274093,0,0,0,1,1
"87700",43850000,1000,0.002649,0,0,0,0,0
"87701",43850500,1000,0.00277184,0,0,0,2,2
"87702",43851000,1000,0.00284282,0,0,1,2,3
"87703",43851500,1000,0.00297184,0,0,2,2,4
"87704",43852000,1000,0.00305146,0,0,2,3,5
"87705",43852500,1000,0.00277903,0,0,1,2,3
"87706",43853000,1000,0.00275574,0,0,0,3,3
"87707",43853500,1000,0.00280027,0,0,0,2,2
"87708",43854000,1000,0.00276931,0,0,0,1,1
"87709",43854500,1000,0.00301815,0,1,0,1,2
"87710",43855000,1000,0.00298252,0,1,0,1,2
"87711",43855500,1000,0.00272729,0,0,0,1,1
"87712",43856000,1000,0.00261032,0,0,0,0,0
"87713",43856500,1000,0.00258299,0,0,0,1,1
"87714",43857000,1000,0.00269364,0,0,0,1,1
"87715",43857500,1000,0.00276871,0,0,0,0,0
"87716",43858000,1000,0.00266005,0,0,0,0,0
"87717",43858500,1000,0.00260442,0,0,0,0,0
"87718",43859000,1000,0.00259528,0,0,0,0,0
"87719",43859500,1000,0.00260767,0,0,0,0,0
"87720",43860000,1000,0.00266347,0,0,0,0,0
"87721",43860500,1000,0.00259457,0,0,0,0,0
"87722",43861000,1000,0.00268524,0,0,0,2,2
"87723",43861500,1000,0.00275264,0,0,0,3,3
"87724",43862000,1000,0.00277172,0,0,0,3,3
"87725",43862500,1000,0.00288109,0,0,1,2,3
"87726",43863000,1000,0.0028632,0,0,1,2,3
"87727",43863500,1000,0.00276423,0,0,0,4,4
"87728",43864000,1000,0.00275409,0,0,0,3,3
"87729",43864500,1000,0.00277351,0,0,0,2,2
"87730",43865000,1000,0.00267801,0,0,0,1,1
"87731",43865500,1000,0.00256618,0,0,0,0,0
"87732",43866000,1000,0.00259958,0,0,1,1,2
"87733",43866500,1000,0.00261413,0,0,1,1,2
"87734",43867000,1000,0.00254373,0,0,0,0,0
"87735",43867500,1000,0.00282481,0,0,0,0,0
"87736",43868000,1000,0.00288336,0,0,0,0,0
"87737",43868500,1000,0.00268708,0,0,0,0,0
"87738",43869000,1000,0.00263201,0,0,0,0,0
"87739",43869500,1000,0.00270024,0,0,0,2,2
"87740",43870000,1000,0.00280449,0,0,0,3,3
"87741",43870500,1000,0.00266313,0,0,0,1,1
"87742",43871000,1000,0.00266088,0,0,0,2,2
"87743",43871500,1000,0.00277934,0,0,1,3,4
"87744",43872000,1000,0.0027024,0,0,1,1,2
"87745",43872500,1000,0.00265895,0,0,0,0,0
"87746",43873000,1000,0.00261682,0,0,0,0,0
"87747",43873500,1000,0.00255432,0,0,0,0,0
"87748",43874000,1000,0.00266309,0,0,0,0,0
"87749",43874500,1000,0.00276123,0,0,0,0,0
"87750",43875000,1000,0.00274644,0,0,0,0,0
"87751",43875500,1000,0.0027975,0,0,1,0,1
"87752",43876000,1000,0.00274654,0,0,1,0,1
"87753",43876500,1000,0.00279435,0,0,1,1,2
"87754",43877000,1000,0.00281722,0,0,1,1,2
"87755",43877500,1000,0.00277335,0,0,1,0,1
"87756",43878000,1000,0.0027657,0,0,1,1,2
"87757",43878500,1000,0.00281955,0,0,1,1,2
"87758",43879000,1000,0.00291295,0,0,1,1,2
"87759",43879500,1000,0.00274868,0,0,0,2,2
"87760",43880000,1000,0.00261989,0,0,0,1,1
"87761",43880500,1000,0.00265761,0,0,0,0,0
"87762",43881000,1000,0.00272384,0,0,0,0,0
"87763",43881500,1000,0.00265707,0,0,0,0,0
"87764",43882000,1000,0.00271912,0,0,0,1,1
"87765",43882500,1000,0.00288728,0,0,0,2,2
"87766",43883000,1000,0.00285423,0,0,0,1,1
"87767",43883500,1000,0.00268569,0,0,0,0,0
"87768",43884000,1000,0.00256806,0,0,0,0,0
"87769",43884500,1000,0.00254867,0,0,0,0,0
"87770",43885000,1000,0.0026844,0,0,0,1,1
"87771",43885500,1000,0.002713,0,0,0,3,3
"87772",43886000,1000,0.00249347,0,0,0,2,2
"87773",43886500,1000,0.00246727,0,0,0,0,0
"87774",43887000,1000,0.00267406,0,0,0,1,1
"87775",43887500,1000,0.00262683,0,0,0,1,1
"87776",43888000,1000,0.00253135,0,0,0,0,0
"87777",43888500,1000,0.00262903,0,0,0,1,1
"87778",43889000,1000,0.00266024,0,0,0,1,1
"87779",43889500,1000,0.00259463,0,0,0,0,0
"87780",43890000,1000,0.00265012,0,0,0,1,1
"87781",43890500,1000,0.00264814,0,0,0,1,1
"87782",43891000,1000,0.00268963,0,0,0,2,2
"87783",43891500,1000,0.00275302,0,0,0,3,3
"87784",43892000,1000,0.00265657,0,0,0,1,1
"87785",43892500,1000,0.00260207,0,0,0,0,0
"87786",43893000,1000,0.00258961,0,0,0,0,0
"87787",43893500,1000,0.00272635,0,0,0,0,0
"87788",43894000,1000,0.00288205,0,0,2,1,3
"87789",43894500,1000,0.00272638,0,0,2,1,3
"87790",43895000,1000,0.00257585,0,0,0,0,0
"87791",43895500,1000,0.00262603,0,0,0,0,0
"87792",43896000,1000,0.00284789,0,0,1,1,2
"87793",43896500,1000,0.00286004,0,0,1,1,2
"87794",43897000,1000,0.00285816,0,1,0,0,1
"87795",43897500,1000,0.00293358,0,1,0,0,1
"87796",43898000,1000,0.00281586,0,0,1,0,1
"87797",43898500,1000,0.00288903,0,0,1,1,2
"87798",43899000,1000,0.00287861,0,0,0,2,2
"87799",43899500,1000,0.00273541,0,0,0,1,1
"87800",43900000,1000,0.00265003,0,0,0,0,0
"87801",43900500,1000,0.00258377,0,0,0,0,0
"87802",43901000,1000,0.00257303,0,0,0,0,0
"87803",43901500,1000,0.00264174,0,0,0,1,1
"87804",43902000,1000,0.00264616,0,0,0,1,1
"87805",43902500,1000,0.00267615,0,0,0,0,0
"87806",43903000,1000,0.00279131,0,0,0,3,3
"87807",43903500,1000,0.00278348,0,0,0,3,3
"87808",43904000,1000,0.00275085,0,0,0,0,0
"87809",43904500,1000,0.00274268,0,0,0,0,0
"87810",43905000,1000,0.00272023,0,0,0,1,1
"87811",43905500,1000,0.00267791,0,0,0,1,1
"87812",43906000,1000,0.00278078,0,1,0,0,1
"87813",43906500,1000,0.00281856,0,1,0,3,4
"87814",43907000,1000,0.00254187,0,0,0,3,3
"87815",43907500,1000,0.00251493,0,0,0,0,0
"87816",43908000,1000,0.00259818,0,0,0,0,0
"87817",43908500,1000,0.00253795,0,0,0,0,0
"87818",43909000,1000,0.00267732,0,0,1,1,2
"87819",43909500,1000,0.00278669,0,0,1,1,2
"87820",43910000,1000,0.00272095,0,0,0,1,1
"87821",43910500,1000,0.00255216,0,0,0,1,1
"87822",43911000,1000,0.00254725,0,0,0,0,0
"87823",43911500,1000,0.00267279,0,0,0,0,0
"87824",43912000,1000,0.00268474,0,0,0,1,1
"87825",43912500,1000,0.0028827,0,0,0,2,2
"87826",43913000,1000,0.00284736,0,0,0,1,1
"87827",43913500,1000,0.00266591,0,0,0,0,0
"87828",43914000,1000,0.00267692,0,0,0,0,0
"87829",43914500,1000,0.00261718,0,0,0,0,0
"87830",43915000,1000,0.00270466,0,0,0,1,1
"87831",43915500,1000,0.00284008,0,0,0,1,1
"87832",43916000,1000,0.00266888,0,0,0,0,0
"87833",43916500,1000,0.00258588,0,0,0,0,0
"87834",43917000,1000,0.00270393,0,0,0,1,1
"87835",43917500,1000,0.0026678,0,0,0,1,1
"87836",43918000,1000,0.00262513,0,0,0,1,1
"87837",43918500,1000,0.00275162,0,0,0,3,3
"87838",43919000,1000,0.00278046,0,0,0,2,2
"87839",43919500,1000,0.00255264,0,0,0,0,0
"87840",43920000,1000,0.00251779,0,0,0,0,0
"87841",43920500,1000,0.00275756,0,0,0,1,1
"87842",43921000,1000,0.00280967,0,0,0,2,2
"87843",43921500,1000,0.00271454,0,0,0,2,2
"87844",43922000,1000,0.00264009,0,0,0,2,2
"87845",43922500,1000,0.00277081,0,0,0,1,1
"87846",43923000,1000,0.00315383,0,0,1,1,2
"87847",43923500,1000,0.00319775,0,0,2,2,4
"87848",43924000,1000,0.00301305,0,0,1,2,3
"87849",43924500,1000,0.00295417,0,0,0,2,2
"87850",43925000,1000,0.00301438,0,0,1,1,2
"87851",43925500,1000,0.00300842,0,0,1,0,1
"87852",43926000,1000,0.00282565,0,0,0,1,1
"87853",43926500,1000,0.00286324,0,0,1,2,3
"87854",43927000,1000,0.00290726,0,0,2,1,3
"87855",43927500,1000,0.00276911,0,0,1,1,2
"87856",43928000,1000,0.00263908,0,0,0,1,1
"87857",43928500,1000,0.00254339,0,0,0,0,0
"87858",43929000,1000,0.00266552,0,0,1,0,1
"87859",43929500,1000,0.00265282,0,0,1,0,1
"87860",43930000,1000,0.0025831,0,0,1,0,1
"87861",43930500,1000,0.00274604,0,0,2,1,3
"87862",43931000,1000,0.00277595,0,0,1,1,2
"87863",43931500,1000,0.00278191,0,0,0,2,2
"87864",43932000,1000,0.00276588,0,0,0,3,3
"87865",43932500,1000,0.00278448,0,0,0,1,1
"87866",43933000,1000,0.00293115,0,0,1,0,1
"87867",43933500,1000,0.00289961,0,0,2,0,2
"87868",43934000,1000,0.00269944,0,0,1,0,1
"87869",43934500,1000,0.00259645,0,0,0,0,0
"87870",43935000,1000,0.00281181,0,0,0,3,3
"87871",43935500,1000,0.0028082,0,0,0,3,3
"87872",43936000,1000,0.00270422,0,0,0,1,1
"87873",43936500,1000,0.00276627,0,0,0,2,2
"87874",43937000,1000,0.00264602,0,0,0,1,1
"87875",43937500,1000,0.00260207,0,0,0,1,1
"87876",43938000,1000,0.00269109,0,0,0,3,3
"87877",43938500,1000,0.00261041,0,0,0,2,2
"87878",43939000,1000,0.00255561,0,0,0,0,0
"87879",43939500,1000,0.0027276,0,0,0,2,2
"87880",43940000,1000,0.00265181,0,0,0,2,2
"87881",43940500,1000,0.00263518,0,0,0,1,1
"87882",43941000,1000,0.00274415,0,0,0,1,1
"87883",43941500,1000,0.00287395,0,1,0,0,1
"87884",43942000,1000,0.00294477,0,1,1,0,2
"87885",43942500,1000,0.00276875,0,0,1,0,1
"87886",43943000,1000,0.00260436,0,0,0,0,0
"87887",43943500,1000,0.00264371,0,0,0,1,1
"87888",43944000,1000,0.00268159,0,0,0,2,2
"87889",43944500,1000,0.00267551,0,0,0,3,3
"87890",43945000,1000,0.00289822,0,0,1,3,4
"87891",43945500,1000,0.00282942,0,0,1,3,4
"87892",43946000,1000,0.00284982,0,1,0,2,3
"87893",43946500,1000,0.00291197,0,1,1,0,2
"87894",43947000,1000,0.0026325,0,0,1,0,1
"87895",43947500,1000,0.00256592,0,0,0,0,0
"87896",43948000,1000,0.00268938,0,0,0,2,2
"87897",43948500,1000,0.0026838,0,0,0,2,2
"87898",43949000,1000,0.00284694,0,1,0,2,3
"87899",43949500,1000,0.00289658,0,1,0,2,3
"87900",43950000,1000,0.00260924,0,0,0,0,0
"87901",43950500,1000,0.00266379,0,0,0,0,0
"87902",43951000,1000,0.00286082,0,0,0,2,2
"87903",43951500,1000,0.00293085,0,0,0,2,2
"87904",43952000,1000,0.0028177,0,0,0,0,0
"87905",43952500,1000,0.00261123,0,0,0,0,0
"87906",43953000,1000,0.00257549,0,0,0,0,0
"87907",43953500,1000,0.00277566,0,1,0,0,1
"87908",43954000,1000,0.00287694,0,1,1,0,2
"87909",43954500,1000,0.00277336,0,0,1,0,1
"87910",43955000,1000,0.00270965,0,0,0,0,0
"87911",43955500,1000,0.00267346,0,0,0,0,0
"87912",43956000,1000,0.00265841,0,0,0,1,1
"87913",43956500,1000,0.00280577,0,0,0,3,3
"87914",43957000,1000,0.00280043,0,0,0,3,3
"87915",43957500,1000,0.00262531,0,0,0,1,1
"87916",43958000,1000,0.00265813,0,0,1,0,1
"87917",43958500,1000,0.00265283,0,0,1,0,1
"87918",43959000,1000,0.00257285,0,0,0,1,1
"87919",43959500,1000,0.0027133,0,0,1,1,2
"87920",43960000,1000,0.00272273,0,0,1,1,2
"87921",43960500,1000,0.00276221,0,0,1,3,4
"87922",43961000,1000,0.00281619,0,0,1,2,3
"87923",43961500,1000,0.00272103,0,0,0,2,2
"87924",43962000,1000,0.00262337,0,0,0,2,2
"87925",43962500,1000,0.00259547,0,0,0,0,0
"87926",43963000,1000,0.00262561,0,0,0,0,0
"87927",43963500,1000,0.00254747,0,0,0,0,0
"87928",43964000,1000,0.00256934,0,0,0,0,0
"87929",43964500,1000,0.00262384,0,0,0,0,0
"87930",43965000,1000,0.00266572,0,0,0,2,2
"87931",43965500,1000,0.00270015,0,0,1,4,5
"87932",43966000,1000,0.00270124,0,0,1,2,3
"87933",43966500,1000,0.0026672,0,0,0,0,0
"87934",43967000,1000,0.00270042,0,0,0,1,1
"87935",43967500,1000,0.00268523,0,0,0,1,1
"87936",43968000,1000,0.00268117,0,0,0,1,1
"87937",43968500,1000,0.00291761,0,0,1,3,4
"87938",43969000,1000,0.00294532,0,0,1,4,5
"87939",43969500,1000,0.00276168,0,0,0,5,5
"87940",43970000,1000,0.00266472,0,0,0,3,3
"87941",43970500,1000,0.00257418,0,0,0,0,0
"87942",43971000,1000,0.00255318,0,0,0,0,0
"87943",43971500,1000,0.00268289,0,0,1,0,1
"87944",43972000,1000,0.00271354,0,0,1,3,4
"87945",43972500,1000,0.00273755,0,0,1,4,5
"87946",43973000,1000,0.00272242,0,0,1,2,3
"87947",43973500,1000,0.00279121,0,0,1,1,2
"87948",43974000,1000,0.0027467,0,0,1,0,1
"87949",43974500,1000,0.00256798,0,0,0,0,0
"87950",43975000,1000,0.00270811,0,0,0,2,2
"87951",43975500,1000,0.00263065,0,0,0,2,2
"87952",43976000,1000,0.00246412,0,0,0,0,0
"87953",43976500,1000,0.00265877,0,0,0,2,2
"87954",43977000,1000,0.00286414,0,0,1,2,3
"87955",43977500,1000,0.0029364,0,0,1,2,3
"87956",43978000,1000,0.00280893,0,0,0,3,3
"87957",43978500,1000,0.00261754,0,0,0,2,2
"87958",43979000,1000,0.00271303,0,0,0,1,1
"87959",43979500,1000,0.00276913,0,0,0,0,0
"87960",43980000,1000,0.00273974,0,0,0,2,2
"87961",43980500,1000,0.00273174,0,0,0,3,3
"87962",43981000,1000,0.0027445,0,0,0,2,2
"87963",43981500,1000,0.00275186,0,0,1,2,3
"87964",43982000,1000,0.00282939,0,1,1,1,3
"87965",43982500,1000,0.00280491,0,1,0,2,3
"87966",43983000,1000,0.00273646,0,0,0,3,3
"87967",43983500,1000,0.00269496,0,0,0,1,1
"87968",43984000,1000,0.00253856,0,0,1,0,1
"87969",43984500,1000,0.00257021,0,0,1,0,1
"87970",43985000,1000,0.00265239,0,0,0,0,0
"87971",43985500,1000,0.00254732,0,0,0,0,0
"87972",43986000,1000,0.00267917,0,0,1,1,2
"87973",43986500,1000,0.00275069,0,0,1,1,2
"87974",43987000,1000,0.00264127,0,0,0,0,0
"87975",43987500,1000,0.00272616,0,0,0,2,2
"87976",43988000,1000,0.00275538,0,0,0,3,3
"87977",43988500,1000,0.00282355,0,0,0,3,3
"87978",43989000,1000,0.00278912,0,0,0,4,4
"87979",43989500,1000,0.00253262,0,0,0,2,2
"87980",43990000,1000,0.00257889,0,0,1,1,2
"87981",43990500,1000,0.00266962,0,0,1,2,3
"87982",43991000,1000,0.00266744,0,0,1,1,2
"87983",43991500,1000,0.00276261,0,0,2,1,3
"87984",43992000,1000,0.00279699,0,1,1,1,3
"87985",43992500,1000,0.00278803,0,1,0,1,2
"87986",43993000,1000,0.00279836,0,0,1,2,3
"87987",43993500,1000,0.00270506,0,0,1,1,2
"87988",43994000,1000,0.0025097,0,0,0,0,0
"87989",43994500,1000,0.0024933,0,0,0,0,0
"87990",43995000,1000,0.00250663,0,0,0,0,0
"87991",43995500,1000,0.00265262,0,0,0,2,2
"87992",43996000,1000,0.00283213,0,0,0,3,3
"87993",43996500,1000,0.00274871,0,0,0,1,1
"87994",43997000,1000,0.00278755,0,0,0,2,2
"87995",43997500,1000,0.00272301,0,0,0,2,2
"87996",43998000,1000,0.00262926,0,0,0,1,1
"87997",43998500,1000,0.00263027,0,0,0,1,1
"87998",43999000,1000,0.00261923,0,0,0,0,0
"87999",43999500,1000,0.00277135,0,0,0,1,1
"88000",44000000,1000,0.00280282,0,0,0,1,1
"88001",44000500,1000,0.00288022,0,0,0,4,4
"88002",44001000,1000,0.00284434,0,0,0,4,4
"88003",44001500,1000,0.00279622,0,0,0,0,0
"88004",44002000,1000,0.00282064,0,0,0,1,1
"88005",44002500,1000,0.00275185,0,0,0,1,1
"88006",44003000,1000,0.00276025,0,0,0,2,2
"88007",44003500,1000,0.0027186,0,0,0,3,3
"88008",44004000,1000,0.0025181,0,0,0,1,1
"88009",44004500,1000,0.00252733,0,0,0,0,0
"88010",44005000,1000,0.00263331,0,0,0,0,0
"88011",44005500,1000,0.00266766,0,0,0,0,0
"88012",44006000,1000,0.00269361,0,0,0,0,0
"88013",44006500,1000,0.00269972,0,0,0,0,0
"88014",44007000,1000,0.0027546,0,0,0,0,0
"88015",44007500,1000,0.00266982,0,0,0,0,0
"88016",44008000,1000,0.00265183,0,0,0,0,0
"88017",44008500,1000,0.00270688,0,0,0,1,1
"88018",44009000,1000,0.00267476,0,0,0,3,3
"88019",44009500,1000,0.0026807,0,0,0,3,3
"88020",44010000,1000,0.00270797,0,0,0,2,2
"88021",44010500,1000,0.00278698,0,0,0,1,1
"88022",44011000,1000,0.00277485,0,0,0,0,0
"88023",44011500,1000,0.00261457,0,0,0,0,0
"88024",44012000,1000,0.00265009,0,0,0,0,0
"88025",44012500,1000,0.00271241,0,0,0,0,0
"88026",44013000,1000,0.00270898,0,0,0,1,1
"88027",44013500,1000,0.00263883,0,0,0,1,1
"88028",44014000,1000,0.00256439,0,0,0,0,0
"88029",44014500,1000,0.00260591,0,0,0,0,0
"88030",44015000,1000,0.00261219,0,0,0,0,0
"88031",44015500,1000,0.00266377,0,0,0,1,1
"88032",44016000,1000,0.00261496,0,0,0,2,2
"88033",44016500,1000,0.00271703,0,0,0,3,3
"88034",44017000,1000,0.00286436,0,0,1,3,4
"88035",44017500,1000,0.00267206,0,0,1,1,2
"88036",44018000,1000,0.00254715,0,0,0,0,0
"88037",44018500,1000,0.00260306,0,0,0,0,0
"88038",44019000,1000,0.00257165,0,0,0,0,0
"88039",44019500,1000,0.00261232,0,0,1,0,1
"88040",44020000,1000,0.00263269,0,0,1,0,1
"88041",44020500,1000,0.00265836,0,0,0,0,0
"88042",44021000,1000,0.00283018,0,0,1,0,1
"88043",44021500,1000,0.00275951,0,0,1,0,1
"88044",44022000,1000,0.00261506,0,0,0,0,0
"88045",44022500,1000,0.00252726,0,0,0,0,0
"88046",44023000,1000,0.0026171,0,0,1,1,2
"88047",44023500,1000,0.00293932,0,0,2,2,4
"88048",44024000,1000,0.00291638,0,0,1,1,2
"88049",44024500,1000,0.00263164,0,0,0,0,0
"88050",44025000,1000,0.00279917,0,0,0,1,1
"88051",44025500,1000,0.00283877,0,0,0,1,1
"88052",44026000,1000,0.0026453,0,0,0,1,1
"88053",44026500,1000,0.00271049,0,0,0,2,2
"88054",44027000,1000,0.00278434,0,0,0,3,3
"88055",44027500,1000,0.00276326,0,0,0,3,3
"88056",44028000,1000,0.00266815,0,0,0,1,1
"88057",44028500,1000,0.00283517,0,1,0,0,1
"88058",44029000,1000,0.00282752,0,1,0,0,1
"88059",44029500,1000,0.00268658,0,0,0,0,0
"88060",44030000,1000,0.00267821,0,0,0,0,0
"88061",44030500,1000,0.00262312,0,0,0,0,0
"88062",44031000,1000,0.00269977,0,0,0,2,2
"88063",44031500,1000,0.00280081,0,0,1,3,4
"88064",44032000,1000,0.00279327,0,0,1,1,2
"88065",44032500,1000,0.00267206,0,0,0,0,0
"88066",44033000,1000,0.00260509,0,0,0,0,0
"88067",44033500,1000,0.00265941,0,0,0,1,1
"88068",44034000,1000,0.00269051,0,0,0,1,1
"88069",44034500,1000,0.0026257,0,0,0,1,1
"88070",44035000,1000,0.00272563,0,0,0,2,2
"88071",44035500,1000,0.00259027,0,0,0,1,1
"88072",44036000,1000,0.00247431,0,0,0,1,1
"88073",44036500,1000,0.0027944,0,0,2,2,4
"88074",44037000,1000,0.00278287,0,0,2,1,3
"88075",44037500,1000,0.00256862,0,0,0,0,0
"88076",44038000,1000,0.00270889,0,0,1,2,3
"88077",44038500,1000,0.00278418,0,0,1,2,3
"88078",44039000,1000,0.00270751,0,0,0,1,1
"88079",44039500,1000,0.00278249,0,0,1,2,3
"88080",44040000,1000,0.00277791,0,0,1,2,3
"88081",44040500,1000,0.00277055,0,0,2,1,3
"88082",44041000,1000,0.00275282,0,0,2,0,2
"88083",44041500,1000,0.00268773,0,0,0,0,0
"88084",44042000,1000,0.00275276,0,0,0,2,2
"88085",44042500,1000,0.00289396,0,0,1,3,4
"88086",44043000,1000,0.00281198,0,0,1,1,2
"88087",44043500,1000,0.00263103,0,0,0,0,0
"88088",44044000,1000,0.00259854,0,0,0,0,0
"88089",44044500,1000,0.00254524,0,0,0,0,0
"88090",44045000,1000,0.0026303,0,0,1,1,2
"88091",44045500,1000,0.00269723,0,0,1,1,2
"88092",44046000,1000,0.00275306,0,0,0,4,4
"88093",44046500,1000,0.00287805,0,0,1,5,6
"88094",44047000,1000,0.00288752,0,0,1,3,4
"88095",44047500,1000,0.00277755,0,0,0,3,3
"88096",44048000,1000,0.0026118,0,0,0,1,1
"88097",44048500,1000,0.00253359,0,0,0,0,0
"88098",44049000,1000,0.00261304,0,0,0,0,0
"88099",44049500,1000,0.00281604,0,1,0,0,1
"88100",44050000,1000,0.00286672,0,1,1,1,3
"88101",44050500,1000,0.00277155,0,0,1,1,2
"88102",44051000,1000,0.00281661,0,0,0,2,2
"88103",44051500,1000,0.00283279,0,0,0,4,4
"88104",44052000,1000,0.00262385,0,0,0,2,2
"88105",44052500,1000,0.00257215,0,0,1,0,1
"88106",44053000,1000,0.00271841,0,0,1,2,3
"88107",44053500,1000,0.00282629,0,0,1,2,3
"88108",44054000,1000,0.00283689,0,0,1,1,2
"88109",44054500,1000,0.00293785,0,1,0,2,3
"88110",44055000,1000,0.0028759,0,1,0,3,4
"88111",44055500,1000,0.00252278,0,0,0,2,2
"88112",44056000,1000,0.00252682,0,0,0,1,1
"88113",44056500,1000,0.00277459,0,0,0,1,1
"88114",44057000,1000,0.00283518,0,0,0,2,2
"88115",44057500,1000,0.00281141,0,0,0,4,4
"88116",44058000,1000,0.0027383,0,0,0,5,5
"88117",44058500,1000,0.00270719,0,0,1,3,4
"88118",44059000,1000,0.00272995,0,0,1,1,2
"88119",44059500,1000,0.00292562,0,1,1,2,4
"88120",44060000,1000,0.00282145,0,1,1,1,3
"88121",44060500,1000,0.00268083,0,0,1,0,1
"88122",44061000,1000,0.00275214,0,0,1,0,1
"88123",44061500,1000,0.00259371,0,0,0,0,0
"88124",44062000,1000,0.00255694,0,0,0,1,1
"88125",44062500,1000,0.00268919,0,0,0,3,3
"88126",44063000,1000,0.00270849,0,0,0,2,2
"88127",44063500,1000,0.00265046,0,0,0,0,0
"88128",44064000,1000,0.00261794,0,0,0,0,0
"88129",44064500,1000,0.00273691,0,0,1,3,4
"88130",44065000,1000,0.00280195,0,0,2,3,5
"88131",44065500,1000,0.00269071,0,0,1,1,2
"88132",44066000,1000,0.00261202,0,0,0,1,1
"88133",44066500,1000,0.00254057,0,0,0,1,1
"88134",44067000,1000,0.00277117,0,0,1,3,4
"88135",44067500,1000,0.00277809,0,0,1,2,3
"88136",44068000,1000,0.00259499,0,0,0,2,2
"88137",44068500,1000,0.00268508,0,0,0,4,4
"88138",44069000,1000,0.00265183,0,0,0,2,2
"88139",44069500,1000,0.00272139,0,0,2,1,3
"88140",44070000,1000,0.00269965,0,0,2,1,3
"88141",44070500,1000,0.00238906,0,0,0,0,0
"88142",44071000,1000,0.00257541,0,0,0,2,2
"88143",44071500,1000,0.00275037,0,0,0,3,3
"88144",44072000,1000,0.00257708,0,0,0,1,1
"88145",44072500,1000,0.00271393,0,0,0,3,3
"88146",44073000,1000,0.00283138,0,0,0,4,4
"88147",44073500,1000,0.00283176,0,0,0,2,2
"88148",44074000,1000,0.00284532,0,0,0,1,1
"88149",44074500,1000,0.00280775,0,0,1,0,1
"88150",44075000,1000,0.00270861,0,0,1,0,1
"88151",44075500,1000,0.00270757,0,0,0,1,1
"88152",44076000,1000,0.00271866,0,0,0,1,1
"88153",44076500,1000,0.00267287,0,0,0,0,0
"88154",44077000,1000,0.00264659,0,0,0,0,0
"88155",44077500,1000,0.00267358,0,0,0,1,1
"88156",44078000,1000,0.00267006,0,0,0,1,1
"88157",44078500,1000,0.00265677,0,0,0,0,0
"88158",44079000,1000,0.00280807,0,0,1,1,2
"88159",44079500,1000,0.00274383,0,0,1,1,2
"88160",44080000,1000,0.00268408,0,0,0,0,0
"88161",44080500,1000,0.00269732,0,0,0,0,0
"88162",44081000,1000,0.00266546,0,0,0,2,2
"88163",44081500,1000,0.00268334,0,0,0,3,3
"88164",44082000,1000,0.00260061,0,0,0,1,1
"88165",44082500,1000,0.00290686,0,1,0,0,1
"88166",44083000,1000,0.00296497,0,1,0,1,2
"88167",44083500,1000,0.00295731,0,0,1,4,5
"88168",44084000,1000,0.00295633,0,0,1,3,4
"88169",44084500,1000,0.00265055,0,0,0,0,0
"88170",44085000,1000,0.00275094,0,0,0,2,2
"88171",44085500,1000,0.00287856,0,0,1,4,5
"88172",44086000,1000,0.00283419,0,0,1,2,3
"88173",44086500,1000,0.00269216,0,0,0,0,0
"88174",44087000,1000,0.00269164,0,0,0,0,0
"88175",44087500,1000,0.00279133,0,0,0,0,0
"88176",44088000,1000,0.00288934,0,0,1,1,2
"88177",44088500,1000,0.0027577,0,0,1,1,2
"88178",44089000,1000,0.00275186,0,0,0,3,3
"88179",44089500,1000,0.00286911,0,0,0,6,6
"88180",44090000,1000,0.0027514,0,0,0,5,5
"88181",44090500,1000,0.00280373,0,0,1,4,5
"88182",44091000,1000,0.00291083,0,0,2,2,4
"88183",44091500,1000,0.00282892,0,0,1,0,1
"88184",44092000,1000,0.00265055,0,0,0,0,0
"88185",44092500,1000,0.00254075,0,0,0,0,0
"88186",44093000,1000,0.00267694,0,0,0,0,0
"88187",44093500,1000,0.00276165,0,0,0,0,0
"88188",44094000,1000,0.00277019,0,0,0,3,3
"88189",44094500,1000,0.00266382,0,0,0,3,3
"88190",44095000,1000,0.00256798,0,0,0,1,1
"88191",44095500,1000,0.00264607,0,0,0,1,1
"88192",44096000,1000,0.00272729,0,0,1,0,1
"88193",44096500,1000,0.00301655,0,0,3,3,6
"88194",44097000,1000,0.00297164,0,0,2,3,5
"88195",44097500,1000,0.00264514,0,0,0,0,0
"88196",44098000,1000,0.00262865,0,0,0,0,0
"88197",44098500,1000,0.0027338,0,0,0,4,4
"88198",44099000,1000,0.00276989,0,0,0,6,6
"88199",44099500,1000,0.00286383,0,0,1,4,5
"88200",44100000,1000,0.00284005,0,0,1,2,3
"88201",44100500,1000,0.00274378,0,0,0,2,2
"88202",44101000,1000,0.00279514,0,0,0,5,5
"88203",44101500,1000,0.00279786,0,0,0,4,4
"88204",44102000,1000,0.00281461,0,0,0,3,3
"88205",44102500,1000,0.00276496,0,0,1,2,3
"88206",44103000,1000,0.00272437,0,0,1,0,1
"88207",44103500,1000,0.0027353,0,0,1,0,1
"88208",44104000,1000,0.00273548,0,0,2,0,2
"88209",44104500,1000,0.00285241,0,1,1,0,2
"88210",44105000,1000,0.00282211,0,1,0,0,1
"88211",44105500,1000,0.00270357,0,0,0,0,0
"88212",44106000,1000,0.00282902,0,0,0,1,1
"88213",44106500,1000,0.00284933,0,0,0,2,2
"88214",44107000,1000,0.00283946,0,0,1,3,4
"88215",44107500,1000,0.00279313,0,0,1,2,3
"88216",44108000,1000,0.00258945,0,0,0,0,0
"88217",44108500,1000,0.00253175,0,0,0,0,0
"88218",44109000,1000,0.00259645,0,0,0,0,0
"88219",44109500,1000,0.00263323,0,0,0,0,0
"88220",44110000,1000,0.00265021,0,0,0,0,0
"88221",44110500,1000,0.00267249,0,0,0,1,1
"88222",44111000,1000,0.00255884,0,0,0,1,1
"88223",44111500,1000,0.00266809,0,0,0,2,2
"88224",44112000,1000,0.00285499,0,0,0,4,4
"88225",44112500,1000,0.00312875,0,1,0,2,3
"88226",44113000,1000,0.00302675,0,1,0,0,1
"88227",44113500,1000,0.00267921,0,0,0,1,1
"88228",44114000,1000,0.00265715,0,0,0,1,1
"88229",44114500,1000,0.00256007,0,0,0,0,0
"88230",44115000,1000,0.00265429,0,0,0,0,0
"88231",44115500,1000,0.00274069,0,0,0,0,0
"88232",44116000,1000,0.00279065,0,1,0,0,1
"88233",44116500,1000,0.00282434,0,1,0,0,1
"88234",44117000,1000,0.00274308,0,0,0,0,0
"88235",44117500,1000,0.00268678,0,0,0,0,0
"88236",44118000,1000,0.00276379,0,0,0,0,0
"88237",44118500,1000,0.0028221,0,0,0,0,0
"88238",44119000,1000,0.00282785,0,0,0,1,1
"88239",44119500,1000,0.00300322,0,0,0,2,2
"88240",44120000,1000,0.00284775,0,0,0,1,1
"88241",44120500,1000,0.00281248,0,0,2,2,4
"88242",44121000,1000,0.00276842,0,0,2,2,4
"88243",44121500,1000,0.00254397,0,0,0,0,0
"88244",44122000,1000,0.00262731,0,0,0,0,0
"88245",44122500,1000,0.00266062,0,0,0,1,1
"88246",44123000,1000,0.00251235,0,0,0,1,1
"88247",44123500,1000,0.00241905,0,0,0,0,0
"88248",44124000,1000,0.00256403,0,0,0,0,0
"88249",44124500,1000,0.00263191,0,0,0,1,1
"88250",44125000,1000,0.00300913,0,1,1,2,4
"88251",44125500,1000,0.00317247,0,1,2,3,6
"88252",44126000,1000,0.00274748,0,0,1,2,3
"88253",44126500,1000,0.00284403,0,1,1,1,3
"88254",44127000,1000,0.0028445,0,1,1,1,3
"88255",44127500,1000,0.00269837,0,0,0,3,3
"88256",44128000,1000,0.00281785,0,0,1,3,4
"88257",44128500,1000,0.00267429,0,0,1,0,1
"88258",44129000,1000,0.00257937,0,0,0,1,1
"88259",44129500,1000,0.00268069,0,0,0,3,3
"88260",44130000,1000,0.00275831,0,0,1,3,4
"88261",44130500,1000,0.00278691,0,0,1,2,3
"88262",44131000,1000,0.00281343,0,0,1,3,4
"88263",44131500,1000,0.00291773,0,0,2,5,7
"88264",44132000,1000,0.00284073,0,0,1,3,4
"88265",44132500,1000,0.00265988,0,0,0,0,0
"88266",44133000,1000,0.00271662,0,0,0,0,0
"88267",44133500,1000,0.00278959,0,0,0,1,1
"88268",44134000,1000,0.00280504,0,0,0,1,1
"88269",44134500,1000,0.00272701,0,0,0,1,1
"88270",44135000,1000,0.00268975,0,0,0,2,2
"88271",44135500,1000,0.00275007,0,0,0,2,2
"88272",44136000,1000,0.0027511,0,0,1,2,3
"88273",44136500,1000,0.00287897,0,0,2,4,6
"88274",44137000,1000,0.0028118,0,0,1,3,4
"88275",44137500,1000,0.00265323,0,0,0,0,0
"88276",44138000,1000,0.00271976,0,0,0,0,0
"88277",44138500,1000,0.00270813,0,0,0,0,0
"88278",44139000,1000,0.00264054,0,0,0,0,0
"88279",44139500,1000,0.00265854,0,0,1,1,2
"88280",44140000,1000,0.00266114,0,0,1,2,3
"88281",44140500,1000,0.00294679,0,0,2,5,7
"88282",44141000,1000,0.00298403,0,0,2,4,6
"88283",44141500,1000,0.00259053,0,0,0,1,1
"88284",44142000,1000,0.00250277,0,0,0,1,1
"88285",44142500,1000,0.00245651,0,0,0,0,0
"88286",44143000,1000,0.00263475,0,0,0,2,2
"88287",44143500,1000,0.00273026,0,0,0,2,2
"88288",44144000,1000,0.00280268,0,0,1,2,3
"88289",44144500,1000,0.00287308,0,0,2,3,5
"88290",44145000,1000,0.00267207,0,0,1,3,4
"88291",44145500,1000,0.00264471,0,0,0,2,2
"88292",44146000,1000,0.00270045,0,0,0,1,1
"88293",44146500,1000,0.00276457,0,0,0,2,2
"88294",44147000,1000,0.00281687,0,0,0,1,1
"88295",44147500,1000,0.00291426,0,0,1,1,2
"88296",44148000,1000,0.00287342,0,0,1,1,2
"88297",44148500,1000,0.00283159,0,0,0,2,2
"88298",44149000,1000,0.00290793,0,0,1,3,4
"88299",44149500,1000,0.00282204,0,0,1,1,2
"88300",44150000,1000,0.00268439,0,0,0,0,0
"88301",44150500,1000,0.00277822,0,0,1,1,2
"88302",44151000,1000,0.00286237,0,0,2,1,3
"88303",44151500,1000,0.00263701,0,0,1,0,1
"88304",44152000,1000,0.00275674,0,0,1,0,1
"88305",44152500,1000,0.0029564,0,1,1,0,2
"88306",44153000,1000,0.00282897,0,1,1,1,3
"88307",44153500,1000,0.00292073,0,0,2,3,5
"88308",44154000,1000,0.00289465,0,0,1,3,4
"88309",44154500,1000,0.00272646,0,0,0,2,2
"88310",44155000,1000,0.0028398,0,0,1,2,3
"88311",44155500,1000,0.00284485,0,0,1,1,2
"88312",44156000,1000,0.00293231,0,1,0,1,2
"88313",44156500,1000,0.00297829,0,1,1,2,4
"88314",44157000,1000,0.00270827,0,0,1,1,2
"88315",44157500,1000,0.00273546,0,0,1,1,2
"88316",44158000,1000,0.00271871,0,0,1,1,2
"88317",44158500,1000,0.0026738,0,0,1,1,2
"88318",44159000,1000,0.00268523,0,0,1,1,2
"88319",44159500,1000,0.00265655,0,0,0,0,0
"88320",44160000,1000,0.00287312,0,0,1,1,2
"88321",44160500,1000,0.00282541,0,0,1,2,3
"88322",44161000,1000,0.00263671,0,0,0,1,1
"88323",44161500,1000,0.00304362,0,1,1,0,2
"88324",44162000,1000,0.00307677,0,1,1,0,2
"88325",44162500,1000,0.00262785,0,0,0,1,1
"88326",44163000,1000,0.00269741,0,0,1,2,3
"88327",44163500,1000,0.00275623,0,0,1,3,4
"88328",44164000,1000,0.00269804,0,0,1,3,4
"88329",44164500,1000,0.00279788,0,0,2,2,4
"88330",44165000,1000,0.00286959,0,0,1,4,5
"88331",44165500,1000,0.00278019,0,0,0,5,5
"88332",44166000,1000,0.00274568,0,0,0,2,2
"88333",44166500,1000,0.00268037,0,0,0,0,0
"88334",44167000,1000,0.00262348,0,0,0,0,0
"88335",44167500,1000,0.00269772,0,0,0,1,1
"88336",44168000,1000,0.00267916,0,0,0,1,1
"88337",44168500,1000,0.00280273,0,0,1,3,4
"88338",44169000,1000,0.00273293,0,0,1,3,4
"88339",44169500,1000,0.00273735,0,0,1,2,3
"88340",44170000,1000,0.00285824,0,0,1,2,3
"88341",44170500,1000,0.00278039,0,0,0,0,0
"88342",44171000,1000,0.00276406,0,0,0,1,1
"88343",44171500,1000,0.0027759,0,0,0,2,2
"88344",44172000,1000,0.00289355,0,0,1,1,2
"88345",44172500,1000,0.00286291,0,0,1,1,2
"88346",44173000,1000,0.00275925,0,0,0,2,2
"88347",44173500,1000,0.00266524,0,0,0,1,1
"88348",44174000,1000,0.00269366,0,0,0,3,3
"88349",44174500,1000,0.00289568,0,0,0,6,6
"88350",44175000,1000,0.00289461,0,0,1,4,5
"88351",44175500,1000,0.00259104,0,0,1,1,2
"88352",44176000,1000,0.00257133,0,0,0,0,0
"88353",44176500,1000,0.00263153,0,0,0,0,0
"88354",44177000,1000,0.00252558,0,0,0,0,0
"88355",44177500,1000,0.00256473,0,0,0,0,0
"88356",44178000,1000,0.00270779,0,0,0,1,1
"88357",44178500,1000,0.00292469,0,0,1,2,3
"88358",44179000,1000,0.00306084,0,0,1,5,6
"88359",44179500,1000,0.00273206,0,0,0,4,4
"88360",44180000,1000,0.00249685,0,0,0,0,0
"88361",44180500,1000,0.0024382,0,0,0,0,0
"88362",44181000,1000,0.00236574,0,0,0,0,0
"88363",44181500,1000,0.00266478,0,1,0,0,1
"88364",44182000,1000,0.00276287,0,1,0,1,2
"88365",44182500,1000,0.0026877,0,0,0,2,2
"88366",44183000,1000,0.00284047,0,0,1,1,2
"88367",44183500,1000,0.00290031,0,0,1,3,4
"88368",44184000,1000,0.00278762,0,0,0,3,3
"88369",44184500,1000,0.00272487,0,0,0,1,1
"88370",44185000,1000,0.00270879,0,0,0,1,1
"88371",44185500,1000,0.00274583,0,0,0,2,2
"88372",44186000,1000,0.00273183,0,0,0,3,3
"88373",44186500,1000,0.00256095,0,0,0,1,1
"88374",44187000,1000,0.00250373,0,0,0,0,0
"88375",44187500,1000,0.00260079,0,0,0,0,0
"88376",44188000,1000,0.00265993,0,0,0,0,0
"88377",44188500,1000,0.00269884,0,0,0,0,0
"88378",44189000,1000,0.00264281,0,0,0,0,0
"88379",44189500,1000,0.00260994,0,0,0,1,1
"88380",44190000,1000,0.00270941,0,0,1,1,2
"88381",44190500,1000,0.0027384,0,0,1,0,1
"88382",44191000,1000,0.00268984,0,0,0,0,0
"88383",44191500,1000,0.00263176,0,0,0,0,0
"88384",44192000,1000,0.00255767,0,0,0,0,0
"88385",44192500,1000,0.00258484,0,0,0,0,0
"88386",44193000,1000,0.00263214,0,0,0,0,0
"88387",44193500,1000,0.00270576,0,0,0,1,1
"88388",44194000,1000,0.00268554,0,0,0,1,1
"88389",44194500,1000,0.00261517,0,0,0,0,0
"88390",44195000,1000,0.00285991,0,0,0,4,4
"88391",44195500,1000,0.00290534,0,0,0,5,5
"88392",44196000,1000,0.00269035,0,0,1,1,2
"88393",44196500,1000,0.00271304,0,0,2,0,2
"88394",44197000,1000,0.00279276,0,0,1,1,2
"88395",44197500,1000,0.00271866,0,0,0,1,1
"88396",44198000,1000,0.00262182,0,0,0,0,0
"88397",44198500,1000,0.00258931,0,0,0,1,1
"88398",44199000,1000,0.00241722,0,0,0,1,1
"88399",44199500,1000,0.0022522,0,0,0,0,0
"88400",44200000,1000,0.00230151,0,0,0,0,0
"88401",44200500,1000,0.0024484,0,0,0,0,0
"88402",44201000,1000,0.00259503,0,0,0,0,0
"88403",44201500,1000,0.00274806,0,0,0,1,1
"88404",44202000,1000,0.00279328,0,0,1,1,2
"88405",44202500,1000,0.00281925,0,0,1,1,2
"88406",44203000,1000,0.00277165,0,0,0,1,1
"88407",44203500,1000,0.00265563,0,0,0,1,1
"88408",44204000,1000,0.0027957,0,1,0,1,2
"88409",44204500,1000,0.00282815,0,1,0,0,1
"88410",44205000,1000,0.00265263,0,0,0,1,1
"88411",44205500,1000,0.00265314,0,1,0,1,2
"88412",44206000,1000,0.00274588,0,1,0,0,1
"88413",44206500,1000,0.0026552,0,0,0,0,0
"88414",44207000,1000,0.00264618,0,0,0,0,0
"88415",44207500,1000,0.00278324,0,0,0,0,0
"88416",44208000,1000,0.00270265,0,0,0,1,1
"88417",44208500,1000,0.00275186,0,0,1,4,5
"88418",44209000,1000,0.00281393,0,0,1,3,4
"88419",44209500,1000,0.00281848,0,1,0,0,1
"88420",44210000,1000,0.00281824,0,1,0,1,2
"88421",44210500,1000,0.00266199,0,0,0,2,2
"88422",44211000,1000,0.00275709,0,0,0,2,2
"88423",44211500,1000,0.0028409,0,0,0,1,1
"88424",44212000,1000,0.0027619,0,0,0,0,0
"88425",44212500,1000,0.00264916,0,0,0,0,0
"88426",44213000,1000,0.00261815,0,0,0,0,0
"88427",44213500,1000,0.00272368,0,0,0,0,0
"88428",44214000,1000,0.00287207,0,0,0,1,1
"88429",44214500,1000,0.00286234,0,0,0,1,1
"88430",44215000,1000,0.00275884,0,0,0,0,0
"88431",44215500,1000,0.00289438,0,0,1,0,1
"88432",44216000,1000,0.00293952,0,1,1,0,2
"88433",44216500,1000,0.00267647,0,1,0,0,1
"88434",44217000,1000,0.00255927,0,0,0,0,0
"88435",44217500,1000,0.00266259,0,0,0,1,1
"88436",44218000,1000,0.00266585,0,0,0,1,1
"88437",44218500,1000,0.00238639,0,0,0,0,0
"88438",44219000,1000,0.00214129,0,0,0,0,0
"88439",44219500,1000,0.0021892,0,0,0,0,0
"88440",44220000,1000,0.00230814,0,0,0,0,0
"88441",44220500,1000,0.00235852,0,0,0,0,0
"88442",44221000,1000,0.00237095,0,0,0,0,0
"88443",44221500,1000,0.00236996,0,0,0,0,0
"88444",44222000,1000,0.00237009,0,0,0,0,0
"88445",44222500,1000,0.00248218,0,0,0,0,0
"88446",44223000,1000,0.00256503,0,0,0,0,0
"88447",44223500,1000,0.00262344,0,0,0,0,0
"88448",44224000,1000,0.00257572,0,0,0,0,0
"88449",44224500,1000,0.00251037,0,0,0,0,0
"88450",44225000,1000,0.00270576,0,0,1,2,3
"88451",44225500,1000,0.0028439,0,0,1,2,3
"88452",44226000,1000,0.00282234,0,0,0,2,2
"88453",44226500,1000,0.00274478,0,0,0,3,3
"88454",44227000,1000,0.00264095,0,0,0,1,1
"88455",44227500,1000,0.00259905,0,0,0,0,0
"88456",44228000,1000,0.00268982,0,0,0,2,2
"88457",44228500,1000,0.00271977,0,0,0,2,2
"88458",44229000,1000,0.00284592,0,0,1,1,2
"88459",44229500,1000,0.002906,0,0,1,1,2
"88460",44230000,1000,0.00281231,0,0,0,1,1
"88461",44230500,1000,0.00282998,0,0,0,1,1
"88462",44231000,1000,0.00272857,0,0,0,1,1
"88463",44231500,1000,0.00265282,0,0,0,2,2
"88464",44232000,1000,0.00272504,0,0,1,3,4
"88465",44232500,1000,0.00263473,0,0,1,2,3
"88466",44233000,1000,0.00254134,0,0,0,2,2
"88467",44233500,1000,0.00263192,0,0,0,4,4
"88468",44234000,1000,0.00258251,0,0,0,2,2
"88469",44234500,1000,0.00267577,0,0,0,2,2
"88470",44235000,1000,0.00302581,0,1,0,2,3
"88471",44235500,1000,0.00292888,0,1,0,1,2
"88472",44236000,1000,0.00278531,0,0,0,3,3
"88473",44236500,1000,0.00283142,0,0,0,2,2
"88474",44237000,1000,0.0027919,0,0,0,1,1
"88475",44237500,1000,0.00272116,0,0,0,1,1
"88476",44238000,1000,0.00250082,0,0,0,0,0
"88477",44238500,1000,0.00233039,0,0,0,0,0
"88478",44239000,1000,0.00250704,0,0,0,0,0
"88479",44239500,1000,0.00273389,0,0,1,0,1
"88480",44240000,1000,0.00273723,0,0,1,0,1
"88481",44240500,1000,0.0027657,0,0,1,1,2
"88482",44241000,1000,0.0026648,0,0,1,2,3
"88483",44241500,1000,0.00296054,0,1,0,1,2
"88484",44242000,1000,0.00297854,0,1,0,1,2
"88485",44242500,1000,0.00256449,0,0,0,2,2
"88486",44243000,1000,0.00268519,0,0,1,2,3
"88487",44243500,1000,0.00265607,0,0,1,1,2
"88488",44244000,1000,0.00268949,0,0,1,1,2
"88489",44244500,1000,0.00280192,0,0,1,2,3
"88490",44245000,1000,0.0027794,0,0,0,3,3
"88491",44245500,1000,0.00274744,0,0,0,2,2
"88492",44246000,1000,0.00269949,0,0,0,2,2
"88493",44246500,1000,0.00271085,0,0,0,2,2
"88494",44247000,1000,0.0026901,0,0,0,0,0
"88495",44247500,1000,0.00268582,0,0,0,0,0
"88496",44248000,1000,0.00262622,0,0,0,1,1
"88497",44248500,1000,0.00259659,0,0,0,1,1
"88498",44249000,1000,0.00267007,0,0,0,2,2
"88499",44249500,1000,0.00275866,0,0,0,3,3
"88500",44250000,1000,0.00282404,0,0,0,2,2
"88501",44250500,1000,0.00302922,0,0,1,3,4
"88502",44251000,1000,0.00306354,0,0,1,2,3
"88503",44251500,1000,0.00278226,0,0,0,0,0
"88504",44252000,1000,0.00268522,0,0,1,0,1
"88505",44252500,1000,0.0028457,0,0,1,2,3
"88506",44253000,1000,0.00282508,0,0,0,3,3
"88507",44253500,1000,0.00266774,0,0,0,2,2
"88508",44254000,1000,0.00274419,0,0,1,2,3
"88509",44254500,1000,0.00277617,0,0,1,2,3
"88510",44255000,1000,0.00267855,0,0,0,1,1
"88511",44255500,1000,0.00274027,0,0,1,0,1
"88512",44256000,1000,0.00260033,0,0,1,0,1
"88513",44256500,1000,0.00273791,0,0,0,2,2
"88514",44257000,1000,0.00302117,0,0,0,4,4
"88515",44257500,1000,0.00301316,0,0,1,3,4
"88516",44258000,1000,0.00290564,0,0,1,1,2
"88517",44258500,1000,0.00293792,0,1,0,0,1
"88518",44259000,1000,0.00286485,0,1,0,0,1
"88519",44259500,1000,0.00280461,0,0,1,1,2
"88520",44260000,1000,0.0028288,0,0,1,1,2
"88521",44260500,1000,0.00274978,0,0,0,1,1
"88522",44261000,1000,0.00270076,0,0,0,1,1
"88523",44261500,1000,0.00262233,0,0,0,0,0
"88524",44262000,1000,0.00263632,0,0,0,0,0
"88525",44262500,1000,0.00267788,0,0,0,0,0
"88526",44263000,1000,0.00300257,0,1,0,0,1
"88527",44263500,1000,0.00290421,0,1,0,1,2
"88528",44264000,1000,0.00262884,0,0,0,2,2
"88529",44264500,1000,0.00265059,0,0,0,1,1
"88530",44265000,1000,0.00263774,0,0,0,0,0
"88531",44265500,1000,0.00271605,0,0,0,2,2
"88532",44266000,1000,0.00275482,0,0,0,2,2
"88533",44266500,1000,0.00270771,0,0,0,0,0
"88534",44267000,1000,0.00264312,0,0,0,0,0
"88535",44267500,1000,0.00267655,0,0,0,0,0
"88536",44268000,1000,0.00271997,0,0,0,0,0
"88537",44268500,1000,0.00271431,0,0,0,0,0
"88538",44269000,1000,0.00273567,0,0,0,0,0
"88539",44269500,1000,0.00279667,0,0,0,0,0
"88540",44270000,1000,0.00276125,0,0,0,1,1
"88541",44270500,1000,0.00271302,0,0,0,2,2
"88542",44271000,1000,0.00277419,0,0,0,1,1
"88543",44271500,1000,0.00267874,0,0,0,1,1
"88544",44272000,1000,0.00272243,0,0,0,2,2
"88545",44272500,1000,0.00284111,0,0,0,3,3
"88546",44273000,1000,0.0027279,0,0,0,2,2
"88547",44273500,1000,0.00272194,0,0,1,1,2
"88548",44274000,1000,0.00280359,0,0,1,3,4
"88549",44274500,1000,0.00297512,0,0,2,4,6
"88550",44275000,1000,0.002965,0,0,3,3,6
"88551",44275500,1000,0.00284851,0,0,1,4,5
"88552",44276000,1000,0.00281904,0,0,0,4,4
"88553",44276500,1000,0.00259839,0,0,0,1,1
"88554",44277000,1000,0.00254617,0,0,0,1,1
"88555",44277500,1000,0.002669,0,0,0,2,2
"88556",44278000,1000,0.00273807,0,0,0,2,2
"88557",44278500,1000,0.00272168,0,0,0,2,2
"88558",44279000,1000,0.00268321,0,0,1,1,2
"88559",44279500,1000,0.00284662,0,0,2,1,3
"88560",44280000,1000,0.00304734,0,1,1,1,3
"88561",44280500,1000,0.00286578,0,1,0,0,1
"88562",44281000,1000,0.00258898,0,0,0,0,0
"88563",44281500,1000,0.00260177,0,0,0,0,0
"88564",44282000,1000,0.00275915,0,0,1,1,2
"88565",44282500,1000,0.00272581,0,0,1,1,2
"88566",44283000,1000,0.00280675,0,0,1,1,2
"88567",44283500,1000,0.00282021,0,0,1,1,2
"88568",44284000,1000,0.00272371,0,0,0,0,0
"88569",44284500,1000,0.00283486,0,0,0,1,1
"88570",44285000,1000,0.00289717,0,0,1,1,2
"88571",44285500,1000,0.00288398,0,0,2,0,2
"88572",44286000,1000,0.00280294,0,0,2,0,2
"88573",44286500,1000,0.00274363,0,0,1,2,3
"88574",44287000,1000,0.00278874,0,0,0,4,4
"88575",44287500,1000,0.00270398,0,0,0,2,2
"88576",44288000,1000,0.00258453,0,0,0,1,1
"88577",44288500,1000,0.0026726,0,0,0,2,2
"88578",44289000,1000,0.0026724,0,0,0,2,2
"88579",44289500,1000,0.00271649,0,0,0,3,3
"88580",44290000,1000,0.00270612,0,0,0,2,2
"88581",44290500,1000,0.00272853,0,0,0,3,3
"88582",44291000,1000,0.00283668,0,1,0,3,4
"88583",44291500,1000,0.00271112,0,1,0,1,2
"88584",44292000,1000,0.00267583,0,0,0,1,1
"88585",44292500,1000,0.00270887,0,0,0,0,0
"88586",44293000,1000,0.0028439,0,0,1,1,2
"88587",44293500,1000,0.00290346,0,0,1,1,2
"88588",44294000,1000,0.00286902,0,0,1,1,2
"88589",44294500,1000,0.0027666,0,0,1,1,2
"88590",44295000,1000,0.00269019,0,0,0,1,1
"88591",44295500,1000,0.0027737,0,0,0,2,2
"88592",44296000,1000,0.00269441,0,0,0,2,2
"88593",44296500,1000,0.00267167,0,0,0,1,1
"88594",44297000,1000,0.00279727,0,0,1,1,2
"88595",44297500,1000,0.0028412,0,1,1,1,3
"88596",44298000,1000,0.00272467,0,1,0,0,1
"88597",44298500,1000,0.00269719,0,0,0,0,0
"88598",44299000,1000,0.00284963,0,0,1,1,2
"88599",44299500,1000,0.00278539,0,0,1,1,2
"88600",44300000,1000,0.00262862,0,0,0,2,2
"88601",44300500,1000,0.00258351,0,0,0,3,3
"88602",44301000,1000,0.00272574,0,0,2,2,4
"88603",44301500,1000,0.00269404,0,0,2,1,3
"88604",44302000,1000,0.00260514,0,0,0,1,1
"88605",44302500,1000,0.0027932,0,0,1,2,3
"88606",44303000,1000,0.00264919,0,0,1,1,2
"88607",44303500,1000,0.00256391,0,0,0,1,1
"88608",44304000,1000,0.00281849,0,0,1,2,3
"88609",44304500,1000,0.00275147,0,0,1,1,2
"88610",44305000,1000,0.00251797,0,0,0,0,0
"88611",44305500,1000,0.00264364,0,0,0,1,1
"88612",44306000,1000,0.00266715,0,0,0,3,3
"88613",44306500,1000,0.00271439,0,0,0,2,2
"88614",44307000,1000,0.00280474,0,0,0,1,1
"88615",44307500,1000,0.00264684,0,0,0,2,2
"88616",44308000,1000,0.00264679,0,0,1,1,2
"88617",44308500,1000,0.00261717,0,0,1,0,1
"88618",44309000,1000,0.00264663,0,1,0,1,2
"88619",44309500,1000,0.00278432,0,1,0,1,2
"88620",44310000,1000,0.00274614,0,0,0,0,0
"88621",44310500,1000,0.00264225,0,0,0,0,0
"88622",44311000,1000,0.0026938,0,0,0,1,1
"88623",44311500,1000,0.00262251,0,0,0,1,1
"88624",44312000,1000,0.00269439,0,1,0,0,1
"88625",44312500,1000,0.00283515,0,1,0,0,1
"88626",44313000,1000,0.00276997,0,0,0,1,1
"88627",44313500,1000,0.00292744,0,0,1,2,3
"88628",44314000,1000,0.00283939,0,0,1,1,2
"88629",44314500,1000,0.00271919,0,0,0,1,1
"88630",44315000,1000,0.00269266,0,0,0,1,1
"88631",44315500,1000,0.00271713,0,0,0,0,0
"88632",44316000,1000,0.00268104,0,0,0,0,0
"88633",44316500,1000,0.0026192,0,0,0,0,0
"88634",44317000,1000,0.00281477,0,0,1,1,2
"88635",44317500,1000,0.00292615,0,0,1,3,4
"88636",44318000,1000,0.00280522,0,0,0,4,4
"88637",44318500,1000,0.00273543,0,0,1,2,3
"88638",44319000,1000,0.00279534,0,0,1,1,2
"88639",44319500,1000,0.00281196,0,0,0,1,1
"88640",44320000,1000,0.00287298,0,1,0,0,1
"88641",44320500,1000,0.0028332,0,1,0,0,1
"88642",44321000,1000,0.00275104,0,0,0,1,1
"88643",44321500,1000,0.00276948,0,0,0,1,1
"88644",44322000,1000,0.00275813,0,0,0,1,1
"88645",44322500,1000,0.00266923,0,0,0,1,1
"88646",44323000,1000,0.00276742,0,0,1,0,1
"88647",44323500,1000,0.00293747,0,0,2,1,3
"88648",44324000,1000,0.002885,0,0,3,1,4
"88649",44324500,1000,0.00261844,0,0,2,0,2
"88650",44325000,1000,0.0024506,0,0,0,0,0
"88651",44325500,1000,0.00267029,0,0,1,0,1
"88652",44326000,1000,0.00281856,0,0,2,2,4
"88653",44326500,1000,0.00262236,0,0,1,2,3
"88654",44327000,1000,0.00279409,0,1,0,2,3
"88655",44327500,1000,0.00300692,0,1,1,4,6
"88656",44328000,1000,0.00284579,0,0,1,2,3
"88657",44328500,1000,0.00279337,0,0,0,0,0
"88658",44329000,1000,0.00277447,0,0,1,1,2
"88659",44329500,1000,0.00272523,0,0,1,3,4
"88660",44330000,1000,0.00271588,0,0,0,3,3
"88661",44330500,1000,0.00283886,0,1,0,1,2
"88662",44331000,1000,0.00285807,0,1,1,0,2
"88663",44331500,1000,0.00276132,0,0,1,1,2
"88664",44332000,1000,0.00273686,0,0,0,1,1
"88665",44332500,1000,0.00263428,0,0,0,1,1
"88666",44333000,1000,0.00259667,0,0,0,2,2
"88667",44333500,1000,0.00274657,0,0,0,1,1
"88668",44334000,1000,0.00288569,0,0,0,2,2
"88669",44334500,1000,0.00278641,0,0,0,3,3
"88670",44335000,1000,0.00258527,0,0,0,1,1
"88671",44335500,1000,0.00265636,0,0,0,1,1
"88672",44336000,1000,0.0027254,0,0,0,1,1
"88673",44336500,1000,0.00277306,0,0,1,1,2
"88674",44337000,1000,0.00275044,0,0,1,2,3
"88675",44337500,1000,0.00260504,0,0,0,1,1
"88676",44338000,1000,0.00249635,0,0,0,0,0
"88677",44338500,1000,0.00253244,0,0,0,0,0
"88678",44339000,1000,0.00264634,0,0,0,1,1
"88679",44339500,1000,0.00262683,0,0,0,2,2
"88680",44340000,1000,0.00270883,0,1,0,1,2
"88681",44340500,1000,0.00280992,0,1,0,0,1
"88682",44341000,1000,0.00270901,0,0,0,0,0
"88683",44341500,1000,0.0026877,0,0,0,0,0
"88684",44342000,1000,0.00279862,0,0,1,1,2
"88685",44342500,1000,0.00271674,0,0,1,1,2
"88686",44343000,1000,0.0026192,0,0,0,0,0
"88687",44343500,1000,0.00266129,0,0,0,0,0
"88688",44344000,1000,0.00267459,0,0,0,0,0
"88689",44344500,1000,0.00278475,0,1,0,0,1
"88690",44345000,1000,0.00275228,0,1,0,0,1
"88691",44345500,1000,0.00255035,0,0,0,0,0
"88692",44346000,1000,0.00266601,0,0,0,0,0
"88693",44346500,1000,0.00302371,0,1,0,1,2
"88694",44347000,1000,0.00291481,0,1,0,1,2
"88695",44347500,1000,0.00276838,0,0,0,4,4
"88696",44348000,1000,0.00284147,0,0,0,5,5
"88697",44348500,1000,0.00284279,0,1,0,1,2
"88698",44349000,1000,0.00274603,0,1,0,0,1
"88699",44349500,1000,0.00268835,0,0,0,0,0
"88700",44350000,1000,0.00277324,0,0,0,0,0
"88701",44350500,1000,0.00270303,0,0,0,0,0
"88702",44351000,1000,0.00283068,0,0,1,1,2
"88703",44351500,1000,0.00283606,0,0,1,2,3
"88704",44352000,1000,0.00263742,0,0,0,1,1
"88705",44352500,1000,0.00263546,0,0,0,1,1
"88706",44353000,1000,0.00270635,0,0,0,1,1
"88707",44353500,1000,0.00259947,0,0,0,0,0
"88708",44354000,1000,0.00242492,0,0,0,0,0
"88709",44354500,1000,0.00247126,0,0,0,0,0
"88710",44355000,1000,0.00258118,0,0,0,0,0
"88711",44355500,1000,0.00284901,0,0,0,1,1
"88712",44356000,1000,0.0029125,0,0,0,1,1
"88713",44356500,1000,0.00268629,0,0,0,0,0
"88714",44357000,1000,0.00289397,0,0,1,3,4
"88715",44357500,1000,0.00289093,0,0,1,4,5
"88716",44358000,1000,0.00276467,0,0,1,2,3
"88717",44358500,1000,0.00278688,0,0,1,1,2
"88718",44359000,1000,0.00276475,0,0,0,2,2
"88719",44359500,1000,0.00278698,0,0,1,2,3
"88720",44360000,1000,0.00266825,0,0,1,0,1
"88721",44360500,1000,0.00260216,0,0,0,1,1
"88722",44361000,1000,0.00266934,0,0,1,1,2
"88723",44361500,1000,0.00270207,0,0,1,0,1
"88724",44362000,1000,0.00256761,0,0,0,0,0
"88725",44362500,1000,0.00255691,0,0,0,1,1
"88726",44363000,1000,0.00247824,0,0,0,1,1
"88727",44363500,1000,0.00232089,0,0,0,0,0
"88728",44364000,1000,0.00239859,0,0,0,0,0
"88729",44364500,1000,0.00261556,0,0,0,1,1
"88730",44365000,1000,0.00282454,0,0,0,3,3
"88731",44365500,1000,0.00289601,0,0,0,3,3
"88732",44366000,1000,0.00274508,0,0,0,1,1
"88733",44366500,1000,0.00267084,0,0,0,0,0
"88734",44367000,1000,0.00282911,0,0,1,0,1
"88735",44367500,1000,0.00278954,0,0,1,0,1
"88736",44368000,1000,0.00266726,0,0,1,0,1
"88737",44368500,1000,0.00266241,0,0,1,1,2
"88738",44369000,1000,0.00261625,0,0,0,1,1
"88739",44369500,1000,0.00267718,0,0,0,0,0
"88740",44370000,1000,0.00274318,0,0,0,0,0
"88741",44370500,1000,0.00268208,0,0,0,1,1
"88742",44371000,1000,0.00274973,0,0,1,1,2
"88743",44371500,1000,0.00278781,0,0,1,0,1
"88744",44372000,1000,0.00285239,0,0,1,1,2
"88745",44372500,1000,0.00279631,0,0,1,3,4
"88746",44373000,1000,0.00281425,0,0,1,4,5
"88747",44373500,1000,0.00286324,0,0,1,2,3
"88748",44374000,1000,0.00283993,0,0,1,0,1
"88749",44374500,1000,0.00302216,0,0,2,1,3
"88750",44375000,1000,0.00289228,0,0,1,2,3
"88751",44375500,1000,0.00271022,0,0,0,1,1
"88752",44376000,1000,0.00274375,0,0,0,0,0
"88753",44376500,1000,0.00288687,0,0,2,1,3
"88754",44377000,1000,0.00294608,0,0,2,3,5
"88755",44377500,1000,0.00277197,0,0,0,3,3
"88756",44378000,1000,0.00258031,0,0,0,1,1
"88757",44378500,1000,0.00256282,0,0,0,0,0
"88758",44379000,1000,0.00278995,0,0,0,4,4
"88759",44379500,1000,0.00289007,0,0,0,4,4
"88760",44380000,1000,0.00275118,0,0,0,1,1
"88761",44380500,1000,0.00272934,0,0,0,1,1
"88762",44381000,1000,0.0026446,0,0,0,0,0
"88763",44381500,1000,0.00268519,0,0,1,1,2
"88764",44382000,1000,0.0027115,0,0,1,1,2
"88765",44382500,1000,0.00263165,0,0,0,0,0
"88766",44383000,1000,0.00272799,0,0,0,0,0
"88767",44383500,1000,0.00273069,0,0,0,0,0
"88768",44384000,1000,0.00258553,0,0,0,0,0
"88769",44384500,1000,0.00254304,0,0,0,0,0
"88770",44385000,1000,0.00256432,0,0,0,0,0
"88771",44385500,1000,0.00248493,0,0,0,0,0
"88772",44386000,1000,0.00264369,0,0,0,3,3
"88773",44386500,1000,0.00280935,0,0,0,4,4
"88774",44387000,1000,0.00278234,0,0,0,3,3
"88775",44387500,1000,0.002735,0,0,0,2,2
"88776",44388000,1000,0.00271998,0,0,0,0,0
"88777",44388500,1000,0.00280906,0,0,0,2,2
"88778",44389000,1000,0.00281821,0,0,0,2,2
"88779",44389500,1000,0.00265497,0,0,0,0,0
"88780",44390000,1000,0.00258533,0,0,0,0,0
"88781",44390500,1000,0.00261651,0,0,0,1,1
"88782",44391000,1000,0.00260825,0,0,0,2,2
"88783",44391500,1000,0.00269397,0,0,0,4,4
"88784",44392000,1000,0.0027041,0,0,0,3,3
"88785",44392500,1000,0.00263072,0,0,0,0,0
"88786",44393000,1000,0.0026711,0,0,0,0,0
"88787",44393500,1000,0.00264663,0,0,0,0,0
"88788",44394000,1000,0.00272077,0,0,0,1,1
"88789",44394500,1000,0.00274742,0,0,0,1,1
"88790",44395000,1000,0.00260487,0,0,0,1,1
"88791",44395500,1000,0.00253887,0,0,0,1,1
"88792",44396000,1000,0.00256358,0,0,0,0,0
"88793",44396500,1000,0.00250465,0,0,0,0,0
"88794",44397000,1000,0.00252275,0,0,0,1,1
"88795",44397500,1000,0.0027964,0,1,0,1,2
"88796",44398000,1000,0.00292753,0,1,0,2,3
"88797",44398500,1000,0.00282153,0,0,0,2,2
"88798",44399000,1000,0.00279126,0,0,0,1,1
"88799",44399500,1000,0.00277442,0,0,0,1,1
"88800",44400000,1000,0.00256805,0,0,0,0,0
"88801",44400500,1000,0.00256334,0,0,0,0,0
"88802",44401000,1000,0.00277553,0,0,0,1,1
"88803",44401500,1000,0.00281384,0,0,1,1,2
"88804",44402000,1000,0.00274907,0,0,1,1,2
"88805",44402500,1000,0.00270006,0,0,0,2,2
"88806",44403000,1000,0.00272688,0,0,0,2,2
"88807",44403500,1000,0.00277763,0,0,1,1,2
"88808",44404000,1000,0.00265206,0,0,1,0,1
"88809",44404500,1000,0.00250103,0,0,0,0,0
"88810",44405000,1000,0.00246633,0,0,0,0,0
"88811",44405500,1000,0.00256096,0,0,0,2,2
"88812",44406000,1000,0.00260539,0,0,0,2,2
"88813",44406500,1000,0.00258299,0,0,0,0,0
"88814",44407000,1000,0.00263045,0,0,0,0,0
"88815",44407500,1000,0.00262735,0,0,0,1,1
"88816",44408000,1000,0.00258558,0,0,1,1,2
"88817",44408500,1000,0.0025493,0,0,1,0,1
"88818",44409000,1000,0.00267398,0,0,0,2,2
"88819",44409500,1000,0.00263737,0,0,0,2,2
"88820",44410000,1000,0.00249407,0,0,0,0,0
"88821",44410500,1000,0.0026045,0,0,0,0,0
"88822",44411000,1000,0.00268935,0,0,0,0,0
"88823",44411500,1000,0.0026689,0,0,0,1,1
"88824",44412000,1000,0.00296078,0,1,0,3,4
"88825",44412500,1000,0.00314764,0,1,0,4,5
"88826",44413000,1000,0.00270915,0,0,0,2,2
"88827",44413500,1000,0.00250338,0,0,0,0,0
"88828",44414000,1000,0.00262048,0,0,0,0,0
"88829",44414500,1000,0.00260877,0,0,0,1,1
"88830",44415000,1000,0.00256276,0,0,0,1,1
"88831",44415500,1000,0.00251625,0,0,0,0,0
"88832",44416000,1000,0.00247299,0,0,0,0,0
"88833",44416500,1000,0.00259072,0,0,0,0,0
"88834",44417000,1000,0.00265551,0,0,0,0,0
"88835",44417500,1000,0.00257333,0,0,0,0,0
"88836",44418000,1000,0.00253152,0,0,0,0,0
"88837",44418500,1000,0.0026273,0,0,1,1,2
"88838",44419000,1000,0.00269549,0,0,2,1,3
"88839",44419500,1000,0.00264204,0,0,1,0,1
"88840",44420000,1000,0.00258028,0,0,0,0,0
"88841",44420500,1000,0.00256436,0,0,0,0,0
"88842",44421000,1000,0.00269388,0,0,0,2,2
"88843",44421500,1000,0.00281055,0,0,1,3,4
"88844",44422000,1000,0.00275391,0,0,1,2,3
"88845",44422500,1000,0.00265762,0,0,0,3,3
"88846",44423000,1000,0.00269482,0,0,0,3,3
"88847",44423500,1000,0.00256064,0,0,0,1,1
"88848",44424000,1000,0.00254969,0,0,0,0,0
"88849",44424500,1000,0.00262003,0,0,0,0,0
"88850",44425000,1000,0.00261701,0,0,0,0,0
"88851",44425500,1000,0.00272243,0,0,0,1,1
"88852",44426000,1000,0.00268995,0,0,0,2,2
"88853",44426500,1000,0.0026433,0,0,0,1,1
"88854",44427000,1000,0.00254276,0,0,0,0,0
"88855",44427500,1000,0.0023854,0,0,0,0,0
"88856",44428000,1000,0.00261545,0,0,0,2,2
"88857",44428500,1000,0.00295215,0,0,1,3,4
"88858",44429000,1000,0.00273605,0,0,1,1,2
"88859",44429500,1000,0.00273172,0,0,1,1,2
"88860",44430000,1000,0.00264822,0,0,1,1,2
"88861",44430500,1000,0.00257117,0,0,1,1,2
"88862",44431000,1000,0.00282455,0,0,1,3,4
"88863",44431500,1000,0.00271123,0,0,0,3,3
"88864",44432000,1000,0.00254802,0,0,0,1,1
"88865",44432500,1000,0.00257497,0,0,0,0,0
"88866",44433000,1000,0.00267698,0,0,0,2,2
"88867",44433500,1000,0.00263992,0,0,0,4,4
"88868",44434000,1000,0.00250587,0,0,0,3,3
"88869",44434500,1000,0.00265224,0,0,1,2,3
"88870",44435000,1000,0.00276537,0,0,1,1,2
"88871",44435500,1000,0.00276967,0,0,0,1,1
"88872",44436000,1000,0.00267199,0,0,0,1,1
"88873",44436500,1000,0.00248295,0,0,0,0,0
"88874",44437000,1000,0.00253342,0,0,0,0,0
"88875",44437500,1000,0.002596,0,0,0,0,0
"88876",44438000,1000,0.00251299,0,0,0,0,0
"88877",44438500,1000,0.00263836,0,0,0,2,2
"88878",44439000,1000,0.00277505,0,0,0,2,2
"88879",44439500,1000,0.00267854,0,0,0,1,1
"88880",44440000,1000,0.00265544,0,0,0,1,1
"88881",44440500,1000,0.00261585,0,0,0,0,0
"88882",44441000,1000,0.00266649,0,0,1,0,1
"88883",44441500,1000,0.00283767,0,0,2,3,5
"88884",44442000,1000,0.00273847,0,0,1,3,4
"88885",44442500,1000,0.00262595,0,0,0,2,2
"88886",44443000,1000,0.00259377,0,0,0,2,2
"88887",44443500,1000,0.00255012,0,0,0,1,1
"88888",44444000,1000,0.00254054,0,0,0,1,1
"88889",44444500,1000,0.00273077,0,1,0,0,1
"88890",44445000,1000,0.00276708,0,1,0,1,2
"88891",44445500,1000,0.00253972,0,0,0,1,1
"88892",44446000,1000,0.00281507,0,0,1,3,4
"88893",44446500,1000,0.00287741,0,0,1,4,5
"88894",44447000,1000,0.00289149,0,0,2,2,4
"88895",44447500,1000,0.00281761,0,0,2,1,3
"88896",44448000,1000,0.00256526,0,0,0,1,1
"88897",44448500,1000,0.00257726,0,0,0,1,1
"88898",44449000,1000,0.00266887,0,0,1,0,1
"88899",44449500,1000,0.00273484,0,0,1,1,2
"88900",44450000,1000,0.00263457,0,0,0,2,2
"88901",44450500,1000,0.00251326,0,0,0,1,1
"88902",44451000,1000,0.00256755,0,0,0,1,1
"88903",44451500,1000,0.00265417,0,0,0,1,1
"88904",44452000,1000,0.00262664,0,0,0,2,2
"88905",44452500,1000,0.0025618,0,0,0,2,2
"88906",44453000,1000,0.00255228,0,0,0,1,1
"88907",44453500,1000,0.00267998,0,0,0,3,3
"88908",44454000,1000,0.00273769,0,0,0,2,2
"88909",44454500,1000,0.00277715,0,0,1,0,1
"88910",44455000,1000,0.00268197,0,0,1,0,1
"88911",44455500,1000,0.00249119,0,0,0,0,0
"88912",44456000,1000,0.00249665,0,0,0,0,0
"88913",44456500,1000,0.00263668,0,0,0,1,1
"88914",44457000,1000,0.00269307,0,0,0,4,4
"88915",44457500,1000,0.00274606,0,0,1,5,6
"88916",44458000,1000,0.0026936,0,0,1,2,3
"88917",44458500,1000,0.00259133,0,0,0,1,1
"88918",44459000,1000,0.00259152,0,0,0,1,1
"88919",44459500,1000,0.00259161,0,0,0,1,1
"88920",44460000,1000,0.00251945,0,0,0,1,1
"88921",44460500,1000,0.00251132,0,0,0,0,0
"88922",44461000,1000,0.00252965,0,0,0,0,0
"88923",44461500,1000,0.00247443,0,0,0,1,1
"88924",44462000,1000,0.00255315,0,0,0,1,1
"88925",44462500,1000,0.00260325,0,0,0,1,1
"88926",44463000,1000,0.00270221,0,0,0,1,1
"88927",44463500,1000,0.00276717,0,0,1,0,1
"88928",44464000,1000,0.00265464,0,0,1,0,1
"88929",44464500,1000,0.002606,0,0,0,0,0
"88930",44465000,1000,0.0025697,0,0,0,0,0
"88931",44465500,1000,0.0024512,0,0,0,0,0
"88932",44466000,1000,0.00247536,0,0,0,0,0
"88933",44466500,1000,0.00248746,0,0,0,0,0
"88934",44467000,1000,0.00253197,0,0,0,1,1
"88935",44467500,1000,0.0025608,0,0,0,1,1
"88936",44468000,1000,0.00274348,0,0,0,4,4
"88937",44468500,1000,0.00269427,0,0,0,4,4
"88938",44469000,1000,0.00245061,0,0,0,0,0
"88939",44469500,1000,0.00255556,0,0,0,0,0
"88940",44470000,1000,0.00272257,0,1,0,0,1
"88941",44470500,1000,0.0028953,0,1,1,1,3
"88942",44471000,1000,0.00268638,0,0,1,1,2
"88943",44471500,1000,0.0024202,0,0,0,0,0
"88944",44472000,1000,0.00244504,0,0,0,0,0
"88945",44472500,1000,0.00264615,0,0,1,1,2
"88946",44473000,1000,0.00275408,0,0,2,2,4
"88947",44473500,1000,0.00262726,0,0,1,1,2
"88948",44474000,1000,0.0024567,0,0,0,0,0
"88949",44474500,1000,0.00239567,0,0,0,0,0
"88950",44475000,1000,0.00275508,0,1,0,1,2
"88951",44475500,1000,0.00277831,0,1,0,1,2
"88952",44476000,1000,0.00258404,0,0,0,0,0
"88953",44476500,1000,0.00263228,0,0,0,1,1
"88954",44477000,1000,0.0026478,0,0,0,1,1
"88955",44477500,1000,0.00255059,0,0,0,0,0
"88956",44478000,1000,0.00259714,0,0,0,1,1
"88957",44478500,1000,0.00273342,0,0,0,2,2
"88958",44479000,1000,0.00252906,0,0,0,1,1
"88959",44479500,1000,0.00256214,0,0,0,1,1
"88960",44480000,1000,0.00266709,0,0,1,1,2
"88961",44480500,1000,0.00259564,0,0,1,0,1
"88962",44481000,1000,0.00254509,0,0,0,0,0
"88963",44481500,1000,0.00268799,0,0,1,0,1
"88964",44482000,1000,0.00284493,0,0,1,2,3
"88965",44482500,1000,0.00281095,0,0,1,3,4
"88966",44483000,1000,0.00275036,0,0,1,3,4
"88967",44483500,1000,0.00264386,0,0,0,2,2
"88968",44484000,1000,0.00261042,0,0,0,1,1
"88969",44484500,1000,0.00260839,0,0,0,1,1
"88970",44485000,1000,0.00263043,0,0,0,1,1
"88971",44485500,1000,0.0026787,0,0,0,1,1
"88972",44486000,1000,0.00255288,0,0,0,0,0
"88973",44486500,1000,0.0024507,0,0,0,0,0
"88974",44487000,1000,0.00251564,0,0,0,0,0
"88975",44487500,1000,0.00258756,0,0,0,0,0
"88976",44488000,1000,0.00268495,0,0,0,2,2
"88977",44488500,1000,0.00285714,0,0,1,5,6
"88978",44489000,1000,0.0026743,0,0,1,3,4
"88979",44489500,1000,0.00251311,0,0,0,0,0
"88980",44490000,1000,0.00263614,0,0,0,1,1
"88981",44490500,1000,0.00264973,0,0,0,2,2
"88982",44491000,1000,0.00271343,0,0,0,3,3
"88983",44491500,1000,0.00266232,0,0,0,3,3
"88984",44492000,1000,0.00272217,0,0,0,4,4
"88985",44492500,1000,0.00268477,0,0,0,3,3
"88986",44493000,1000,0.00251777,0,0,0,1,1
"88987",44493500,1000,0.00261648,0,0,1,2,3
"88988",44494000,1000,0.00270513,0,0,1,2,3
"88989",44494500,1000,0.00264739,0,0,0,1,1
"88990",44495000,1000,0.00267148,0,0,1,0,1
"88991",44495500,1000,0.00265639,0,0,1,0,1
"88992",44496000,1000,0.00259963,0,0,0,1,1
"88993",44496500,1000,0.00261977,0,0,0,1,1
"88994",44497000,1000,0.00263688,0,0,0,1,1
"88995",44497500,1000,0.00270643,0,0,0,3,3
"88996",44498000,1000,0.00269592,0,0,0,2,2
"88997",44498500,1000,0.00259804,0,0,0,0,0
"88998",44499000,1000,0.00262329,0,0,0,0,0
"88999",44499500,1000,0.00260919,0,0,0,0,0
"89000",44500000,1000,0.00255003,0,0,0,0,0
"89001",44500500,1000,0.00265397,0,0,0,0,0
"89002",44501000,1000,0.00257144,0,0,0,1,1
"89003",44501500,1000,0.00258368,0,1,0,1,2
"89004",44502000,1000,0.00271043,0,1,0,1,2
"89005",44502500,1000,0.00258515,0,0,0,1,1
"89006",44503000,1000,0.00246966,0,0,0,0,0
"89007",44503500,1000,0.00261613,0,0,1,1,2
"89008",44504000,1000,0.00264485,0,0,1,2,3
"89009",44504500,1000,0.00262644,0,0,1,2,3
"89010",44505000,1000,0.00301486,0,1,2,3,6
"89011",44505500,1000,0.00299487,0,1,1,3,5
"89012",44506000,1000,0.00274199,0,0,1,2,3
"89013",44506500,1000,0.00290865,0,0,2,2,4
"89014",44507000,1000,0.00296465,0,1,1,1,3
"89015",44507500,1000,0.00298844,0,1,0,4,5
"89016",44508000,1000,0.00296368,0,0,1,5,6
"89017",44508500,1000,0.00276182,0,0,1,1,2
"89018",44509000,1000,0.00275996,0,0,1,0,1
"89019",44509500,1000,0.00277012,0,0,1,1,2
"89020",44510000,1000,0.00271273,0,0,1,2,3
"89021",44510500,1000,0.00265053,0,0,1,1,2
"89022",44511000,1000,0.0026632,0,0,1,1,2
"89023",44511500,1000,0.00276016,0,0,1,2,3
"89024",44512000,1000,0.00264304,0,0,0,1,1
"89025",44512500,1000,0.00276908,0,0,1,2,3
"89026",44513000,1000,0.0027091,0,0,1,2,3
"89027",44513500,1000,0.00271723,0,0,1,3,4
"89028",44514000,1000,0.00280283,0,0,1,4,5
"89029",44514500,1000,0.00258433,0,0,0,1,1
"89030",44515000,1000,0.00261133,0,0,0,2,2
"89031",44515500,1000,0.00269071,0,0,0,3,3
"89032",44516000,1000,0.00275491,0,0,0,1,1
"89033",44516500,1000,0.00265825,0,0,0,0,0
"89034",44517000,1000,0.00268791,0,0,0,1,1
"89035",44517500,1000,0.00276435,0,0,0,2,2
"89036",44518000,1000,0.00272467,0,0,0,1,1
"89037",44518500,1000,0.00276091,0,0,1,1,2
"89038",44519000,1000,0.00281016,0,0,1,2,3
"89039",44519500,1000,0.00281307,0,0,0,1,1
"89040",44520000,1000,0.00266774,0,0,0,1,1
"89041",44520500,1000,0.00265782,0,0,0,2,2
"89042",44521000,1000,0.00268737,0,0,0,1,1
"89043",44521500,1000,0.00267943,0,0,0,2,2
"89044",44522000,1000,0.00273101,0,0,1,3,4
"89045",44522500,1000,0.00256621,0,0,1,1,2
"89046",44523000,1000,0.00252399,0,0,0,1,1
"89047",44523500,1000,0.0027302,0,0,0,1,1
"89048",44524000,1000,0.00273043,0,0,0,0,0
"89049",44524500,1000,0.00257015,0,0,0,0,0
"89050",44525000,1000,0.00254174,0,0,0,0,0
"89051",44525500,1000,0.00253202,0,0,0,0,0
"89052",44526000,1000,0.00255946,0,0,0,1,1
"89053",44526500,1000,0.00271413,0,0,0,3,3
"89054",44527000,1000,0.00264176,0,0,0,2,2
"89055",44527500,1000,0.00253234,0,0,0,0,0
"89056",44528000,1000,0.00262722,0,0,0,0,0
"89057",44528500,1000,0.00268833,0,0,0,0,0
"89058",44529000,1000,0.00278988,0,0,0,1,1
"89059",44529500,1000,0.00284845,0,0,0,2,2
"89060",44530000,1000,0.00271218,0,0,0,1,1
"89061",44530500,1000,0.00262664,0,0,0,1,1
"89062",44531000,1000,0.00263315,0,0,0,1,1
"89063",44531500,1000,0.00449686,1,0,0,4,5
"89064",44532000,1000,0.00443255,1,0,0,4,5
"89065",44532500,1000,0.00267446,0,0,1,1,2
"89066",44533000,1000,0.00278963,0,0,1,1,2
"89067",44533500,1000,0.00274243,0,0,0,0,0
"89068",44534000,1000,0.00267198,0,0,0,0,0
"89069",44534500,1000,0.00274321,0,0,1,1,2
"89070",44535000,1000,0.00285469,0,0,2,2,4
"89071",44535500,1000,0.00269292,0,0,1,2,3
"89072",44536000,1000,0.00265502,0,0,0,1,1
"89073",44536500,1000,0.00275375,0,0,0,1,1
"89074",44537000,1000,0.00266659,0,0,0,1,1
"89075",44537500,1000,0.00272341,0,0,1,1,2
"89076",44538000,1000,0.00275528,0,0,1,1,2
"89077",44538500,1000,0.00267575,0,0,0,0,0
"89078",44539000,1000,0.00282807,0,0,1,1,2
"89079",44539500,1000,0.00273566,0,0,1,1,2
"89080",44540000,1000,0.00258616,0,0,0,0,0
"89081",44540500,1000,0.00260067,0,0,0,0,0
"89082",44541000,1000,0.00269012,0,0,0,1,1
"89083",44541500,1000,0.0027077,0,0,0,1,1
"89084",44542000,1000,0.00269768,0,0,1,0,1
"89085",44542500,1000,0.00264674,0,0,1,1,2
"89086",44543000,1000,0.00272796,0,1,0,1,2
"89087",44543500,1000,0.00280219,0,1,0,0,1
"89088",44544000,1000,0.00290162,0,0,1,1,2
"89089",44544500,1000,0.00285477,0,0,1,1,2
"89090",44545000,1000,0.00260299,0,0,0,1,1
"89091",44545500,1000,0.00259246,0,0,0,1,1
"89092",44546000,1000,0.00271075,0,0,1,2,3
"89093",44546500,1000,0.00271481,0,0,1,2,3
"89094",44547000,1000,0.0025886,0,0,0,0,0
"89095",44547500,1000,0.00253754,0,0,0,0,0
"89096",44548000,1000,0.00262652,0,0,0,0,0
"89097",44548500,1000,0.00269649,0,0,0,0,0
"89098",44549000,1000,0.00271157,0,0,0,2,2
"89099",44549500,1000,0.00274191,0,0,0,2,2
"89100",44550000,1000,0.00264789,0,0,0,1,1
"89101",44550500,1000,0.00263625,0,0,0,1,1
"89102",44551000,1000,0.00295269,0,0,2,4,6
"89103",44551500,1000,0.00295468,0,0,2,4,6
"89104",44552000,1000,0.00285274,0,0,0,2,2
"89105",44552500,1000,0.00291478,0,0,0,2,2
"89106",44553000,1000,0.0027851,0,0,0,2,2
"89107",44553500,1000,0.00279801,0,0,1,3,4
"89108",44554000,1000,0.00269563,0,0,1,1,2
"89109",44554500,1000,0.00261891,0,0,0,1,1
"89110",44555000,1000,0.00263079,0,0,0,1,1
"89111",44555500,1000,0.0026278,0,0,0,1,1
"89112",44556000,1000,0.00255751,0,0,0,1,1
"89113",44556500,1000,0.00247973,0,0,0,0,0
"89114",44557000,1000,0.00248462,0,0,0,0,0
"89115",44557500,1000,0.00254029,0,0,0,0,0
"89116",44558000,1000,0.00255668,0,0,0,0,0
"89117",44558500,1000,0.00278712,0,0,0,1,1
"89118",44559000,1000,0.00292439,0,0,0,1,1
"89119",44559500,1000,0.00265665,0,0,0,0,0
"89120",44560000,1000,0.00253356,0,0,0,0,0
"89121",44560500,1000,0.00267266,0,0,1,1,2
"89122",44561000,1000,0.00256936,0,0,1,1,2
"89123",44561500,1000,0.00245526,0,0,0,0,0
"89124",44562000,1000,0.00262217,0,0,0,1,1
"89125",44562500,1000,0.00264615,0,0,0,1,1
"89126",44563000,1000,0.00280227,0,0,1,3,4
"89127",44563500,1000,0.0028294,0,0,1,3,4
"89128",44564000,1000,0.00268983,0,0,1,1,2
"89129",44564500,1000,0.00267715,0,0,1,2,3
"89130",44565000,1000,0.00260234,0,0,0,1,1
"89131",44565500,1000,0.00262769,0,0,0,0,0
"89132",44566000,1000,0.00263414,0,0,0,0,0
"89133",44566500,1000,0.0026732,0,0,1,0,1
"89134",44567000,1000,0.00277912,0,0,2,1,3
"89135",44567500,1000,0.00277828,0,0,1,2,3
"89136",44568000,1000,0.00273945,0,0,0,1,1
"89137",44568500,1000,0.0026649,0,0,0,0,0
"89138",44569000,1000,0.00266921,0,0,0,0,0
"89139",44569500,1000,0.00266062,0,0,0,1,1
"89140",44570000,1000,0.00265178,0,0,0,3,3
"89141",44570500,1000,0.00267249,0,0,0,3,3
"89142",44571000,1000,0.00264214,0,0,0,2,2
"89143",44571500,1000,0.0026195,0,0,1,1,2
"89144",44572000,1000,0.00273876,0,0,1,3,4
"89145",44572500,1000,0.00285823,0,0,0,4,4
"89146",44573000,1000,0.00277939,0,0,0,2,2
"89147",44573500,1000,0.00285083,0,1,0,1,2
"89148",44574000,1000,0.00290464,0,1,1,1,3
"89149",44574500,1000,0.00279596,0,0,1,1,2
"89150",44575000,1000,0.00275042,0,0,0,2,2
"89151",44575500,1000,0.00268868,0,0,0,3,3
"89152",44576000,1000,0.00260825,0,0,0,1,1
"89153",44576500,1000,0.0025492,0,0,0,0,0
"89154",44577000,1000,0.00269417,0,0,1,1,2
"89155",44577500,1000,0.00270024,0,0,1,1,2
"89156",44578000,1000,0.00263114,0,0,0,0,0
"89157",44578500,1000,0.00266983,0,0,0,0,0
"89158",44579000,1000,0.00274581,0,0,0,0,0
"89159",44579500,1000,0.0027169,0,0,0,0,0
"89160",44580000,1000,0.00269583,0,0,0,1,1
"89161",44580500,1000,0.00272982,0,0,0,2,2
"89162",44581000,1000,0.00260503,0,0,0,1,1
"89163",44581500,1000,0.00273854,0,0,0,2,2
"89164",44582000,1000,0.00280271,0,0,0,3,3
"89165",44582500,1000,0.00263547,0,0,0,1,1
"89166",44583000,1000,0.00263028,0,0,1,1,2
"89167",44583500,1000,0.00272986,0,0,1,1,2
"89168",44584000,1000,0.00273492,0,0,0,0,0
"89169",44584500,1000,0.00281824,0,0,0,2,2
"89170",44585000,1000,0.00266138,0,0,0,2,2
"89171",44585500,1000,0.00254465,0,0,0,1,1
"89172",44586000,1000,0.00268767,0,0,0,3,3
"89173",44586500,1000,0.00270946,0,0,0,3,3
"89174",44587000,1000,0.00286417,0,0,1,2,3
"89175",44587500,1000,0.00283442,0,0,1,2,3
"89176",44588000,1000,0.00274265,0,0,0,2,2
"89177",44588500,1000,0.00271506,0,0,0,2,2
"89178",44589000,1000,0.00268505,0,0,0,1,1
"89179",44589500,1000,0.0027002,0,0,0,0,0
"89180",44590000,1000,0.00262272,0,0,0,0,0
"89181",44590500,1000,0.00263086,0,0,0,0,0
"89182",44591000,1000,0.00262144,0,0,0,0,0
"89183",44591500,1000,0.00263646,0,0,0,0,0
"89184",44592000,1000,0.00269572,0,0,0,1,1
"89185",44592500,1000,0.00276284,0,0,0,1,1
"89186",44593000,1000,0.00272142,0,0,0,0,0
"89187",44593500,1000,0.00262235,0,0,0,1,1
"89188",44594000,1000,0.00270353,0,0,0,1,1
"89189",44594500,1000,0.00277274,0,0,1,0,1
"89190",44595000,1000,0.00274134,0,0,1,1,2
"89191",44595500,1000,0.00272544,0,0,0,2,2
"89192",44596000,1000,0.00268462,0,0,0,1,1
"89193",44596500,1000,0.00270829,0,0,0,2,2
"89194",44597000,1000,0.00263666,0,0,0,2,2
"89195",44597500,1000,0.00252545,0,0,0,0,0
"89196",44598000,1000,0.00256247,0,0,0,0,0
"89197",44598500,1000,0.0026188,0,0,0,1,1
"89198",44599000,1000,0.00261666,0,0,0,1,1
"89199",44599500,1000,0.00267844,0,0,0,1,1
"89200",44600000,1000,0.00264782,0,0,0,1,1
"89201",44600500,1000,0.00261026,0,0,0,0,0
"89202",44601000,1000,0.00264622,0,0,0,1,1
"89203",44601500,1000,0.00260263,0,0,0,1,1
"89204",44602000,1000,0.0027184,0,0,0,1,1
"89205",44602500,1000,0.00268088,0,0,0,1,1
"89206",44603000,1000,0.00256129,0,0,0,0,0
"89207",44603500,1000,0.00265838,0,0,0,0,0
"89208",44604000,1000,0.00270933,0,0,0,0,0
"89209",44604500,1000,0.00281763,0,0,1,0,1
"89210",44605000,1000,0.00289554,0,0,1,1,2
"89211",44605500,1000,0.00280503,0,0,1,1,2
"89212",44606000,1000,0.00285451,0,0,2,0,2
"89213",44606500,1000,0.00283632,0,0,1,0,1
"89214",44607000,1000,0.00281052,0,0,0,2,2
"89215",44607500,1000,0.00320431,0,1,0,4,5
"89216",44608000,1000,0.00304113,0,1,0,2,3
"89217",44608500,1000,0.00264276,0,0,0,0,0
"89218",44609000,1000,0.00276192,0,0,0,0,0
"89219",44609500,1000,0.00276376,0,0,0,2,2
"89220",44610000,1000,0.00274178,0,0,0,2,2
"89221",44610500,1000,0.00281215,0,0,0,1,1
"89222",44611000,1000,0.00283323,0,1,0,1,2
"89223",44611500,1000,0.00274609,0,1,0,1,2
"89224",44612000,1000,0.00264658,0,0,0,1,1
"89225",44612500,1000,0.0026135,0,0,0,1,1
"89226",44613000,1000,0.00266198,0,0,0,2,2
"89227",44613500,1000,0.00261488,0,0,0,1,1
"89228",44614000,1000,0.00256892,0,0,0,0,0
"89229",44614500,1000,0.00271477,0,0,0,0,0
"89230",44615000,1000,0.00276325,0,0,0,1,1
"89231",44615500,1000,0.00270963,0,0,1,2,3
"89232",44616000,1000,0.00265397,0,0,1,2,3
"89233",44616500,1000,0.00274052,0,0,1,3,4
"89234",44617000,1000,0.00295518,0,0,1,3,4
"89235",44617500,1000,0.00289431,0,0,0,1,1
"89236",44618000,1000,0.00298164,0,1,1,2,4
"89237",44618500,1000,0.00292692,0,1,1,2,4
"89238",44619000,1000,0.00270148,0,0,0,0,0
"89239",44619500,1000,0.00276638,0,0,1,2,3
"89240",44620000,1000,0.00292036,0,1,1,2,4
"89241",44620500,1000,0.00282984,0,1,0,0,1
"89242",44621000,1000,0.00284757,0,1,0,2,3
"89243",44621500,1000,0.00278708,0,1,0,2,3
"89244",44622000,1000,0.00273652,0,1,0,0,1
"89245",44622500,1000,0.00283169,0,1,0,2,3
"89246",44623000,1000,0.00275582,0,0,1,3,4
"89247",44623500,1000,0.00267165,0,0,1,1,2
"89248",44624000,1000,0.00264299,0,0,0,1,1
"89249",44624500,1000,0.00277219,0,0,0,1,1
"89250",44625000,1000,0.00280344,0,0,0,2,2
"89251",44625500,1000,0.00266374,0,0,0,3,3
"89252",44626000,1000,0.00264126,0,0,0,1,1
"89253",44626500,1000,0.00277734,0,0,0,1,1
"89254",44627000,1000,0.00291763,0,1,0,2,3
"89255",44627500,1000,0.00286122,0,1,0,2,3
"89256",44628000,1000,0.00254311,0,0,0,1,1
"89257",44628500,1000,0.00250567,0,0,0,0,0
"89258",44629000,1000,0.00264005,0,0,0,1,1
"89259",44629500,1000,0.00275142,0,0,0,4,4
"89260",44630000,1000,0.00275471,0,0,0,4,4
"89261",44630500,1000,0.00281436,0,0,0,3,3
"89262",44631000,1000,0.00275168,0,0,0,2,2
"89263",44631500,1000,0.00269413,0,0,0,2,2
"89264",44632000,1000,0.00263077,0,0,0,2,2
"89265",44632500,1000,0.00259639,0,0,0,1,1
"89266",44633000,1000,0.00266012,0,0,0,1,1
"89267",44633500,1000,0.00263877,0,0,1,1,2
"89268",44634000,1000,0.00255294,0,0,1,1,2
"89269",44634500,1000,0.00262547,0,0,1,1,2
"89270",44635000,1000,0.00283145,0,0,2,1,3
"89271",44635500,1000,0.00275851,0,0,2,1,3
"89272",44636000,1000,0.00251097,0,0,1,1,2
"89273",44636500,1000,0.00243314,0,0,0,0,0
"89274",44637000,1000,0.00253545,0,0,0,0,0
"89275",44637500,1000,0.00260855,0,0,0,0,0
"89276",44638000,1000,0.00274701,0,0,0,1,1
"89277",44638500,1000,0.00271747,0,0,0,1,1
"89278",44639000,1000,0.00261365,0,0,0,1,1
"89279",44639500,1000,0.00266584,0,0,0,2,2
"89280",44640000,1000,0.00262654,0,0,0,1,1
"89281",44640500,1000,0.00246504,0,0,0,0,0
"89282",44641000,1000,0.00246616,0,0,0,0,0
"89283",44641500,1000,0.00255227,0,0,0,1,1
"89284",44642000,1000,0.00257474,0,0,0,2,2
"89285",44642500,1000,0.00253033,0,0,0,1,1
"89286",44643000,1000,0.00261099,0,0,0,1,1
"89287",44643500,1000,0.00278316,0,0,0,3,3
"89288",44644000,1000,0.00283073,0,0,0,4,4
"89289",44644500,1000,0.00276113,0,0,1,3,4
"89290",44645000,1000,0.00268067,0,0,1,1,2
"89291",44645500,1000,0.00280454,0,0,1,1,2
"89292",44646000,1000,0.00282423,0,0,1,1,2
"89293",44646500,1000,0.00269295,0,0,0,2,2
"89294",44647000,1000,0.00260854,0,0,0,3,3
"89295",44647500,1000,0.00259684,0,0,0,2,2
"89296",44648000,1000,0.00259581,0,0,0,1,1
"89297",44648500,1000,0.0025595,0,0,0,0,0
"89298",44649000,1000,0.00272394,0,0,1,1,2
"89299",44649500,1000,0.00259399,0,0,1,1,2
"89300",44650000,1000,0.00257671,0,0,1,0,1
"89301",44650500,1000,0.00274356,0,0,1,2,3
"89302",44651000,1000,0.00259583,0,0,0,2,2
"89303",44651500,1000,0.00253516,0,0,0,0,0
"89304",44652000,1000,0.00255989,0,0,0,1,1
"89305",44652500,1000,0.00283984,0,1,0,3,4
"89306",44653000,1000,0.00297412,0,1,1,2,4
"89307",44653500,1000,0.0026375,0,0,1,0,1
"89308",44654000,1000,0.00256645,0,0,0,0,0
"89309",44654500,1000,0.00264357,0,0,0,0,0
"89310",44655000,1000,0.00275414,0,0,1,1,2
"89311",44655500,1000,0.00277778,0,0,2,1,3
"89312",44656000,1000,0.00250732,0,0,1,0,1
"89313",44656500,1000,0.00242486,0,0,0,1,1
"89314",44657000,1000,0.0025531,0,0,0,1,1
"89315",44657500,1000,0.00267202,0,0,0,0,0
"89316",44658000,1000,0.00271797,0,0,1,1,2
"89317",44658500,1000,0.00255368,0,0,1,1,2
"89318",44659000,1000,0.00236531,0,0,0,0,0
"89319",44659500,1000,0.00237046,0,0,0,0,0
"89320",44660000,1000,0.0025091,0,0,0,1,1
"89321",44660500,1000,0.00253843,0,0,0,2,2
"89322",44661000,1000,0.00248861,0,0,0,2,2
"89323",44661500,1000,0.0025311,0,0,0,1,1
"89324",44662000,1000,0.0025841,0,0,0,0,0
"89325",44662500,1000,0.00255548,0,0,0,1,1
"89326",44663000,1000,0.00253588,0,0,0,1,1
"89327",44663500,1000,0.00246124,0,0,0,0,0
"89328",44664000,1000,0.00255834,0,0,1,1,2
"89329",44664500,1000,0.0026856,0,0,1,1,2
"89330",44665000,1000,0.00257574,0,0,0,0,0
"89331",44665500,1000,0.00246827,0,0,0,0,0
"89332",44666000,1000,0.00257421,0,1,0,0,1
"89333",44666500,1000,0.00280061,0,1,0,0,1
"89334",44667000,1000,0.00271752,0,0,0,0,0
"89335",44667500,1000,0.00256191,0,0,0,0,0
"89336",44668000,1000,0.00256193,0,0,0,0,0
"89337",44668500,1000,0.00268883,0,0,1,1,2
"89338",44669000,1000,0.00263765,0,0,1,1,2
"89339",44669500,1000,0.00256236,0,0,0,1,1
"89340",44670000,1000,0.00263158,0,0,0,2,2
"89341",44670500,1000,0.00270141,0,0,0,3,3
"89342",44671000,1000,0.00252554,0,0,0,2,2
"89343",44671500,1000,0.0024153,0,0,0,2,2
"89344",44672000,1000,0.00255662,0,0,0,3,3
"89345",44672500,1000,0.00267073,0,0,1,1,2
"89346",44673000,1000,0.00265092,0,0,1,0,1
"89347",44673500,1000,0.00249663,0,0,0,0,0
"89348",44674000,1000,0.00254312,0,0,0,1,1
"89349",44674500,1000,0.00252098,0,0,0,1,1
"89350",44675000,1000,0.00242288,0,0,0,0,0
"89351",44675500,1000,0.00245479,0,0,0,1,1
"89352",44676000,1000,0.00245092,0,0,0,1,1
"89353",44676500,1000,0.00261385,0,0,1,1,2
"89354",44677000,1000,0.00262644,0,0,1,1,2
"89355",44677500,1000,0.0025757,0,0,0,1,1
"89356",44678000,1000,0.00256488,0,0,0,1,1
"89357",44678500,1000,0.00254122,0,0,0,0,0
"89358",44679000,1000,0.00274054,0,1,0,0,1
"89359",44679500,1000,0.00279847,0,1,1,1,3
"89360",44680000,1000,0.00269676,0,0,1,2,3
"89361",44680500,1000,0.00266868,0,0,0,1,1
"89362",44681000,1000,0.00287868,0,0,1,2,3
"89363",44681500,1000,0.00278497,0,0,1,3,4
"89364",44682000,1000,0.00262274,0,0,0,1,1
"89365",44682500,1000,0.00272811,0,0,1,1,2
"89366",44683000,1000,0.00275009,0,0,2,2,4
"89367",44683500,1000,0.00271587,0,0,1,1,2
"89368",44684000,1000,0.00265886,0,0,0,0,0
"89369",44684500,1000,0.00261524,0,0,0,0,0
"89370",44685000,1000,0.00275071,0,1,0,0,1
"89371",44685500,1000,0.00271257,0,1,0,0,1
"89372",44686000,1000,0.00263822,0,0,1,0,1
"89373",44686500,1000,0.00261706,0,0,1,0,1
"89374",44687000,1000,0.00262215,0,0,0,2,2
"89375",44687500,1000,0.0027024,0,0,0,2,2
"89376",44688000,1000,0.00254342,0,0,0,0,0
"89377",44688500,1000,0.00250961,0,0,0,0,0
"89378",44689000,1000,0.00254823,0,0,0,0,0
"89379",44689500,1000,0.00253592,0,0,0,0,0
"89380",44690000,1000,0.00255122,0,0,0,0,0
"89381",44690500,1000,0.00267884,0,0,1,1,2
"89382",44691000,1000,0.00268782,0,0,1,1,2
"89383",44691500,1000,0.00270386,0,0,0,1,1
"89384",44692000,1000,0.00269666,0,0,0,1,1
"89385",44692500,1000,0.00273662,0,0,1,2,3
"89386",44693000,1000,0.00267849,0,0,1,2,3
"89387",44693500,1000,0.00259377,0,0,0,3,3
"89388",44694000,1000,0.00265677,0,0,0,3,3
"89389",44694500,1000,0.00273258,0,0,1,0,1
"89390",44695000,1000,0.0028016,0,0,1,1,2
"89391",44695500,1000,0.00259412,0,0,0,2,2
"89392",44696000,1000,0.00261733,0,0,0,2,2
"89393",44696500,1000,0.00266651,0,0,0,1,1
"89394",44697000,1000,0.00267738,0,0,1,2,3
"89395",44697500,1000,0.00274743,0,0,1,3,4
"89396",44698000,1000,0.00268717,0,0,0,3,3
"89397",44698500,1000,0.00285347,0,0,1,4,5
"89398",44699000,1000,0.00289593,0,0,1,5,6
"89399",44699500,1000,0.0027298,0,0,1,3,4
"89400",44700000,1000,0.00269892,0,0,1,2,3
"89401",44700500,1000,0.00266202,0,0,0,3,3
"89402",44701000,1000,0.00260694,0,0,0,2,2
"89403",44701500,1000,0.00269618,0,0,1,2,3
"89404",44702000,1000,0.00280714,0,0,1,5,6
"89405",44702500,1000,0.00263707,0,0,0,4,4
"89406",44703000,1000,0.00260652,0,0,0,2,2
"89407",44703500,1000,0.00273167,0,0,0,2,2
"89408",44704000,1000,0.00263589,0,0,0,0,0
"89409",44704500,1000,0.00268242,0,1,0,0,1
"89410",44705000,1000,0.00266111,0,1,0,0,1
"89411",44705500,1000,0.00270066,0,0,1,1,2
"89412",44706000,1000,0.00282167,0,0,1,2,3
"89413",44706500,1000,0.00266011,0,0,0,2,2
"89414",44707000,1000,0.00263651,0,0,1,2,3
"89415",44707500,1000,0.00276589,0,0,1,2,3
"89416",44708000,1000,0.00279635,0,0,0,1,1
"89417",44708500,1000,0.00258599,0,0,0,0,0
"89418",44709000,1000,0.00256147,0,0,0,0,0
"89419",44709500,1000,0.0028462,0,0,0,4,4
"89420",44710000,1000,0.00280269,0,0,0,5,5
"89421",44710500,1000,0.0025663,0,0,0,1,1
"89422",44711000,1000,0.00260219,0,0,0,0,0
"89423",44711500,1000,0.00276177,0,0,0,3,3
"89424",44712000,1000,0.00267649,0,0,0,3,3
"89425",44712500,1000,0.00280245,0,1,0,1,2
"89426",44713000,1000,0.00292146,0,1,0,4,5
"89427",44713500,1000,0.00270421,0,0,0,3,3
"89428",44714000,1000,0.00264718,0,0,0,0,0
"89429",44714500,1000,0.00264811,0,0,0,1,1
"89430",44715000,1000,0.00269761,0,0,0,3,3
"89431",44715500,1000,0.00263786,0,0,0,2,2
"89432",44716000,1000,0.00260603,0,0,0,0,0
"89433",44716500,1000,0.00258065,0,0,0,0,0
"89434",44717000,1000,0.00251427,0,0,0,0,0
"89435",44717500,1000,0.00264607,0,0,0,1,1
"89436",44718000,1000,0.00266787,0,0,0,1,1
"89437",44718500,1000,0.00264598,0,0,0,1,1
"89438",44719000,1000,0.00265271,0,0,0,3,3
"89439",44719500,1000,0.0026182,0,0,0,2,2
"89440",44720000,1000,0.00270372,0,0,0,0,0
"89441",44720500,1000,0.00272984,0,0,0,0,0
"89442",44721000,1000,0.00271989,0,0,0,2,2
"89443",44721500,1000,0.00268947,0,0,0,2,2
"89444",44722000,1000,0.00263603,0,0,0,0,0
"89445",44722500,1000,0.00262516,0,0,0,0,0
"89446",44723000,1000,0.00272418,0,0,0,2,2
"89447",44723500,1000,0.00275805,0,0,0,2,2
"89448",44724000,1000,0.00270773,0,0,0,0,0
"89449",44724500,1000,0.00286859,0,0,0,5,5
"89450",44725000,1000,0.00280848,0,0,0,5,5
"89451",44725500,1000,0.00266578,0,0,0,0,0
"89452",44726000,1000,0.00270868,0,0,1,0,1
"89453",44726500,1000,0.00257014,0,0,1,0,1
"89454",44727000,1000,0.00258187,0,0,0,2,2
"89455",44727500,1000,0.00277891,0,0,0,4,4
"89456",44728000,1000,0.00269325,0,0,0,2,2
"89457",44728500,1000,0.00272545,0,0,1,1,2
"89458",44729000,1000,0.00275803,0,0,1,3,4
"89459",44729500,1000,0.00272217,0,0,0,2,2
"89460",44730000,1000,0.00267265,0,0,0,1,1
"89461",44730500,1000,0.00283916,0,1,0,1,2
"89462",44731000,1000,0.00301547,0,1,0,1,2
"89463",44731500,1000,0.00291691,0,0,0,1,1
"89464",44732000,1000,0.00287639,0,0,0,1,1
"89465",44732500,1000,0.00307133,0,1,1,1,3
"89466",44733000,1000,0.00295634,0,1,1,0,2
"89467",44733500,1000,0.00269918,0,0,0,0,0
"89468",44734000,1000,0.00288096,0,0,1,0,1
"89469",44734500,1000,0.00288196,0,0,1,2,3
"89470",44735000,1000,0.00281788,0,0,0,4,4
"89471",44735500,1000,0.00267013,0,0,0,2,2
"89472",44736000,1000,0.00263742,0,1,0,0,1
"89473",44736500,1000,0.0028132,0,1,0,0,1
"89474",44737000,1000,0.00287395,0,0,0,2,2
"89475",44737500,1000,0.00271209,0,0,0,2,2
"89476",44738000,1000,0.00259605,0,0,0,0,0
"89477",44738500,1000,0.0027235,0,0,0,0,0
"89478",44739000,1000,0.00278265,0,1,0,0,1
"89479",44739500,1000,0.00281915,0,1,0,0,1
"89480",44740000,1000,0.00274721,0,0,0,0,0
"89481",44740500,1000,0.0027439,0,0,1,1,2
"89482",44741000,1000,0.00272972,0,0,1,1,2
"89483",44741500,1000,0.00262319,0,0,0,1,1
"89484",44742000,1000,0.00269678,0,0,0,3,3
"89485",44742500,1000,0.00269209,0,0,0,2,2
"89486",44743000,1000,0.0025078,0,0,0,1,1
"89487",44743500,1000,0.00257535,0,0,0,3,3
"89488",44744000,1000,0.00274046,0,0,0,4,4
"89489",44744500,1000,0.00257336,0,0,0,3,3
"89490",44745000,1000,0.00261757,0,0,0,3,3
"89491",44745500,1000,0.00272559,0,0,0,3,3
"89492",44746000,1000,0.00268059,0,0,0,1,1
"89493",44746500,1000,0.00287018,0,1,0,2,3
"89494",44747000,1000,0.00291006,0,1,0,4,5
"89495",44747500,1000,0.0027565,0,0,0,2,2
"89496",44748000,1000,0.0028406,0,0,0,1,1
"89497",44748500,1000,0.00286349,0,0,0,1,1
"89498",44749000,1000,0.00275209,0,0,0,0,0
"89499",44749500,1000,0.00282989,0,0,0,2,2
"89500",44750000,1000,0.00283577,0,0,0,4,4
"89501",44750500,1000,0.00262699,0,0,0,2,2
"89502",44751000,1000,0.00266506,0,0,0,1,1
"89503",44751500,1000,0.00298198,0,1,0,1,2
"89504",44752000,1000,0.00311995,0,2,1,1,4
"89505",44752500,1000,0.00285368,0,1,1,1,3
"89506",44753000,1000,0.00266865,0,0,0,0,0
"89507",44753500,1000,0.00275821,0,0,0,1,1
"89508",44754000,1000,0.0027593,0,0,0,1,1
"89509",44754500,1000,0.00282534,0,0,1,1,2
"89510",44755000,1000,0.00298231,0,0,1,4,5
"89511",44755500,1000,0.00287478,0,0,0,4,4
"89512",44756000,1000,0.00277387,0,0,1,1,2
"89513",44756500,1000,0.00272268,0,0,1,1,2
"89514",44757000,1000,0.00269256,0,0,0,1,1
"89515",44757500,1000,0.00284716,0,1,0,0,1
"89516",44758000,1000,0.0028197,0,1,0,1,2
"89517",44758500,1000,0.00259604,0,0,0,2,2
"89518",44759000,1000,0.0023647,0,0,0,1,1
"89519",44759500,1000,0.002508,0,0,1,0,1
"89520",44760000,1000,0.00265316,0,0,1,0,1
"89521",44760500,1000,0.00256075,0,0,0,0,0
"89522",44761000,1000,0.00275405,0,0,0,3,3
"89523",44761500,1000,0.00285752,0,0,0,3,3
"89524",44762000,1000,0.00270893,0,0,0,0,0
"89525",44762500,1000,0.00265891,0,0,0,0,0
"89526",44763000,1000,0.0027062,0,0,0,0,0
"89527",44763500,1000,0.00289285,0,0,0,3,3
"89528",44764000,1000,0.00289133,0,0,0,3,3
"89529",44764500,1000,0.00292165,0,0,1,1,2
"89530",44765000,1000,0.00291559,0,0,1,1,2
"89531",44765500,1000,0.00262669,0,0,0,1,1
"89532",44766000,1000,0.00265113,0,0,0,2,2
"89533",44766500,1000,0.00287928,0,0,1,1,2
"89534",44767000,1000,0.00287091,0,0,1,1,2
"89535",44767500,1000,0.00265819,0,0,0,1,1
"89536",44768000,1000,0.0026079,0,0,0,1,1
"89537",44768500,1000,0.00268669,0,0,0,2,2
"89538",44769000,1000,0.00266087,0,0,0,1,1
"89539",44769500,1000,0.00267057,0,0,0,0,0
"89540",44770000,1000,0.00267648,0,0,0,1,1
"89541",44770500,1000,0.00273507,0,0,0,2,2
"89542",44771000,1000,0.00274413,0,0,0,1,1
"89543",44771500,1000,0.00262946,0,0,0,0,0
"89544",44772000,1000,0.00269106,0,0,1,0,1
"89545",44772500,1000,0.00272453,0,0,1,0,1
"89546",44773000,1000,0.00275547,0,0,0,1,1
"89547",44773500,1000,0.0028035,0,0,0,2,2
"89548",44774000,1000,0.00271932,0,0,0,1,1
"89549",44774500,1000,0.00268534,0,0,0,0,0
"89550",44775000,1000,0.00267642,0,0,0,0,0
"89551",44775500,1000,0.00251337,0,0,0,0,0
"89552",44776000,1000,0.00250033,0,0,0,0,0
"89553",44776500,1000,0.00261266,0,0,0,0,0
"89554",44777000,1000,0.00267679,0,0,0,1,1
"89555",44777500,1000,0.00284176,0,0,0,1,1
"89556",44778000,1000,0.0029236,0,0,1,0,1
"89557",44778500,1000,0.00271389,0,0,1,1,2
"89558",44779000,1000,0.00256741,0,0,0,2,2
"89559",44779500,1000,0.00284676,0,1,0,1,2
"89560",44780000,1000,0.00293273,0,1,0,1,2
"89561",44780500,1000,0.00265859,0,0,0,1,1
"89562",44781000,1000,0.00262554,0,0,0,1,1
"89563",44781500,1000,0.00268522,0,0,0,1,1
"89564",44782000,1000,0.00260167,0,0,0,0,0
"89565",44782500,1000,0.00264826,0,0,1,1,2
"89566",44783000,1000,0.00276996,0,0,1,3,4
"89567",44783500,1000,0.0028157,0,0,0,5,5
"89568",44784000,1000,0.00267086,0,0,0,3,3
"89569",44784500,1000,0.00262008,0,0,1,1,2
"89570",44785000,1000,0.00289675,0,1,2,2,5
"89571",44785500,1000,0.00293197,0,1,1,2,4
"89572",44786000,1000,0.00277919,0,0,0,1,1
"89573",44786500,1000,0.00267395,0,0,0,0,0
"89574",44787000,1000,0.00257812,0,0,0,0,0
"89575",44787500,1000,0.00258044,0,0,0,1,1
"89576",44788000,1000,0.00268845,0,0,0,2,2
"89577",44788500,1000,0.00260223,0,0,0,1,1
"89578",44789000,1000,0.0027177,0,0,1,2,3
"89579",44789500,1000,0.00282184,0,0,1,3,4
"89580",44790000,1000,0.00265799,0,0,0,2,2
"89581",44790500,1000,0.00275119,0,0,1,1,2
"89582",44791000,1000,0.00276919,0,0,1,2,3
"89583",44791500,1000,0.00273351,0,0,0,3,3
"89584",44792000,1000,0.00259126,0,0,0,1,1
"89585",44792500,1000,0.00251273,0,0,0,0,0
"89586",44793000,1000,0.00255589,0,0,0,0,0
"89587",44793500,1000,0.0026032,0,0,0,1,1
"89588",44794000,1000,0.00272991,0,0,0,1,1
"89589",44794500,1000,0.00262725,0,0,0,0,0
"89590",44795000,1000,0.00271814,0,0,1,1,2
"89591",44795500,1000,0.00281191,0,0,1,2,3
"89592",44796000,1000,0.00266171,0,0,0,1,1
"89593",44796500,1000,0.00256123,0,0,0,0,0
"89594",44797000,1000,0.00247173,0,0,0,1,1
"89595",44797500,1000,0.002815,0,1,0,2,3
"89596",44798000,1000,0.00288239,0,1,0,2,3
"89597",44798500,1000,0.00262713,0,0,0,1,1
"89598",44799000,1000,0.00278976,0,0,1,2,3
"89599",44799500,1000,0.00284128,0,0,1,4,5
"89600",44800000,1000,0.00272323,0,0,0,4,4
"89601",44800500,1000,0.0026067,0,0,0,2,2
"89602",44801000,1000,0.00264312,0,0,0,1,1
"89603",44801500,1000,0.00280121,0,0,0,3,3
"89604",44802000,1000,0.00265117,0,0,0,2,2
"89605",44802500,1000,0.00256481,0,0,0,0,0
"89606",44803000,1000,0.00278756,0,1,0,0,1
"89607",44803500,1000,0.00265482,0,1,0,0,1
"89608",44804000,1000,0.00251045,0,0,0,0,0
"89609",44804500,1000,0.00273375,0,0,0,0,0
"89610",44805000,1000,0.00275083,0,0,0,0,0
"89611",44805500,1000,0.00260104,0,0,0,0,0
"89612",44806000,1000,0.00266353,0,0,0,1,1
"89613",44806500,1000,0.00277812,0,0,1,2,3
"89614",44807000,1000,0.00269804,0,0,1,1,2
"89615",44807500,1000,0.00267796,0,0,0,1,1
"89616",44808000,1000,0.00260129,0,0,0,1,1
"89617",44808500,1000,0.00263367,0,0,0,2,2
"89618",44809000,1000,0.00272825,0,0,0,2,2
"89619",44809500,1000,0.00271296,0,0,0,2,2
"89620",44810000,1000,0.00286069,0,0,1,5,6
"89621",44810500,1000,0.00288774,0,0,1,3,4
"89622",44811000,1000,0.00285287,0,0,0,2,2
"89623",44811500,1000,0.00272769,0,0,0,2,2
"89624",44812000,1000,0.00265781,0,0,0,2,2
"89625",44812500,1000,0.00284001,0,0,1,3,4
"89626",44813000,1000,0.0029099,0,0,2,2,4
"89627",44813500,1000,0.00284517,0,0,2,2,4
"89628",44814000,1000,0.00280987,0,0,1,4,5
"89629",44814500,1000,0.00276765,0,0,0,5,5
"89630",44815000,1000,0.00264937,0,0,0,2,2
"89631",44815500,1000,0.00267297,0,0,1,1,2
"89632",44816000,1000,0.00257704,0,0,1,1,2
"89633",44816500,1000,0.00253384,0,0,0,1,1
"89634",44817000,1000,0.00275771,0,0,0,2,2
"89635",44817500,1000,0.00284336,0,0,0,2,2
"89636",44818000,1000,0.00271599,0,0,0,2,2
"89637",44818500,1000,0.00265909,0,0,0,2,2
"89638",44819000,1000,0.00278911,0,0,1,2,3
"89639",44819500,1000,0.0026262,0,0,1,1,2
"89640",44820000,1000,0.00257751,0,0,0,2,2
"89641",44820500,1000,0.00263759,0,0,0,2,2
"89642",44821000,1000,0.00266423,0,0,1,1,2
"89643",44821500,1000,0.00276423,0,0,1,3,4
"89644",44822000,1000,0.00266768,0,0,1,3,4
"89645",44822500,1000,0.00264419,0,0,1,1,2
"89646",44823000,1000,0.00262542,0,0,0,1,1
"89647",44823500,1000,0.00273962,0,0,0,3,3
"89648",44824000,1000,0.00297982,0,0,1,4,5
"89649",44824500,1000,0.00285742,0,0,1,5,6
"89650",44825000,1000,0.00263689,0,0,0,3,3
"89651",44825500,1000,0.00271994,0,0,1,1,2
"89652",44826000,1000,0.00288022,0,0,1,4,5
"89653",44826500,1000,0.00285331,0,1,0,3,4
"89654",44827000,1000,0.0027421,0,1,0,0,1
"89655",44827500,1000,0.00264921,0,0,0,1,1
"89656",44828000,1000,0.00255377,0,0,0,1,1
"89657",44828500,1000,0.00252767,0,0,0,0,0
"89658",44829000,1000,0.00263716,0,0,0,1,1
"89659",44829500,1000,0.00254654,0,0,0,1,1
"89660",44830000,1000,0.00235768,0,0,0,0,0
"89661",44830500,1000,0.00243541,0,0,0,0,0
"89662",44831000,1000,0.00257101,0,0,1,0,1
"89663",44831500,1000,0.00255358,0,0,1,0,1
"89664",44832000,1000,0.00267142,0,0,1,1,2
"89665",44832500,1000,0.00285762,0,0,3,2,5
"89666",44833000,1000,0.00279965,0,0,2,3,5
"89667",44833500,1000,0.00267543,0,0,0,2,2
"89668",44834000,1000,0.00278332,0,0,0,3,3
"89669",44834500,1000,0.00284616,0,0,0,4,4
"89670",44835000,1000,0.00278062,0,0,1,2,3
"89671",44835500,1000,0.00284572,0,0,2,2,4
"89672",44836000,1000,0.00283295,0,0,1,3,4
"89673",44836500,1000,0.0027845,0,0,1,3,4
"89674",44837000,1000,0.00274935,0,0,1,2,3
"89675",44837500,1000,0.00269842,0,0,0,2,2
"89676",44838000,1000,0.00275259,0,0,0,3,3
"89677",44838500,1000,0.00288939,0,0,1,5,6
"89678",44839000,1000,0.0027127,0,0,1,4,5
"89679",44839500,1000,0.0026392,0,0,1,2,3
"89680",44840000,1000,0.00282317,0,0,2,2,4
"89681",44840500,1000,0.00280115,0,0,1,1,2
"89682",44841000,1000,0.00273012,0,0,0,1,1
"89683",44841500,1000,0.00276757,0,0,1,2,3
"89684",44842000,1000,0.00276006,0,0,1,2,3
"89685",44842500,1000,0.00262489,0,0,0,1,1
"89686",44843000,1000,0.00252655,0,0,0,0,0
"89687",44843500,1000,0.00255321,0,0,0,1,1
"89688",44844000,1000,0.00262386,0,0,0,1,1
"89689",44844500,1000,0.00261075,0,0,0,1,1
"89690",44845000,1000,0.00266828,0,0,1,2,3
"89691",44845500,1000,0.00279875,0,1,1,1,3
"89692",44846000,1000,0.00271898,0,1,0,0,1
"89693",44846500,1000,0.00269562,0,0,0,2,2
"89694",44847000,1000,0.00270184,0,0,1,3,4
"89695",44847500,1000,0.00272325,0,0,1,1,2
"89696",44848000,1000,0.00288187,0,0,0,1,1
"89697",44848500,1000,0.00290931,0,0,0,2,2
"89698",44849000,1000,0.00272311,0,0,0,1,1
"89699",44849500,1000,0.00264954,0,0,0,1,1
"89700",44850000,1000,0.00276625,0,0,0,1,1
"89701",44850500,1000,0.00281827,0,1,0,0,1
"89702",44851000,1000,0.00283104,0,1,0,0,1
"89703",44851500,1000,0.00265154,0,0,0,0,0
"89704",44852000,1000,0.00269575,0,0,1,1,2
"89705",44852500,1000,0.00270664,0,0,1,1,2
"89706",44853000,1000,0.00262527,0,0,0,0,0
"89707",44853500,1000,0.00272687,0,0,0,0,0
"89708",44854000,1000,0.00269268,0,0,0,0,0
"89709",44854500,1000,0.00279949,0,0,0,0,0
"89710",44855000,1000,0.00285453,0,0,1,0,1
"89711",44855500,1000,0.00271215,0,0,1,1,2
"89712",44856000,1000,0.00269002,0,0,1,1,2
"89713",44856500,1000,0.00269509,0,0,1,1,2
"89714",44857000,1000,0.00265365,0,0,0,1,1
"89715",44857500,1000,0.00262645,0,0,0,0,0
"89716",44858000,1000,0.00277161,0,0,0,2,2
"89717",44858500,1000,0.00286869,0,0,0,2,2
"89718",44859000,1000,0.00284011,0,0,1,0,1
"89719",44859500,1000,0.00310141,0,1,1,0,2
"89720",44860000,1000,0.00299783,0,1,0,0,1
"89721",44860500,1000,0.00267801,0,0,0,1,1
"89722",44861000,1000,0.00273768,0,0,0,3,3
"89723",44861500,1000,0.00280681,0,0,1,3,4
"89724",44862000,1000,0.00285169,0,0,1,2,3
"89725",44862500,1000,0.00290889,0,0,0,1,1
"89726",44863000,1000,0.00277454,0,0,0,1,1
"89727",44863500,1000,0.00268094,0,0,0,1,1
"89728",44864000,1000,0.00259178,0,0,0,0,0
"89729",44864500,1000,0.00265015,0,0,0,1,1
"89730",44865000,1000,0.00289409,0,0,1,1,2
"89731",44865500,1000,0.00271166,0,0,1,1,2
"89732",44866000,1000,0.00268049,0,0,0,2,2
"89733",44866500,1000,0.00278128,0,0,0,2,2
"89734",44867000,1000,0.00265733,0,0,0,1,1
"89735",44867500,1000,0.0028417,0,1,0,0,1
"89736",44868000,1000,0.00280131,0,1,0,0,1
"89737",44868500,1000,0.00257435,0,0,0,0,0
"89738",44869000,1000,0.00262564,0,0,0,0,0
"89739",44869500,1000,0.00273484,0,0,0,0,0
"89740",44870000,1000,0.00260581,0,0,0,0,0
"89741",44870500,1000,0.0027413,0,0,1,1,2
"89742",44871000,1000,0.00284833,0,0,1,1,2
"89743",44871500,1000,0.00263506,0,0,0,0,0
"89744",44872000,1000,0.00287523,0,1,0,1,2
"89745",44872500,1000,0.00297236,0,1,0,2,3
"89746",44873000,1000,0.00269432,0,0,0,1,1
"89747",44873500,1000,0.00270566,0,0,1,1,2
"89748",44874000,1000,0.00282712,0,0,1,3,4
"89749",44874500,1000,0.00268141,0,0,0,2,2
"89750",44875000,1000,0.002645,0,0,0,1,1
"89751",44875500,1000,0.00266739,0,0,0,1,1
"89752",44876000,1000,0.00266787,0,0,0,0,0
"89753",44876500,1000,0.00280751,0,0,1,1,2
"89754",44877000,1000,0.00282699,0,0,1,1,2
"89755",44877500,1000,0.0029695,0,0,1,4,5
"89756",44878000,1000,0.00291921,0,0,1,4,5
"89757",44878500,1000,0.00261779,0,0,0,0,0
"89758",44879000,1000,0.00272946,0,0,1,2,3
"89759",44879500,1000,0.00281792,0,0,1,3,4
"89760",44880000,1000,0.00277357,0,0,1,1,2
"89761",44880500,1000,0.0028405,0,0,2,2,4
"89762",44881000,1000,0.00288204,0,1,1,2,4
"89763",44881500,1000,0.00281764,0,1,0,0,1
"89764",44882000,1000,0.00297472,0,0,1,3,4
"89765",44882500,1000,0.00284333,0,0,1,3,4
"89766",44883000,1000,0.00258469,0,0,0,0,0
"89767",44883500,1000,0.00276692,0,0,0,1,1
"89768",44884000,1000,0.00299292,0,0,1,4,5
"89769",44884500,1000,0.00294966,0,0,1,4,5
"89770",44885000,1000,0.00277873,0,0,0,2,2
"89771",44885500,1000,0.00285239,0,1,0,2,3
"89772",44886000,1000,0.00282182,0,1,0,3,4
"89773",44886500,1000,0.00285906,0,0,0,3,3
"89774",44887000,1000,0.00274263,0,0,0,1,1
"89775",44887500,1000,0.00246649,0,0,0,0,0
"89776",44888000,1000,0.00258597,0,0,0,0,0
"89777",44888500,1000,0.00267484,0,0,0,1,1
"89778",44889000,1000,0.00290202,0,0,1,3,4
"89779",44889500,1000,0.00282573,0,0,1,2,3
"89780",44890000,1000,0.00269512,0,0,1,0,1
"89781",44890500,1000,0.0027005,0,0,1,0,1
"89782",44891000,1000,0.00260402,0,0,0,0,0
"89783",44891500,1000,0.0027376,0,0,1,2,3
"89784",44892000,1000,0.0027958,0,0,1,3,4
"89785",44892500,1000,0.00272787,0,0,0,2,2
"89786",44893000,1000,0.00267626,0,0,0,2,2
"89787",44893500,1000,0.0026892,0,0,0,2,2
"89788",44894000,1000,0.00274307,0,0,0,2,2
"89789",44894500,1000,0.00262245,0,0,0,1,1
"89790",44895000,1000,0.00254686,0,0,1,1,2
"89791",44895500,1000,0.00262088,0,0,1,2,3
"89792",44896000,1000,0.00266738,0,0,0,3,3
"89793",44896500,1000,0.00280768,0,0,1,2,3
"89794",44897000,1000,0.00272233,0,0,1,2,3
"89795",44897500,1000,0.00257094,0,0,1,2,3
"89796",44898000,1000,0.00268226,0,0,2,1,3
"89797",44898500,1000,0.00267654,0,0,1,1,2
"89798",44899000,1000,0.0025359,0,0,0,1,1
"89799",44899500,1000,0.00263873,0,0,0,1,1
"89800",44900000,1000,0.00277299,0,0,0,1,1
"89801",44900500,1000,0.00277848,0,0,0,1,1
"89802",44901000,1000,0.00276185,0,0,0,0,0
"89803",44901500,1000,0.00267519,0,0,0,0,0
"89804",44902000,1000,0.00272102,0,0,0,0,0
"89805",44902500,1000,0.00284896,0,0,0,0,0
"89806",44903000,1000,0.00274374,0,0,0,0,0
"89807",44903500,1000,0.00264259,0,0,0,0,0
"89808",44904000,1000,0.00270477,0,0,0,0,0
"89809",44904500,1000,0.00280218,0,0,0,0,0
"89810",44905000,1000,0.00270654,0,0,0,1,1
"89811",44905500,1000,0.00261043,0,0,0,1,1
"89812",44906000,1000,0.00284636,0,1,0,0,1
"89813",44906500,1000,0.00297989,0,1,1,0,2
"89814",44907000,1000,0.00294747,0,0,2,1,3
"89815",44907500,1000,0.00281009,0,0,1,1,2
"89816",44908000,1000,0.00266933,0,0,0,0,0
"89817",44908500,1000,0.00277288,0,0,0,3,3
"89818",44909000,1000,0.00275808,0,0,0,3,3
"89819",44909500,1000,0.00277692,0,0,0,1,1
"89820",44910000,1000,0.00273795,0,0,0,1,1
"89821",44910500,1000,0.00261085,0,0,0,1,1
"89822",44911000,1000,0.00267246,0,0,0,1,1
"89823",44911500,1000,0.00290207,0,1,0,0,1
"89824",44912000,1000,0.00296274,0,1,0,2,3
"89825",44912500,1000,0.00288512,0,0,1,3,4
"89826",44913000,1000,0.00284402,0,0,1,1,2
"89827",44913500,1000,0.00276462,0,0,0,0,0
"89828",44914000,1000,0.00283408,0,0,0,1,1
"89829",44914500,1000,0.00277064,0,0,0,1,1
"89830",44915000,1000,0.00270533,0,0,0,1,1
"89831",44915500,1000,0.00279337,0,1,0,1,2
"89832",44916000,1000,0.0029516,0,1,2,0,3
"89833",44916500,1000,0.00282707,0,0,2,0,2
"89834",44917000,1000,0.00267185,0,0,0,1,1
"89835",44917500,1000,0.00296861,0,0,1,2,3
"89836",44918000,1000,0.00288648,0,0,1,1,2
"89837",44918500,1000,0.00276317,0,0,1,0,1
"89838",44919000,1000,0.00286448,0,0,1,1,2
"89839",44919500,1000,0.00312934,0,1,1,1,3
"89840",44920000,1000,0.00311432,0,1,1,0,2
"89841",44920500,1000,0.00277488,0,0,0,0,0
"89842",44921000,1000,0.00267262,0,0,0,0,0
"89843",44921500,1000,0.00262273,0,0,0,0,0
"89844",44922000,1000,0.00278733,0,0,1,0,1
"89845",44922500,1000,0.00277502,0,0,1,0,1
"89846",44923000,1000,0.00278405,0,0,0,1,1
"89847",44923500,1000,0.0029898,0,1,0,1,2
"89848",44924000,1000,0.00282554,0,1,0,0,1
"89849",44924500,1000,0.00260734,0,0,0,1,1
"89850",44925000,1000,0.00263435,0,0,0,2,2
"89851",44925500,1000,0.00270101,0,0,0,3,3
"89852",44926000,1000,0.00274649,0,0,0,2,2
"89853",44926500,1000,0.00273865,0,0,0,0,0
"89854",44927000,1000,0.00302366,0,1,0,1,2
"89855",44927500,1000,0.00298178,0,1,0,1,2
"89856",44928000,1000,0.00269413,0,0,0,1,1
"89857",44928500,1000,0.00279036,0,0,0,2,2
"89858",44929000,1000,0.00283553,0,0,0,2,2
"89859",44929500,1000,0.00264982,0,0,0,1,1
"89860",44930000,1000,0.00253031,0,0,0,1,1
"89861",44930500,1000,0.00255401,0,0,0,1,1
"89862",44931000,1000,0.00260123,0,0,0,0,0
"89863",44931500,1000,0.00273246,0,0,0,0,0
"89864",44932000,1000,0.00272469,0,0,0,0,0
"89865",44932500,1000,0.00272582,0,0,0,1,1
"89866",44933000,1000,0.00292258,0,0,1,1,2
"89867",44933500,1000,0.00299921,0,0,2,2,4
"89868",44934000,1000,0.00286732,0,0,1,3,4
"89869",44934500,1000,0.00284418,0,0,0,3,3
"89870",44935000,1000,0.00288187,0,0,0,2,2
"89871",44935500,1000,0.00284235,0,0,0,1,1
"89872",44936000,1000,0.00282557,0,0,0,1,1
"89873",44936500,1000,0.00277888,0,0,1,1,2
"89874",44937000,1000,0.00259156,0,0,1,1,2
"89875",44937500,1000,0.00249319,0,0,0,0,0
"89876",44938000,1000,0.00258584,0,0,0,2,2
"89877",44938500,1000,0.00262685,0,0,0,3,3
"89878",44939000,1000,0.0026566,0,0,0,3,3
"89879",44939500,1000,0.00264226,0,0,1,2,3
"89880",44940000,1000,0.00271419,0,1,1,0,2
"89881",44940500,1000,0.00270066,0,1,0,1,2
"89882",44941000,1000,0.00251141,0,0,0,1,1
"89883",44941500,1000,0.00266155,0,0,0,1,1
"89884",44942000,1000,0.00280439,0,0,1,1,2
"89885",44942500,1000,0.00285952,0,0,2,1,3
"89886",44943000,1000,0.00281513,0,0,1,3,4
"89887",44943500,1000,0.00265037,0,0,0,2,2
"89888",44944000,1000,0.00270906,0,0,0,1,1
"89889",44944500,1000,0.00256988,0,0,0,1,1
"89890",44945000,1000,0.00243472,0,0,0,1,1
"89891",44945500,1000,0.00256272,0,0,0,3,3
"89892",44946000,1000,0.00257209,0,0,0,4,4
"89893",44946500,1000,0.00255474,0,0,0,2,2
"89894",44947000,1000,0.00260192,0,0,0,0,0
"89895",44947500,1000,0.00259299,0,0,0,0,0
"89896",44948000,1000,0.0026486,0,0,0,0,0
"89897",44948500,1000,0.00263513,0,0,0,0,0
"89898",44949000,1000,0.00261625,0,0,0,0,0
"89899",44949500,1000,0.00262845,0,0,0,0,0
"89900",44950000,1000,0.00266615,0,0,0,2,2
"89901",44950500,1000,0.00281479,0,0,0,5,5
"89902",44951000,1000,0.00282733,0,0,0,4,4
"89903",44951500,1000,0.00267526,0,0,0,2,2
"89904",44952000,1000,0.00259207,0,0,0,1,1
"89905",44952500,1000,0.00264766,0,0,0,1,1
"89906",44953000,1000,0.00265933,0,0,0,1,1
"89907",44953500,1000,0.00279345,0,0,0,2,2
"89908",44954000,1000,0.00278768,0,0,0,2,2
"89909",44954500,1000,0.0028037,0,0,1,1,2
"89910",44955000,1000,0.0028229,0,0,1,1,2
"89911",44955500,1000,0.00265451,0,0,0,0,0
"89912",44956000,1000,0.00272865,0,0,0,2,2
"89913",44956500,1000,0.00277306,0,0,0,2,2
"89914",44957000,1000,0.00276065,0,0,0,1,1
"89915",44957500,1000,0.00262331,0,0,0,1,1
"89916",44958000,1000,0.00245488,0,0,0,0,0
"89917",44958500,1000,0.00258804,0,0,0,3,3
"89918",44959000,1000,0.00272239,0,0,0,6,6
"89919",44959500,1000,0.0026253,0,0,0,3,3
"89920",44960000,1000,0.00265944,0,0,0,0,0
"89921",44960500,1000,0.00289424,0,0,0,2,2
"89922",44961000,1000,0.00291112,0,0,1,2,3
"89923",44961500,1000,0.00281859,0,0,2,2,4
"89924",44962000,1000,0.00278405,0,0,1,4,5
"89925",44962500,1000,0.002594,0,0,0,2,2
"89926",44963000,1000,0.00252262,0,0,0,0,0
"89927",44963500,1000,0.00278947,0,0,1,2,3
"89928",44964000,1000,0.00288715,0,0,1,3,4
"89929",44964500,1000,0.00274233,0,0,0,1,1
"89930",44965000,1000,0.00275636,0,0,0,3,3
"89931",44965500,1000,0.00275527,0,0,0,3,3
"89932",44966000,1000,0.00273965,0,0,0,2,2
"89933",44966500,1000,0.00273346,0,0,0,2,2
"89934",44967000,1000,0.0025336,0,0,0,0,0
"89935",44967500,1000,0.00243994,0,0,0,0,0
"89936",44968000,1000,0.00234182,0,0,0,0,0
"89937",44968500,1000,0.00238855,0,0,0,0,0
"89938",44969000,1000,0.00262669,0,0,0,0,0
"89939",44969500,1000,0.00262734,0,0,0,0,0
"89940",44970000,1000,0.00248281,0,0,0,0,0
"89941",44970500,1000,0.00246525,0,0,0,0,0
"89942",44971000,1000,0.00252751,0,0,0,0,0
"89943",44971500,1000,0.00252556,0,0,0,1,1
"89944",44972000,1000,0.00259818,0,0,0,1,1
"89945",44972500,1000,0.00280318,0,0,1,1,2
"89946",44973000,1000,0.00278071,0,0,1,2,3
"89947",44973500,1000,0.00271316,0,0,0,2,2
"89948",44974000,1000,0.00285077,0,0,1,2,3
"89949",44974500,1000,0.00277763,0,0,1,2,3
"89950",44975000,1000,0.0026788,0,0,0,1,1
"89951",44975500,1000,0.00272061,0,0,0,2,2
"89952",44976000,1000,0.00272646,0,0,1,2,3
"89953",44976500,1000,0.00275878,0,0,2,0,2
"89954",44977000,1000,0.00275856,0,0,1,0,1
"89955",44977500,1000,0.00262523,0,0,0,0,0
"89956",44978000,1000,0.00275258,0,0,1,0,1
"89957",44978500,1000,0.00282431,0,0,1,0,1
"89958",44979000,1000,0.00268925,0,0,0,0,0
"89959",44979500,1000,0.00275274,0,0,0,0,0
"89960",44980000,1000,0.00274585,0,0,0,0,0
"89961",44980500,1000,0.00269492,0,0,0,0,0
"89962",44981000,1000,0.00266448,0,0,0,0,0
"89963",44981500,1000,0.00272887,0,0,0,0,0
"89964",44982000,1000,0.00284059,0,0,0,0,0
"89965",44982500,1000,0.00291115,0,0,0,1,1
"89966",44983000,1000,0.0029269,0,0,1,1,2
"89967",44983500,1000,0.00291317,0,0,1,1,2
"89968",44984000,1000,0.00280826,0,0,0,1,1
"89969",44984500,1000,0.00260683,0,0,0,0,0
"89970",44985000,1000,0.00267992,0,0,0,0,0
"89971",44985500,1000,0.00287692,0,0,0,2,2
"89972",44986000,1000,0.00278945,0,0,0,2,2
"89973",44986500,1000,0.00268274,0,0,1,0,1
"89974",44987000,1000,0.00265519,0,0,1,0,1
"89975",44987500,1000,0.0025871,0,0,0,0,0
"89976",44988000,1000,0.00253647,0,0,0,0,0
"89977",44988500,1000,0.00260874,0,0,0,2,2
"89978",44989000,1000,0.00264,0,0,0,2,2
"89979",44989500,1000,0.00268436,0,0,0,3,3
"89980",44990000,1000,0.00281884,0,0,0,4,4
"89981",44990500,1000,0.00289009,0,0,2,1,3
"89982",44991000,1000,0.00286417,0,0,2,1,3
"89983",44991500,1000,0.00273379,0,0,0,2,2
"89984",44992000,1000,0.00263724,0,0,0,1,1
"89985",44992500,1000,0.0028604,0,0,0,1,1
"89986",44993000,1000,0.00284429,0,0,0,1,1
"89987",44993500,1000,0.00272564,0,0,0,2,2
"89988",44994000,1000,0.00278789,0,0,0,2,2
"89989",44994500,1000,0.00278198,0,0,0,2,2
"89990",44995000,1000,0.00277838,0,0,0,4,4
"89991",44995500,1000,0.00266461,0,0,0,2,2
"89992",44996000,1000,0.00268897,0,0,0,0,0
"89993",44996500,1000,0.00267561,0,0,0,0,0
"89994",44997000,1000,0.00263601,0,0,0,2,2
"89995",44997500,1000,0.00265496,0,0,0,2,2
"89996",44998000,1000,0.00273148,0,0,0,2,2
"89997",44998500,1000,0.00274493,0,0,0,2,2
"89998",44999000,1000,0.00260353,0,0,0,0,0
"89999",44999500,1000,0.0025936,0,0,0,0,0
"90000",45000000,1000,0.00277576,0,0,1,2,3
"90001",45000500,1000,0.00277765,0,0,1,2,3
"90002",45001000,1000,0.00270375,0,0,0,0,0
"90003",45001500,1000,0.00270633,0,0,0,0,0
"90004",45002000,1000,0.00270301,0,0,0,1,1
"90005",45002500,1000,0.0027357,0,0,0,3,3
"90006",45003000,1000,0.00275326,0,0,0,2,2
"90007",45003500,1000,0.0026739,0,0,0,0,0
"90008",45004000,1000,0.00267838,0,0,0,1,1
"90009",45004500,1000,0.00269605,0,0,0,1,1
"90010",45005000,1000,0.00271156,0,0,1,2,3
"90011",45005500,1000,0.00276935,0,0,1,3,4
"90012",45006000,1000,0.00271621,0,0,0,2,2
"90013",45006500,1000,0.00254216,0,0,0,1,1
"90014",45007000,1000,0.00259642,0,0,1,0,1
"90015",45007500,1000,0.00271254,0,0,1,0,1
"90016",45008000,1000,0.00276728,0,0,0,2,2
"90017",45008500,1000,0.00279555,0,0,0,3,3
"90018",45009000,1000,0.00275566,0,0,1,1,2
"90019",45009500,1000,0.00273964,0,0,1,0,1
"90020",45010000,1000,0.00272312,0,0,0,1,1
"90021",45010500,1000,0.0027389,0,0,0,1,1
"90022",45011000,1000,0.00269037,0,0,0,3,3
"90023",45011500,1000,0.00287945,0,1,0,3,4
"90024",45012000,1000,0.00281223,0,1,0,1,2
"90025",45012500,1000,0.00269882,0,0,0,3,3
"90026",45013000,1000,0.00276517,0,0,0,3,3
"90027",45013500,1000,0.00263447,0,0,0,1,1
"90028",45014000,1000,0.00257262,0,0,0,2,2
"90029",45014500,1000,0.00273046,0,0,1,2,3
"90030",45015000,1000,0.00283585,0,0,1,0,1
"90031",45015500,1000,0.00271362,0,0,0,1,1
"90032",45016000,1000,0.00262207,0,0,0,2,2
"90033",45016500,1000,0.00251056,0,0,0,1,1
"90034",45017000,1000,0.00270592,0,0,1,2,3
"90035",45017500,1000,0.00276256,0,0,1,2,3
"90036",45018000,1000,0.00279401,0,1,0,0,1
"90037",45018500,1000,0.00287315,0,1,1,0,2
"90038",45019000,1000,0.00247855,0,0,1,0,1
"90039",45019500,1000,0.00251092,0,0,0,1,1
"90040",45020000,1000,0.00275035,0,0,0,2,2
"90041",45020500,1000,0.0026609,0,0,0,1,1
"90042",45021000,1000,0.00268894,0,0,0,0,0
"90043",45021500,1000,0.0027557,0,0,1,0,1
"90044",45022000,1000,0.00260512,0,0,1,0,1
"90045",45022500,1000,0.00251051,0,0,0,0,0
"90046",45023000,1000,0.00260989,0,0,0,0,0
"90047",45023500,1000,0.0026423,0,0,0,0,0
"90048",45024000,1000,0.00261675,0,0,0,0,0
"90049",45024500,1000,0.00270632,0,0,1,0,1
"90050",45025000,1000,0.00287128,0,1,1,0,2
"90051",45025500,1000,0.00281761,0,1,0,0,1
"90052",45026000,1000,0.00285971,0,0,1,3,4
"90053",45026500,1000,0.00293545,0,0,1,4,5
"90054",45027000,1000,0.00279857,0,0,0,1,1
"90055",45027500,1000,0.00288379,0,0,0,2,2
"90056",45028000,1000,0.00279262,0,0,0,3,3
"90057",45028500,1000,0.00282571,0,0,2,2,4
"90058",45029000,1000,0.00290178,0,0,3,1,4
"90059",45029500,1000,0.00265857,0,0,1,0,1
"90060",45030000,1000,0.00272638,0,0,0,2,2
"90061",45030500,1000,0.00293369,0,1,0,2,3
"90062",45031000,1000,0.00297802,0,1,1,1,3
"90063",45031500,1000,0.00289575,0,0,1,1,2
"90064",45032000,1000,0.00276632,0,0,0,1,1
"90065",45032500,1000,0.00274729,0,0,0,3,3
"90066",45033000,1000,0.00275517,0,0,1,3,4
"90067",45033500,1000,0.00275512,0,0,1,3,4
"90068",45034000,1000,0.0027549,0,0,0,2,2
"90069",45034500,1000,0.00273276,0,0,0,0,0
"90070",45035000,1000,0.00274229,0,0,0,2,2
"90071",45035500,1000,0.00287857,0,0,1,2,3
"90072",45036000,1000,0.00284388,0,0,1,1,2
"90073",45036500,1000,0.00270446,0,0,0,2,2
"90074",45037000,1000,0.00284975,0,1,0,1,2
"90075",45037500,1000,0.00294744,0,1,1,2,4
"90076",45038000,1000,0.00280774,0,0,1,3,4
"90077",45038500,1000,0.00270616,0,0,0,2,2
"90078",45039000,1000,0.00268819,0,0,0,1,1
"90079",45039500,1000,0.00272785,0,0,0,2,2
"90080",45040000,1000,0.00288428,0,0,1,3,4
"90081",45040500,1000,0.00285809,0,0,1,1,2
"90082",45041000,1000,0.00266189,0,0,0,0,0
"90083",45041500,1000,0.00276317,0,0,0,3,3
"90084",45042000,1000,0.00290951,0,0,0,4,4
"90085",45042500,1000,0.0027438,0,0,0,1,1
"90086",45043000,1000,0.0029572,0,1,0,0,1
"90087",45043500,1000,0.00293959,0,1,0,0,1
"90088",45044000,1000,0.00259445,0,0,0,1,1
"90089",45044500,1000,0.0026028,0,0,0,1,1
"90090",45045000,1000,0.00255759,0,0,0,0,0
"90091",45045500,1000,0.00263209,0,0,0,2,2
"90092",45046000,1000,0.00287648,0,0,2,2,4
"90093",45046500,1000,0.00281454,0,0,2,0,2
"90094",45047000,1000,0.00250981,0,0,0,0,0
"90095",45047500,1000,0.00252657,0,0,0,1,1
"90096",45048000,1000,0.00271962,0,0,0,5,5
"90097",45048500,1000,0.00272101,0,0,0,4,4
"90098",45049000,1000,0.00263958,0,0,0,0,0
"90099",45049500,1000,0.00271684,0,0,0,2,2
"90100",45050000,1000,0.0027358,0,0,0,3,3
"90101",45050500,1000,0.00265289,0,0,0,1,1
"90102",45051000,1000,0.00256646,0,0,0,1,1
"90103",45051500,1000,0.00230649,0,0,0,1,1
"90104",45052000,1000,0.00229078,0,0,0,1,1
"90105",45052500,1000,0.00268183,0,0,0,5,5
"90106",45053000,1000,0.00281961,0,0,0,4,4
"90107",45053500,1000,0.00289894,0,1,0,2,3
"90108",45054000,1000,0.00284153,0,1,0,2,3
"90109",45054500,1000,0.00268524,0,0,0,0,0
"90110",45055000,1000,0.0028203,0,1,0,0,1
"90111",45055500,1000,0.00288137,0,1,0,2,3
"90112",45056000,1000,0.00274953,0,0,0,2,2
"90113",45056500,1000,0.00272282,0,0,1,2,3
"90114",45057000,1000,0.00275022,0,0,1,4,5
"90115",45057500,1000,0.0028262,0,0,1,3,4
"90116",45058000,1000,0.00277497,0,0,1,2,3
"90117",45058500,1000,0.00268075,0,0,1,2,3
"90118",45059000,1000,0.00275887,0,0,2,1,3
"90119",45059500,1000,0.00295131,0,1,2,1,4
"90120",45060000,1000,0.00287474,0,1,1,2,4
"90121",45060500,1000,0.00254568,0,0,0,1,1
"90122",45061000,1000,0.00251198,0,0,0,0,0
"90123",45061500,1000,0.00252025,0,0,0,0,0
"90124",45062000,1000,0.00255853,0,0,0,1,1
"90125",45062500,1000,0.00266202,0,0,1,2,3
"90126",45063000,1000,0.00264641,0,0,1,2,3
"90127",45063500,1000,0.00275485,0,0,1,2,3
"90128",45064000,1000,0.0028161,0,0,1,3,4
"90129",45064500,1000,0.00267516,0,0,0,3,3
"90130",45065000,1000,0.00275268,0,0,1,2,3
"90131",45065500,1000,0.00263617,0,0,1,1,2
"90132",45066000,1000,0.00256919,0,0,0,1,1
"90133",45066500,1000,0.00281614,0,1,0,3,4
"90134",45067000,1000,0.00272493,0,1,0,2,3
"90135",45067500,1000,0.00251959,0,0,0,0,0
"90136",45068000,1000,0.00268703,0,0,1,1,2
"90137",45068500,1000,0.00276805,0,0,1,2,3
"90138",45069000,1000,0.00270489,0,0,0,4,4
"90139",45069500,1000,0.0026994,0,0,0,3,3
"90140",45070000,1000,0.00263551,0,0,0,0,0
"90141",45070500,1000,0.00270273,0,0,1,1,2
"90142",45071000,1000,0.00281809,0,0,1,1,2
"90143",45071500,1000,0.00276989,0,0,0,1,1
"90144",45072000,1000,0.00275351,0,0,0,2,2
"90145",45072500,1000,0.00275503,0,0,0,2,2
"90146",45073000,1000,0.0027129,0,0,0,2,2
"90147",45073500,1000,0.00268114,0,0,0,3,3
"90148",45074000,1000,0.00278867,0,0,0,3,3
"90149",45074500,1000,0.00277319,0,0,0,1,1
"90150",45075000,1000,0.00268213,0,0,0,1,1
"90151",45075500,1000,0.0028065,0,0,0,4,4
"90152",45076000,1000,0.00268028,0,0,0,3,3
"90153",45076500,1000,0.00264435,0,0,0,2,2
"90154",45077000,1000,0.0026676,0,0,0,3,3
"90155",45077500,1000,0.00261282,0,0,0,2,2
"90156",45078000,1000,0.00285646,0,1,1,1,3
"90157",45078500,1000,0.00280513,0,1,1,1,3
"90158",45079000,1000,0.00274344,0,0,1,2,3
"90159",45079500,1000,0.00278313,0,0,1,3,4
"90160",45080000,1000,0.00264042,0,0,0,2,2
"90161",45080500,1000,0.00274123,0,0,0,2,2
"90162",45081000,1000,0.00270828,0,0,0,2,2
"90163",45081500,1000,0.00270885,0,0,1,0,1
"90164",45082000,1000,0.00275393,0,0,1,0,1
"90165",45082500,1000,0.00268011,0,0,0,2,2
"90166",45083000,1000,0.00269659,0,0,1,2,3
"90167",45083500,1000,0.00264521,0,0,1,0,1
"90168",45084000,1000,0.00251402,0,0,0,0,0
"90169",45084500,1000,0.00268942,0,0,1,2,3
"90170",45085000,1000,0.00280439,0,0,1,2,3
"90171",45085500,1000,0.00263004,0,0,1,0,1
"90172",45086000,1000,0.0026511,0,0,1,1,2
"90173",45086500,1000,0.00268745,0,0,0,1,1
"90174",45087000,1000,0.00265429,0,0,0,0,0
"90175",45087500,1000,0.00264518,0,0,0,0,0
"90176",45088000,1000,0.00266632,0,0,0,0,0
"90177",45088500,1000,0.00279952,0,0,1,2,3
"90178",45089000,1000,0.00275642,0,0,1,2,3
"90179",45089500,1000,0.00274176,0,0,0,4,4
"90180",45090000,1000,0.00284376,0,0,0,5,5
"90181",45090500,1000,0.0027648,0,0,0,1,1
"90182",45091000,1000,0.00274938,0,0,0,0,0
"90183",45091500,1000,0.00262658,0,0,0,1,1
"90184",45092000,1000,0.00294926,0,1,1,1,3
"90185",45092500,1000,0.00294666,0,1,1,0,2
"90186",45093000,1000,0.00254738,0,0,0,0,0
"90187",45093500,1000,0.00264449,0,0,0,0,0
"90188",45094000,1000,0.00279464,0,0,0,3,3
"90189",45094500,1000,0.00282667,0,0,1,3,4
"90190",45095000,1000,0.00291381,0,0,2,2,4
"90191",45095500,1000,0.00280764,0,0,1,3,4
"90192",45096000,1000,0.00262333,0,0,0,1,1
"90193",45096500,1000,0.00265169,0,0,0,0,0
"90194",45097000,1000,0.00261406,0,0,0,0,0
"90195",45097500,1000,0.00266245,0,0,0,1,1
"90196",45098000,1000,0.00272078,0,0,0,1,1
"90197",45098500,1000,0.0026292,0,0,0,0,0
"90198",45099000,1000,0.00262483,0,0,0,0,0
"90199",45099500,1000,0.00275357,0,0,0,1,1
"90200",45100000,1000,0.00273179,0,0,0,2,2
"90201",45100500,1000,0.00289238,0,0,2,3,5
"90202",45101000,1000,0.00292409,0,0,2,3,5
"90203",45101500,1000,0.00269243,0,0,0,1,1
"90204",45102000,1000,0.00276212,0,0,1,0,1
"90205",45102500,1000,0.00284397,0,0,1,1,2
"90206",45103000,1000,0.0028264,0,0,0,2,2
"90207",45103500,1000,0.00278722,0,0,0,1,1
"90208",45104000,1000,0.00279744,0,0,0,1,1
"90209",45104500,1000,0.00280462,0,0,0,1,1
"90210",45105000,1000,0.00278348,0,0,0,1,1
"90211",45105500,1000,0.00272849,0,0,0,1,1
"90212",45106000,1000,0.00275084,0,0,0,1,1
"90213",45106500,1000,0.00271083,0,0,0,1,1
"90214",45107000,1000,0.00256621,0,0,0,0,0
"90215",45107500,1000,0.00283696,0,1,0,0,1
"90216",45108000,1000,0.00294949,0,1,0,1,2
"90217",45108500,1000,0.00272057,0,0,0,1,1
"90218",45109000,1000,0.00288119,0,0,0,1,1
"90219",45109500,1000,0.00298924,0,0,1,2,3
"90220",45110000,1000,0.00283766,0,0,2,2,4
"90221",45110500,1000,0.00275544,0,0,1,1,2
"90222",45111000,1000,0.00272778,0,0,1,0,1
"90223",45111500,1000,0.00288145,0,1,1,0,2
"90224",45112000,1000,0.0028305,0,1,0,0,1
"90225",45112500,1000,0.00267429,0,0,0,0,0
"90226",45113000,1000,0.00272089,0,0,0,0,0
"90227",45113500,1000,0.00271442,0,0,0,0,0
"90228",45114000,1000,0.00268565,0,0,1,0,1
"90229",45114500,1000,0.00279565,0,0,2,0,2
"90230",45115000,1000,0.00278436,0,0,1,1,2
"90231",45115500,1000,0.00268472,0,0,0,2,2
"90232",45116000,1000,0.00275953,0,0,0,1,1
"90233",45116500,1000,0.00271894,0,0,0,0,0
"90234",45117000,1000,0.00270798,0,0,0,2,2
"90235",45117500,1000,0.00282344,0,0,0,4,4
"90236",45118000,1000,0.00278885,0,0,0,2,2
"90237",45118500,1000,0.00273363,0,0,0,1,1
"90238",45119000,1000,0.00275653,0,0,0,1,1
"90239",45119500,1000,0.00290199,0,0,1,1,2
"90240",45120000,1000,0.00301914,0,0,2,1,3
"90241",45120500,1000,0.00276978,0,0,1,0,1
"90242",45121000,1000,0.00255242,0,0,0,0,0
"90243",45121500,1000,0.00256364,0,0,0,0,0
"90244",45122000,1000,0.00267722,0,0,0,0,0
"90245",45122500,1000,0.00282424,0,0,0,0,0
"90246",45123000,1000,0.00286932,0,1,0,0,1
"90247",45123500,1000,0.00286016,0,1,0,2,3
"90248",45124000,1000,0.00268695,0,0,0,2,2
"90249",45124500,1000,0.0028773,0,0,2,2,4
"90250",45125000,1000,0.00311882,0,0,3,6,9
"90251",45125500,1000,0.00277691,0,0,1,4,5
"90252",45126000,1000,0.00262193,0,0,1,0,1
"90253",45126500,1000,0.00277263,0,0,1,2,3
"90254",45127000,1000,0.00273907,0,0,0,2,2
"90255",45127500,1000,0.00261953,0,0,0,0,0
"90256",45128000,1000,0.0025896,0,0,0,0,0
"90257",45128500,1000,0.00257611,0,0,0,0,0
"90258",45129000,1000,0.00271346,0,0,1,1,2
"90259",45129500,1000,0.00271931,0,0,1,1,2
"90260",45130000,1000,0.0026595,0,0,0,2,2
"90261",45130500,1000,0.00279148,0,0,0,4,4
"90262",45131000,1000,0.00277177,0,0,0,2,2
"90263",45131500,1000,0.00266461,0,0,0,0,0
"90264",45132000,1000,0.00242762,0,0,0,0,0
"90265",45132500,1000,0.0023123,0,0,0,0,0
"90266",45133000,1000,0.00255459,0,0,0,0,0
"90267",45133500,1000,0.00267764,0,0,1,1,2
"90268",45134000,1000,0.00250541,0,0,1,1,2
"90269",45134500,1000,0.00253524,0,0,1,1,2
"90270",45135000,1000,0.00273715,0,0,2,3,5
"90271",45135500,1000,0.00275198,0,0,1,2,3
"90272",45136000,1000,0.00266209,0,0,0,0,0
"90273",45136500,1000,0.00266322,0,0,0,0,0
"90274",45137000,1000,0.00277832,0,0,0,1,1
"90275",45137500,1000,0.00277733,0,0,0,1,1
"90276",45138000,1000,0.00281613,0,0,0,1,1
"90277",45138500,1000,0.00283098,0,0,0,4,4
"90278",45139000,1000,0.00273117,0,0,0,3,3
"90279",45139500,1000,0.00268163,0,0,0,0,0
"90280",45140000,1000,0.00269999,0,0,0,1,1
"90281",45140500,1000,0.00288394,0,0,1,2,3
"90282",45141000,1000,0.00278642,0,0,1,1,2
"90283",45141500,1000,0.00256059,0,0,0,0,0
"90284",45142000,1000,0.00259092,0,0,1,1,2
"90285",45142500,1000,0.00267688,0,0,1,3,4
"90286",45143000,1000,0.0026528,0,0,0,3,3
"90287",45143500,1000,0.00261428,0,0,0,1,1
"90288",45144000,1000,0.00249377,0,0,0,0,0
"90289",45144500,1000,0.00249597,0,0,1,0,1
"90290",45145000,1000,0.00266366,0,0,1,0,1
"90291",45145500,1000,0.00274888,0,0,1,1,2
"90292",45146000,1000,0.0027295,0,0,1,1,2
"90293",45146500,1000,0.00261651,0,0,0,1,1
"90294",45147000,1000,0.00256641,0,0,0,1,1
"90295",45147500,1000,0.00248165,0,0,0,0,0
"90296",45148000,1000,0.00243173,0,0,0,1,1
"90297",45148500,1000,0.00249532,0,0,0,2,2
"90298",45149000,1000,0.00262211,0,0,0,1,1
"90299",45149500,1000,0.00279167,0,1,0,0,1
"90300",45150000,1000,0.00288168,0,1,0,1,2
"90301",45150500,1000,0.00254764,0,0,0,1,1
"90302",45151000,1000,0.00246312,0,0,0,1,1
"90303",45151500,1000,0.00265116,0,0,0,1,1
"90304",45152000,1000,0.00261949,0,0,0,0,0
"90305",45152500,1000,0.00257189,0,0,0,0,0
"90306",45153000,1000,0.00254042,0,0,0,1,1
"90307",45153500,1000,0.00256128,0,0,0,2,2
"90308",45154000,1000,0.00266795,0,0,1,1,2
"90309",45154500,1000,0.00290958,0,0,3,1,4
"90310",45155000,1000,0.00278981,0,0,2,1,3
"90311",45155500,1000,0.00252845,0,0,0,0,0
"90312",45156000,1000,0.00259836,0,0,1,0,1
"90313",45156500,1000,0.0027333,0,0,2,0,2
"90314",45157000,1000,0.00282347,0,0,2,1,3
"90315",45157500,1000,0.00272211,0,0,1,1,2
"90316",45158000,1000,0.00261565,0,0,0,0,0
"90317",45158500,1000,0.00278892,0,0,0,1,1
"90318",45159000,1000,0.00263809,0,0,0,1,1
"90319",45159500,1000,0.00260859,0,0,0,2,2
"90320",45160000,1000,0.00271741,0,0,0,2,2
"90321",45160500,1000,0.00277813,0,1,0,0,1
"90322",45161000,1000,0.00273331,0,1,0,0,1
"90323",45161500,1000,0.00250707,0,0,0,0,0
"90324",45162000,1000,0.00276063,0,1,0,0,1
"90325",45162500,1000,0.00285392,0,1,0,0,1
"90326",45163000,1000,0.00281215,0,0,1,2,3
"90327",45163500,1000,0.00288365,0,0,1,3,4
"90328",45164000,1000,0.00287541,0,0,1,2,3
"90329",45164500,1000,0.00280207,0,0,1,2,3
"90330",45165000,1000,0.0026489,0,0,0,2,2
"90331",45165500,1000,0.00254096,0,0,0,1,1
"90332",45166000,1000,0.00260209,0,0,0,2,2
"90333",45166500,1000,0.00271154,0,0,0,4,4
"90334",45167000,1000,0.00274129,0,0,1,3,4
"90335",45167500,1000,0.00276306,0,0,2,1,3
"90336",45168000,1000,0.00278071,0,0,2,1,3
"90337",45168500,1000,0.00274282,0,0,1,2,3
"90338",45169000,1000,0.00271839,0,0,0,1,1
"90339",45169500,1000,0.00284065,0,0,0,0,0
"90340",45170000,1000,0.00276378,0,0,0,0,0
"90341",45170500,1000,0.00267964,0,0,0,0,0
"90342",45171000,1000,0.00272893,0,0,0,1,1
"90343",45171500,1000,0.00261542,0,0,0,1,1
"90344",45172000,1000,0.00254678,0,0,0,0,0
"90345",45172500,1000,0.00259578,0,0,0,0,0
"90346",45173000,1000,0.00268857,0,0,0,1,1
"90347",45173500,1000,0.00270572,0,0,0,1,1
"90348",45174000,1000,0.00284113,0,0,2,2,4
"90349",45174500,1000,0.00284608,0,0,2,3,5
"90350",45175000,1000,0.00285012,0,0,1,1,2
"90351",45175500,1000,0.00289271,0,0,1,0,1
"90352",45176000,1000,0.00270361,0,0,0,0,0
"90353",45176500,1000,0.00255312,0,0,0,0,0
"90354",45177000,1000,0.00270689,0,0,1,2,3
"90355",45177500,1000,0.00275885,0,0,1,2,3
"90356",45178000,1000,0.00272374,0,0,0,1,1
"90357",45178500,1000,0.00283516,0,0,0,4,4
"90358",45179000,1000,0.00283915,0,0,0,4,4
"90359",45179500,1000,0.00267518,0,0,0,2,2
"90360",45180000,1000,0.002811,0,0,2,4,6
"90361",45180500,1000,0.00291513,0,0,2,4,6
"90362",45181000,1000,0.00271722,0,0,1,2,3
"90363",45181500,1000,0.00277638,0,0,1,2,3
"90364",45182000,1000,0.00275501,0,0,1,1,2
"90365",45182500,1000,0.00271807,0,0,1,1,2
"90366",45183000,1000,0.00284891,0,0,0,1,1
"90367",45183500,1000,0.0029491,0,0,1,1,2
"90368",45184000,1000,0.0028044,0,0,1,2,3
"90369",45184500,1000,0.00267379,0,0,0,1,1
"90370",45185000,1000,0.00265461,0,0,0,2,2
"90371",45185500,1000,0.00264462,0,0,0,4,4
"90372",45186000,1000,0.00276191,0,0,1,3,4
"90373",45186500,1000,0.00285453,0,0,1,2,3
"90374",45187000,1000,0.00287549,0,0,0,3,3
"90375",45187500,1000,0.00285531,0,0,0,2,2
"90376",45188000,1000,0.00281733,0,0,0,3,3
"90377",45188500,1000,0.00265705,0,0,0,3,3
"90378",45189000,1000,0.00245641,0,0,0,0,0
"90379",45189500,1000,0.00258255,0,0,0,0,0
"90380",45190000,1000,0.00279613,0,0,0,3,3
"90381",45190500,1000,0.00273024,0,0,0,3,3
"90382",45191000,1000,0.00257208,0,0,0,0,0
"90383",45191500,1000,0.00258951,0,0,0,1,1
"90384",45192000,1000,0.00275423,0,0,0,3,3
"90385",45192500,1000,0.00278041,0,0,0,4,4
"90386",45193000,1000,0.00274245,0,0,1,3,4
"90387",45193500,1000,0.00285413,0,0,1,5,6
"90388",45194000,1000,0.00272281,0,0,0,4,4
"90389",45194500,1000,0.00253677,0,0,0,1,1
"90390",45195000,1000,0.00264596,0,0,0,1,1
"90391",45195500,1000,0.00264757,0,0,0,0,0
"90392",45196000,1000,0.00268863,0,0,1,1,2
"90393",45196500,1000,0.00298257,0,0,2,3,5
"90394",45197000,1000,0.00317227,0,1,1,2,4
"90395",45197500,1000,0.00313196,0,1,0,0,1
"90396",45198000,1000,0.00274086,0,0,0,0,0
"90397",45198500,1000,0.00245948,0,0,0,0,0
"90398",45199000,1000,0.00270536,0,0,1,0,1
"90399",45199500,1000,0.00293543,0,0,2,1,3
"90400",45200000,1000,0.00282062,0,0,1,2,3
"90401",45200500,1000,0.00277259,0,0,1,1,2
"90402",45201000,1000,0.0028748,0,1,1,0,2
"90403",45201500,1000,0.00292703,0,1,0,2,3
"90404",45202000,1000,0.00267984,0,0,0,2,2
"90405",45202500,1000,0.0026742,0,0,1,2,3
"90406",45203000,1000,0.00313986,0,1,2,2,5
"90407",45203500,1000,0.0030002,0,1,1,1,3
"90408",45204000,1000,0.00258305,0,0,0,1,1
"90409",45204500,1000,0.00254618,0,0,0,0,0
"90410",45205000,1000,0.00265085,0,0,0,1,1
"90411",45205500,1000,0.00259236,0,0,0,1,1
"90412",45206000,1000,0.00263134,0,0,0,2,2
"90413",45206500,1000,0.00276883,0,0,0,4,4
"90414",45207000,1000,0.00286583,0,0,1,3,4
"90415",45207500,1000,0.00284024,0,0,1,3,4
"90416",45208000,1000,0.0027576,0,0,0,2,2
"90417",45208500,1000,0.00286008,0,0,0,4,4
"90418",45209000,1000,0.00281672,0,0,0,6,6
"90419",45209500,1000,0.00283354,0,0,0,4,4
"90420",45210000,1000,0.00271354,0,0,0,2,2
"90421",45210500,1000,0.00258613,0,0,1,1,2
"90422",45211000,1000,0.00272984,0,0,2,2,4
"90423",45211500,1000,0.0028469,0,0,1,4,5
"90424",45212000,1000,0.00268366,0,0,0,3,3
"90425",45212500,1000,0.00275769,0,0,2,1,3
"90426",45213000,1000,0.00281209,0,0,2,1,3
"90427",45213500,1000,0.00266667,0,0,0,2,2
"90428",45214000,1000,0.00283973,0,1,0,4,5
"90429",45214500,1000,0.00277736,0,1,0,2,3
"90430",45215000,1000,0.00273449,0,0,0,2,2
"90431",45215500,1000,0.00268577,0,0,0,2,2
"90432",45216000,1000,0.0026259,0,0,0,0,0
"90433",45216500,1000,0.0026347,0,0,0,1,1
"90434",45217000,1000,0.00267606,0,0,0,3,3
"90435",45217500,1000,0.00263244,0,0,0,3,3
"90436",45218000,1000,0.00264899,0,0,1,2,3
"90437",45218500,1000,0.00281048,0,0,2,2,4
"90438",45219000,1000,0.00267261,0,0,1,1,2
"90439",45219500,1000,0.00267431,0,0,1,1,2
"90440",45220000,1000,0.00292398,0,0,3,2,5
"90441",45220500,1000,0.00293127,0,0,2,2,4
"90442",45221000,1000,0.00268578,0,0,0,1,1
"90443",45221500,1000,0.00241511,0,0,0,0,0
"90444",45222000,1000,0.00228019,0,0,0,0,0
"90445",45222500,1000,0.00241936,0,0,0,0,0
"90446",45223000,1000,0.00259948,0,0,0,1,1
"90447",45223500,1000,0.00268649,0,0,0,1,1
"90448",45224000,1000,0.00276828,0,0,0,1,1
"90449",45224500,1000,0.00272295,0,0,0,2,2
"90450",45225000,1000,0.00271856,0,0,1,2,3
"90451",45225500,1000,0.00281866,0,0,1,1,2
"90452",45226000,1000,0.00277844,0,0,0,1,1
"90453",45226500,1000,0.00265498,0,0,0,1,1
"90454",45227000,1000,0.00265196,0,0,0,0,0
"90455",45227500,1000,0.00269589,0,0,0,0,0
"90456",45228000,1000,0.00268416,0,0,0,0,0
"90457",45228500,1000,0.00271254,0,0,0,0,0
"90458",45229000,1000,0.00281029,0,0,1,0,1
"90459",45229500,1000,0.00278308,0,0,1,0,1
"90460",45230000,1000,0.00267679,0,0,0,1,1
"90461",45230500,1000,0.00278578,0,0,0,1,1
"90462",45231000,1000,0.00285956,0,0,0,1,1
"90463",45231500,1000,0.00270469,0,0,0,1,1
"90464",45232000,1000,0.00252916,0,0,0,0,0
"90465",45232500,1000,0.00267183,0,0,0,0,0
"90466",45233000,1000,0.00286185,0,0,0,0,0
"90467",45233500,1000,0.00285104,0,0,0,1,1
"90468",45234000,1000,0.00273554,0,0,0,1,1
"90469",45234500,1000,0.0025991,0,0,0,0,0
"90470",45235000,1000,0.0026697,0,1,0,0,1
"90471",45235500,1000,0.00270251,0,1,0,0,1
"90472",45236000,1000,0.00264436,0,0,0,0,0
"90473",45236500,1000,0.00260587,0,0,0,2,2
"90474",45237000,1000,0.00290243,0,1,0,2,3
"90475",45237500,1000,0.00300562,0,1,0,0,1
"90476",45238000,1000,0.00268234,0,0,0,0,0
"90477",45238500,1000,0.0026983,0,0,0,0,0
"90478",45239000,1000,0.00282631,0,0,0,1,1
"90479",45239500,1000,0.00291894,0,1,0,1,2
"90480",45240000,1000,0.00279395,0,1,0,2,3
"90481",45240500,1000,0.00268166,0,0,0,3,3
"90482",45241000,1000,0.00270902,0,0,0,1,1
"90483",45241500,1000,0.00253865,0,0,0,0,0
"90484",45242000,1000,0.00249762,0,0,0,0,0
"90485",45242500,1000,0.00259409,0,0,0,0,0
"90486",45243000,1000,0.00268231,0,0,0,0,0
"90487",45243500,1000,0.00272899,0,0,0,0,0
"90488",45244000,1000,0.0026968,0,0,0,0,0
"90489",45244500,1000,0.00291983,0,0,0,2,2
"90490",45245000,1000,0.00306216,0,0,1,2,3
"90491",45245500,1000,0.00279525,0,0,1,0,1
"90492",45246000,1000,0.00264725,0,0,0,1,1
"90493",45246500,1000,0.00266752,0,0,0,1,1
"90494",45247000,1000,0.00256739,0,0,0,0,0
"90495",45247500,1000,0.00251824,0,0,0,1,1
"90496",45248000,1000,0.00250084,0,0,0,1,1
"90497",45248500,1000,0.00258547,0,0,0,0,0
"90498",45249000,1000,0.00267289,0,0,0,1,1
"90499",45249500,1000,0.00275638,0,0,0,3,3
"90500",45250000,1000,0.00276046,0,0,0,2,2
"90501",45250500,1000,0.00264965,0,0,0,0,0
"90502",45251000,1000,0.00260419,0,0,0,0,0
"90503",45251500,1000,0.00261872,0,0,0,1,1
"90504",45252000,1000,0.00264456,0,0,0,2,2
"90505",45252500,1000,0.0026674,0,0,0,1,1
"90506",45253000,1000,0.00267573,0,0,0,0,0
"90507",45253500,1000,0.00296603,0,0,1,2,3
"90508",45254000,1000,0.0029612,0,0,1,2,3
"90509",45254500,1000,0.00263006,0,0,0,1,1
"90510",45255000,1000,0.00271483,0,0,1,1,2
"90511",45255500,1000,0.00277288,0,0,1,0,1
"90512",45256000,1000,0.00274562,0,0,0,1,1
"90513",45256500,1000,0.00275289,0,0,0,2,2
"90514",45257000,1000,0.00262251,0,0,0,1,1
"90515",45257500,1000,0.00254822,0,0,0,0,0
"90516",45258000,1000,0.00265024,0,0,0,0,0
"90517",45258500,1000,0.00264138,0,0,0,0,0
"90518",45259000,1000,0.00257384,0,0,0,0,0
"90519",45259500,1000,0.00257259,0,0,0,1,1
"90520",45260000,1000,0.00270658,0,0,0,2,2
"90521",45260500,1000,0.00280083,0,0,0,2,2
"90522",45261000,1000,0.00276396,0,0,0,1,1
"90523",45261500,1000,0.00264339,0,0,0,1,1
"90524",45262000,1000,0.00254054,0,0,0,1,1
"90525",45262500,1000,0.0026644,0,0,0,0,0
"90526",45263000,1000,0.0028914,0,0,0,1,1
"90527",45263500,1000,0.00290073,0,0,0,1,1
"90528",45264000,1000,0.00276747,0,0,0,0,0
"90529",45264500,1000,0.00272813,0,0,0,1,1
"90530",45265000,1000,0.00274634,0,0,0,3,3
"90531",45265500,1000,0.00276586,0,0,1,2,3
"90532",45266000,1000,0.00280522,0,0,1,0,1
"90533",45266500,1000,0.00269669,0,0,0,0,0
"90534",45267000,1000,0.00264388,0,0,0,0,0
"90535",45267500,1000,0.00263019,0,0,0,0,0
"90536",45268000,1000,0.00264053,0,0,0,1,1
"90537",45268500,1000,0.00276858,0,0,0,2,2
"90538",45269000,1000,0.00267407,0,0,0,1,1
"90539",45269500,1000,0.00258958,0,0,0,0,0
"90540",45270000,1000,0.00256123,0,0,0,0,0
"90541",45270500,1000,0.0025281,0,0,0,0,0
"90542",45271000,1000,0.00263335,0,0,0,0,0
"90543",45271500,1000,0.00265307,0,0,1,1,2
"90544",45272000,1000,0.00260817,0,0,1,1,2
"90545",45272500,1000,0.00257821,0,0,0,0,0
"90546",45273000,1000,0.00249734,0,0,0,0,0
"90547",45273500,1000,0.00262003,0,0,0,1,1
"90548",45274000,1000,0.00278318,0,0,0,1,1
"90549",45274500,1000,0.00285436,0,0,1,1,2
"90550",45275000,1000,0.00271278,0,0,1,1,2
"90551",45275500,1000,0.00256793,0,0,0,1,1
"90552",45276000,1000,0.00256887,0,0,0,1,1
"90553",45276500,1000,0.00257511,0,0,0,1,1
"90554",45277000,1000,0.00272455,0,0,0,2,2
"90555",45277500,1000,0.00284755,0,0,1,1,2
"90556",45278000,1000,0.00262978,0,0,1,0,1
"90557",45278500,1000,0.00247815,0,0,0,1,1
"90558",45279000,1000,0.00257857,0,0,0,1,1
"90559",45279500,1000,0.00263144,0,0,0,2,2
"90560",45280000,1000,0.00268345,0,0,0,2,2
"90561",45280500,1000,0.0027901,0,0,1,1,2
"90562",45281000,1000,0.00273508,0,0,1,1,2
"90563",45281500,1000,0.00259007,0,0,0,1,1
"90564",45282000,1000,0.0026024,0,0,0,2,2
"90565",45282500,1000,0.00276097,0,0,1,1,2
"90566",45283000,1000,0.00300327,0,0,1,1,2
"90567",45283500,1000,0.00284498,0,0,0,1,1
"90568",45284000,1000,0.00300971,0,1,0,1,2
"90569",45284500,1000,0.00305765,0,1,0,1,2
"90570",45285000,1000,0.00284147,0,1,0,2,3
"90571",45285500,1000,0.00280074,0,1,0,3,4
"90572",45286000,1000,0.00266126,0,0,0,1,1
"90573",45286500,1000,0.00278778,0,0,0,1,1
"90574",45287000,1000,0.00277978,0,0,0,1,1
"90575",45287500,1000,0.00274823,0,0,0,1,1
"90576",45288000,1000,0.00277545,0,0,0,1,1
"90577",45288500,1000,0.0027695,0,0,1,1,2
"90578",45289000,1000,0.00281089,0,0,1,2,3
"90579",45289500,1000,0.00268552,0,0,0,1,1
"90580",45290000,1000,0.00265836,0,0,0,0,0
"90581",45290500,1000,0.00292629,0,0,1,2,3
"90582",45291000,1000,0.00296425,0,0,1,2,3
"90583",45291500,1000,0.00272374,0,0,0,0,0
"90584",45292000,1000,0.00265638,0,0,0,0,0
"90585",45292500,1000,0.00299387,0,1,2,0,3
"90586",45293000,1000,0.00336587,0,2,2,0,4
"90587",45293500,1000,0.00312138,0,1,0,0,1
"90588",45294000,1000,0.00282286,0,0,1,0,1
"90589",45294500,1000,0.00272095,0,0,1,0,1
"90590",45295000,1000,0.00252969,0,0,0,0,0
"90591",45295500,1000,0.00259261,0,0,0,0,0
"90592",45296000,1000,0.00273546,0,0,0,1,1
"90593",45296500,1000,0.00260688,0,0,0,1,1
"90594",45297000,1000,0.00256741,0,0,0,0,0
"90595",45297500,1000,0.00278959,0,0,1,1,2
"90596",45298000,1000,0.0026794,0,0,1,1,2
"90597",45298500,1000,0.0025905,0,0,0,0,0
"90598",45299000,1000,0.00275228,0,0,0,0,0
"90599",45299500,1000,0.0027573,0,0,0,2,2
"90600",45300000,1000,0.00281887,0,0,1,3,4
"90601",45300500,1000,0.00271516,0,0,1,2,3
"90602",45301000,1000,0.00266765,0,0,0,3,3
"90603",45301500,1000,0.00260551,0,0,0,2,2
"90604",45302000,1000,0.00250702,0,0,0,0,0
"90605",45302500,1000,0.00265001,0,0,0,2,2
"90606",45303000,1000,0.00279059,0,0,0,4,4
"90607",45303500,1000,0.00271157,0,0,0,4,4
"90608",45304000,1000,0.00268896,0,0,0,4,4
"90609",45304500,1000,0.00273276,0,0,0,3,3
"90610",45305000,1000,0.00273394,0,0,1,2,3
"90611",45305500,1000,0.00277723,0,0,1,1,2
"90612",45306000,1000,0.00260499,0,0,0,0,0
"90613",45306500,1000,0.00253023,0,0,0,0,0
"90614",45307000,1000,0.00257906,0,0,0,0,0
"90615",45307500,1000,0.00260809,0,0,0,0,0
"90616",45308000,1000,0.00259845,0,0,0,0,0
"90617",45308500,1000,0.00276599,0,0,1,0,1
"90618",45309000,1000,0.00292036,0,0,1,0,1
"90619",45309500,1000,0.00285367,0,0,0,2,2
"90620",45310000,1000,0.00273019,0,0,0,3,3
"90621",45310500,1000,0.0026874,0,0,0,2,2
"90622",45311000,1000,0.00279251,0,0,0,1,1
"90623",45311500,1000,0.00276258,0,0,0,0,0
"90624",45312000,1000,0.00271465,0,0,0,2,2
"90625",45312500,1000,0.00280304,0,0,0,3,3
"90626",45313000,1000,0.00282595,0,0,0,1,1
"90627",45313500,1000,0.00300633,0,1,0,0,1
"90628",45314000,1000,0.002904,0,1,0,0,1
"90629",45314500,1000,0.00256244,0,0,0,0,0
"90630",45315000,1000,0.00262147,0,0,0,0,0
"90631",45315500,1000,0.00270209,0,0,0,1,1
"90632",45316000,1000,0.00270297,0,0,0,1,1
"90633",45316500,1000,0.00248815,0,0,0,0,0
"90634",45317000,1000,0.00229721,0,0,0,0,0
"90635",45317500,1000,0.00247987,0,0,0,0,0
"90636",45318000,1000,0.00262338,0,0,0,0,0
"90637",45318500,1000,0.00260296,0,0,0,0,0
"90638",45319000,1000,0.00267662,0,0,0,0,0
"90639",45319500,1000,0.00275466,0,0,0,0,0
"90640",45320000,1000,0.00273881,0,0,0,0,0
"90641",45320500,1000,0.00266605,0,0,0,0,0
"90642",45321000,1000,0.00265271,0,0,0,0,0
"90643",45321500,1000,0.00276263,0,0,0,2,2
"90644",45322000,1000,0.00303643,0,1,1,2,4
"90645",45322500,1000,0.00301542,0,1,1,1,3
"90646",45323000,1000,0.00279534,0,0,0,1,1
"90647",45323500,1000,0.00286514,0,0,0,1,1
"90648",45324000,1000,0.00289621,0,0,1,1,2
"90649",45324500,1000,0.00287579,0,0,2,1,3
"90650",45325000,1000,0.00273999,0,0,1,1,2
"90651",45325500,1000,0.00268968,0,0,0,3,3
"90652",45326000,1000,0.0027809,0,0,1,3,4
"90653",45326500,1000,0.00282607,0,0,1,0,1
"90654",45327000,1000,0.00278357,0,0,0,1,1
"90655",45327500,1000,0.00275072,0,0,0,3,3
"90656",45328000,1000,0.0028327,0,0,1,3,4
"90657",45328500,1000,0.00263532,0,0,1,1,2
"90658",45329000,1000,0.0024967,0,0,0,0,0
"90659",45329500,1000,0.00264106,0,0,0,1,1
"90660",45330000,1000,0.00273453,0,0,0,3,3
"90661",45330500,1000,0.00266742,0,0,0,2,2
"90662",45331000,1000,0.00251401,0,0,0,0,0
"90663",45331500,1000,0.00254046,0,0,0,1,1
"90664",45332000,1000,0.00264906,0,0,0,1,1
"90665",45332500,1000,0.0026345,0,0,0,0,0
"90666",45333000,1000,0.00271089,0,0,0,1,1
"90667",45333500,1000,0.00282901,0,0,0,1,1
"90668",45334000,1000,0.00267473,0,0,0,0,0
"90669",45334500,1000,0.00267276,0,0,0,1,1
"90670",45335000,1000,0.00277159,0,0,0,3,3
"90671",45335500,1000,0.00280262,0,0,0,3,3
"90672",45336000,1000,0.00290015,0,1,0,1,2
"90673",45336500,1000,0.00297837,0,2,0,0,2
"90674",45337000,1000,0.00285259,0,1,0,1,2
"90675",45337500,1000,0.00262159,0,0,0,1,1
"90676",45338000,1000,0.00288293,0,1,0,1,2
"90677",45338500,1000,0.00297342,0,1,0,4,5
"90678",45339000,1000,0.00273854,0,0,0,3,3
"90679",45339500,1000,0.0027303,0,0,0,1,1
"90680",45340000,1000,0.00282004,0,0,0,2,2
"90681",45340500,1000,0.00286606,0,0,1,2,3
"90682",45341000,1000,0.00279291,0,0,1,2,3
"90683",45341500,1000,0.00278729,0,0,0,1,1
"90684",45342000,1000,0.00273763,0,0,0,0,0
"90685",45342500,1000,0.00254547,0,0,0,0,0
"90686",45343000,1000,0.00257529,0,0,0,0,0
"90687",45343500,1000,0.0026175,0,0,0,0,0
"90688",45344000,1000,0.00261374,0,0,0,2,2
"90689",45344500,1000,0.00271853,0,0,0,4,4
"90690",45345000,1000,0.00268987,0,0,0,3,3
"90691",45345500,1000,0.00257459,0,0,0,1,1
"90692",45346000,1000,0.00276769,0,1,0,1,2
"90693",45346500,1000,0.00283124,0,1,0,1,2
"90694",45347000,1000,0.00273192,0,0,0,3,3
"90695",45347500,1000,0.00263936,0,0,0,3,3
"90696",45348000,1000,0.00249998,0,0,0,0,0
"90697",45348500,1000,0.00256972,0,0,0,0,0
"90698",45349000,1000,0.00253884,0,0,0,0,0
"90699",45349500,1000,0.00250142,0,0,0,0,0
"90700",45350000,1000,0.00242676,0,0,0,0,0
"90701",45350500,1000,0.00238256,0,0,0,0,0
"90702",45351000,1000,0.00249062,0,0,1,0,1
"90703",45351500,1000,0.00253842,0,0,1,0,1
"90704",45352000,1000,0.00265757,0,0,1,0,1
"90705",45352500,1000,0.00273742,0,0,1,1,2
"90706",45353000,1000,0.00262928,0,0,0,1,1
"90707",45353500,1000,0.00265206,0,0,0,2,2
"90708",45354000,1000,0.0026744,0,0,0,3,3
"90709",45354500,1000,0.00268661,0,0,0,1,1
"90710",45355000,1000,0.00279613,0,0,0,1,1
"90711",45355500,1000,0.00280196,0,0,0,2,2
"90712",45356000,1000,0.0028938,0,0,1,2,3
"90713",45356500,1000,0.00273251,0,0,1,1,2
"90714",45357000,1000,0.00266584,0,0,1,0,1
"90715",45357500,1000,0.00270015,0,0,1,0,1
"90716",45358000,1000,0.00247695,0,0,0,0,0
"90717",45358500,1000,0.00245173,0,0,0,0,0
"90718",45359000,1000,0.00253723,0,0,0,1,1
"90719",45359500,1000,0.00264923,0,0,1,1,2
"90720",45360000,1000,0.00260467,0,0,1,1,2
"90721",45360500,1000,0.00251987,0,0,0,1,1
"90722",45361000,1000,0.00253321,0,0,0,0,0
"90723",45361500,1000,0.00261703,0,0,0,0,0
"90724",45362000,1000,0.00272167,0,0,1,0,1
"90725",45362500,1000,0.00272945,0,0,1,0,1
"90726",45363000,1000,0.00265807,0,0,0,0,0
"90727",45363500,1000,0.00271107,0,0,0,1,1
"90728",45364000,1000,0.00283671,0,0,1,2,3
"90729",45364500,1000,0.00286747,0,0,1,1,2
"90730",45365000,1000,0.00284571,0,0,0,2,2
"90731",45365500,1000,0.0026558,0,0,0,2,2
"90732",45366000,1000,0.00259093,0,0,0,0,0
"90733",45366500,1000,0.00280018,0,0,0,1,1
"90734",45367000,1000,0.00284609,0,0,0,3,3
"90735",45367500,1000,0.00282826,0,0,2,2,4
"90736",45368000,1000,0.00280452,0,0,2,2,4
"90737",45368500,1000,0.00266917,0,0,0,2,2
"90738",45369000,1000,0.00254136,0,0,0,0,0
"90739",45369500,1000,0.00247256,0,0,0,0,0
"90740",45370000,1000,0.00263553,0,0,1,1,2
"90741",45370500,1000,0.00277989,0,0,2,2,4
"90742",45371000,1000,0.00265789,0,0,1,2,3
"90743",45371500,1000,0.00240895,0,0,0,1,1
"90744",45372000,1000,0.00240716,0,0,0,1,1
"90745",45372500,1000,0.00277241,0,0,1,4,5
"90746",45373000,1000,0.0029296,0,0,1,4,5
"90747",45373500,1000,0.00275469,0,0,0,1,1
"90748",45374000,1000,0.00297751,0,1,0,2,3
"90749",45374500,1000,0.00293038,0,1,0,2,3
"90750",45375000,1000,0.0027118,0,0,0,0,0
"90751",45375500,1000,0.0028808,0,1,0,0,1
"90752",45376000,1000,0.00281599,0,1,0,0,1
"90753",45376500,1000,0.00258398,0,0,0,0,0
"90754",45377000,1000,0.00258965,0,0,0,0,0
"90755",45377500,1000,0.00284757,0,0,1,0,1
"90756",45378000,1000,0.00283299,0,0,1,0,1
"90757",45378500,1000,0.00275244,0,0,0,1,1
"90758",45379000,1000,0.0027482,0,0,0,1,1
"90759",45379500,1000,0.00278424,0,0,0,2,2
"90760",45380000,1000,0.00281686,0,0,1,2,3
"90761",45380500,1000,0.00276143,0,0,1,0,1
"90762",45381000,1000,0.00265971,0,0,0,2,2
"90763",45381500,1000,0.0026303,0,0,0,3,3
"90764",45382000,1000,0.00259772,0,0,0,1,1
"90765",45382500,1000,0.00257036,0,0,0,0,0
"90766",45383000,1000,0.00258262,0,0,0,0,0
"90767",45383500,1000,0.00273838,0,0,1,1,2
"90768",45384000,1000,0.00285023,0,0,1,2,3
"90769",45384500,1000,0.00268678,0,0,0,1,1
"90770",45385000,1000,0.00262927,0,0,0,0,0
"90771",45385500,1000,0.0026556,0,0,0,1,1
"90772",45386000,1000,0.00252786,0,0,0,1,1
"90773",45386500,1000,0.00270139,0,0,0,1,1
"90774",45387000,1000,0.00283288,0,0,0,1,1
"90775",45387500,1000,0.00281879,0,0,1,1,2
"90776",45388000,1000,0.00273323,0,0,1,1,2
"90777",45388500,1000,0.00260988,0,0,0,0,0
"90778",45389000,1000,0.00266339,0,0,0,0,0
"90779",45389500,1000,0.00269749,0,0,0,0,0
"90780",45390000,1000,0.00264888,0,0,0,0,0
"90781",45390500,1000,0.00256014,0,0,0,1,1
"90782",45391000,1000,0.00270089,0,1,0,1,2
"90783",45391500,1000,0.00275819,0,1,0,0,1
"90784",45392000,1000,0.00276473,0,0,0,1,1
"90785",45392500,1000,0.00275751,0,0,0,1,1
"90786",45393000,1000,0.00274682,0,0,0,0,0
"90787",45393500,1000,0.00280236,0,1,0,1,2
"90788",45394000,1000,0.00279431,0,1,0,1,2
"90789",45394500,1000,0.0030331,0,1,0,0,1
"90790",45395000,1000,0.0029384,0,1,0,0,1
"90791",45395500,1000,0.00259862,0,0,0,0,0
"90792",45396000,1000,0.00263021,0,0,0,1,1
"90793",45396500,1000,0.00275326,0,0,0,3,3
"90794",45397000,1000,0.00279903,0,0,0,2,2
"90795",45397500,1000,0.00284281,0,1,0,0,1
"90796",45398000,1000,0.00287729,0,1,0,1,2
"90797",45398500,1000,0.0028218,0,0,0,3,3
"90798",45399000,1000,0.00290715,0,0,1,3,4
"90799",45399500,1000,0.00273084,0,0,1,1,2
"90800",45400000,1000,0.00250884,0,0,0,0,0
"90801",45400500,1000,0.0026292,0,0,0,0,0
"90802",45401000,1000,0.00265744,0,0,0,0,0
"90803",45401500,1000,0.00281469,0,0,1,1,2
"90804",45402000,1000,0.00288347,0,0,1,1,2
"90805",45402500,1000,0.00292327,0,1,1,0,2
"90806",45403000,1000,0.00298195,0,1,1,0,2
"90807",45403500,1000,0.0027689,0,0,0,1,1
"90808",45404000,1000,0.00272035,0,0,0,1,1
"90809",45404500,1000,0.00274289,0,0,0,0,0
"90810",45405000,1000,0.00275013,0,0,0,1,1
"90811",45405500,1000,0.00268793,0,0,0,1,1
"90812",45406000,1000,0.00258307,0,0,0,0,0
"90813",45406500,1000,0.00262593,0,0,0,0,0
"90814",45407000,1000,0.00264094,0,0,0,1,1
"90815",45407500,1000,0.0025949,0,0,0,3,3
"90816",45408000,1000,0.0026697,0,0,0,2,2
"90817",45408500,1000,0.00264351,0,0,0,0,0
"90818",45409000,1000,0.00272398,0,0,0,0,0
"90819",45409500,1000,0.00283748,0,0,0,0,0
"90820",45410000,1000,0.00274632,0,0,0,0,0
"90821",45410500,1000,0.00274796,0,0,0,1,1
"90822",45411000,1000,0.00274743,0,0,0,1,1
"90823",45411500,1000,0.0027606,0,0,1,0,1
"90824",45412000,1000,0.0029525,0,1,1,0,2
"90825",45412500,1000,0.00288486,0,1,0,0,1
"90826",45413000,1000,0.00275292,0,0,0,1,1
"90827",45413500,1000,0.00295612,0,1,0,3,4
"90828",45414000,1000,0.00278456,0,1,0,2,3
"90829",45414500,1000,0.00275224,0,0,0,3,3
"90830",45415000,1000,0.00288494,0,0,0,4,4
"90831",45415500,1000,0.00276214,0,0,0,2,2
"90832",45416000,1000,0.00272138,0,0,0,3,3
"90833",45416500,1000,0.00270053,0,0,0,4,4
"90834",45417000,1000,0.00273051,0,0,1,2,3
"90835",45417500,1000,0.00280161,0,0,2,2,4
"90836",45418000,1000,0.00276228,0,0,1,3,4
"90837",45418500,1000,0.00262159,0,0,0,1,1
"90838",45419000,1000,0.00257656,0,0,0,0,0
"90839",45419500,1000,0.00244142,0,0,0,0,0
"90840",45420000,1000,0.00240477,0,0,0,0,0
"90841",45420500,1000,0.00256086,0,0,0,2,2
"90842",45421000,1000,0.00265308,0,0,0,3,3
"90843",45421500,1000,0.00272638,0,0,0,3,3
"90844",45422000,1000,0.00266372,0,0,0,2,2
"90845",45422500,1000,0.00268394,0,0,1,1,2
"90846",45423000,1000,0.00265499,0,0,1,1,2
"90847",45423500,1000,0.00249524,0,0,0,0,0
"90848",45424000,1000,0.0026965,0,0,1,0,1
"90849",45424500,1000,0.0028114,0,0,1,1,2
"90850",45425000,1000,0.0026189,0,0,0,1,1
"90851",45425500,1000,0.00260837,0,0,0,0,0
"90852",45426000,1000,0.00275491,0,0,0,0,0
"90853",45426500,1000,0.00275411,0,0,0,0,0
"90854",45427000,1000,0.00273833,0,0,0,0,0
"90855",45427500,1000,0.0026577,0,0,0,0,0
"90856",45428000,1000,0.00253677,0,0,0,0,0
"90857",45428500,1000,0.00261108,0,0,0,0,0
"90858",45429000,1000,0.00265797,0,0,0,0,0
"90859",45429500,1000,0.00255221,0,0,1,0,1
"90860",45430000,1000,0.00257183,0,0,2,0,2
"90861",45430500,1000,0.00262393,0,0,1,1,2
"90862",45431000,1000,0.00261749,0,0,0,1,1
"90863",45431500,1000,0.00253031,0,0,0,0,0
"90864",45432000,1000,0.00255068,0,0,1,0,1
"90865",45432500,1000,0.00252525,0,0,1,0,1
"90866",45433000,1000,0.00256226,0,0,0,0,0
"90867",45433500,1000,0.0027053,0,0,0,1,1
"90868",45434000,1000,0.0026269,0,0,0,1,1
"90869",45434500,1000,0.00269274,0,0,0,1,1
"90870",45435000,1000,0.0029055,0,0,0,2,2
"90871",45435500,1000,0.00281109,0,0,0,1,1
"90872",45436000,1000,0.00255165,0,0,0,0,0
"90873",45436500,1000,0.00264966,0,0,0,0,0
"90874",45437000,1000,0.00270713,0,0,0,0,0
"90875",45437500,1000,0.00268612,0,0,0,0,0
"90876",45438000,1000,0.00279717,0,0,1,1,2
"90877",45438500,1000,0.00282783,0,0,1,3,4
"90878",45439000,1000,0.00278834,0,0,0,2,2
"90879",45439500,1000,0.0027658,0,0,1,0,1
"90880",45440000,1000,0.00276291,0,0,2,0,2
"90881",45440500,1000,0.00269314,0,0,1,0,1
"90882",45441000,1000,0.00262363,0,0,0,0,0
"90883",45441500,1000,0.00263522,0,0,0,0,0
"90884",45442000,1000,0.00269984,0,0,0,0,0
"90885",45442500,1000,0.00271806,0,0,0,0,0
"90886",45443000,1000,0.00271534,0,0,0,1,1
"90887",45443500,1000,0.00271146,0,0,0,2,2
"90888",45444000,1000,0.00277522,0,0,1,1,2
"90889",45444500,1000,0.00276491,0,0,1,1,2
"90890",45445000,1000,0.00274518,0,0,0,2,2
"90891",45445500,1000,0.00283118,0,0,0,1,1
"90892",45446000,1000,0.00280519,0,0,0,0,0
"90893",45446500,1000,0.002674,0,0,0,0,0
"90894",45447000,1000,0.00273167,0,0,0,1,1
"90895",45447500,1000,0.00280757,0,0,0,1,1
"90896",45448000,1000,0.00260014,0,0,0,0,0
"90897",45448500,1000,0.00257521,0,0,0,1,1
"90898",45449000,1000,0.00257503,0,0,0,1,1
"90899",45449500,1000,0.00250839,0,0,0,0,0
"90900",45450000,1000,0.00261206,0,0,0,0,0
"90901",45450500,1000,0.00275772,0,0,0,1,1
"90902",45451000,1000,0.00277618,0,0,0,1,1
"90903",45451500,1000,0.00284147,0,1,0,1,2
"90904",45452000,1000,0.00289532,0,1,1,1,3
"90905",45452500,1000,0.00274639,0,0,1,0,1
"90906",45453000,1000,0.00266338,0,0,0,0,0
"90907",45453500,1000,0.00276276,0,0,0,0,0
"90908",45454000,1000,0.00280768,0,0,0,0,0
"90909",45454500,1000,0.00284304,0,0,0,3,3
"90910",45455000,1000,0.00282685,0,0,0,3,3
"90911",45455500,1000,0.00294179,0,1,0,0,1
"90912",45456000,1000,0.00287157,0,1,0,0,1
"90913",45456500,1000,0.00280314,0,1,0,1,2
"90914",45457000,1000,0.0028729,0,1,0,1,2
"90915",45457500,1000,0.00260534,0,0,0,0,0
"90916",45458000,1000,0.00252145,0,0,0,0,0
"90917",45458500,1000,0.00261156,0,0,0,2,2
"90918",45459000,1000,0.00258798,0,0,0,2,2
"90919",45459500,1000,0.00274758,0,0,2,0,2
"90920",45460000,1000,0.00299099,0,0,2,2,4
"90921",45460500,1000,0.00289583,0,0,1,3,4
"90922",45461000,1000,0.00282943,0,0,2,2,4
"90923",45461500,1000,0.00277265,0,0,1,1,2
"90924",45462000,1000,0.00289312,0,1,0,0,1
"90925",45462500,1000,0.00284109,0,1,0,0,1
"90926",45463000,1000,0.00266245,0,0,0,0,0
"90927",45463500,1000,0.00275615,0,0,0,0,0
"90928",45464000,1000,0.00271471,0,0,0,0,0
"90929",45464500,1000,0.0026762,0,0,0,0,0
"90930",45465000,1000,0.00270716,0,0,0,1,1
"90931",45465500,1000,0.0026128,0,0,0,1,1
"90932",45466000,1000,0.00256118,0,0,0,0,0
"90933",45466500,1000,0.00259232,0,0,0,0,0
"90934",45467000,1000,0.00262365,0,0,0,1,1
"90935",45467500,1000,0.00275973,0,0,0,1,1
"90936",45468000,1000,0.0027837,0,0,0,0,0
"90937",45468500,1000,0.00281528,0,0,0,2,2
"90938",45469000,1000,0.00292583,0,0,1,3,4
"90939",45469500,1000,0.00292148,0,0,1,2,3
"90940",45470000,1000,0.00276072,0,0,0,1,1
"90941",45470500,1000,0.00269482,0,0,1,1,2
"90942",45471000,1000,0.00259748,0,0,1,1,2
"90943",45471500,1000,0.00252171,0,0,0,0,0
"90944",45472000,1000,0.00265475,0,0,0,1,1
"90945",45472500,1000,0.00279191,0,0,0,4,4
"90946",45473000,1000,0.00276804,0,0,0,4,4
"90947",45473500,1000,0.00254324,0,0,0,1,1
"90948",45474000,1000,0.00257284,0,0,0,2,2
"90949",45474500,1000,0.00270541,0,0,0,2,2
"90950",45475000,1000,0.00285461,0,0,0,0,0
"90951",45475500,1000,0.00295823,0,0,0,0,0
"90952",45476000,1000,0.00283371,0,1,0,0,1
"90953",45476500,1000,0.00277753,0,1,0,0,1
"90954",45477000,1000,0.00280625,0,0,0,2,2
"90955",45477500,1000,0.00281441,0,0,0,2,2
"90956",45478000,1000,0.00289186,0,1,0,0,1
"90957",45478500,1000,0.00295971,0,2,0,0,2
"90958",45479000,1000,0.00288383,0,1,1,0,2
"90959",45479500,1000,0.00269583,0,0,1,0,1
"90960",45480000,1000,0.0027013,0,0,1,2,3
"90961",45480500,1000,0.00267371,0,0,1,2,3
"90962",45481000,1000,0.00248684,0,0,0,0,0
"90963",45481500,1000,0.00260776,0,0,0,1,1
"90964",45482000,1000,0.00267817,0,0,0,1,1
"90965",45482500,1000,0.00267456,0,1,0,0,1
"90966",45483000,1000,0.0027992,0,1,0,1,2
"90967",45483500,1000,0.00276187,0,0,0,2,2
"90968",45484000,1000,0.00271743,0,0,0,2,2
"90969",45484500,1000,0.00267237,0,0,0,2,2
"90970",45485000,1000,0.00272987,0,0,0,2,2
"90971",45485500,1000,0.00289089,0,0,1,3,4
"90972",45486000,1000,0.00281695,0,0,2,4,6
"90973",45486500,1000,0.00272412,0,0,1,3,4
"90974",45487000,1000,0.00271425,0,0,0,1,1
"90975",45487500,1000,0.00278699,0,0,0,0,0
"90976",45488000,1000,0.00274179,0,0,0,0,0
"90977",45488500,1000,0.00261446,0,0,0,0,0
"90978",45489000,1000,0.00266516,0,0,0,0,0
"90979",45489500,1000,0.00273004,0,0,0,0,0
"90980",45490000,1000,0.00265827,0,0,0,0,0
"90981",45490500,1000,0.00243511,0,0,0,0,0
"90982",45491000,1000,0.00250041,0,0,0,1,1
"90983",45491500,1000,0.0027765,0,0,1,3,4
"90984",45492000,1000,0.00277049,0,0,1,3,4
"90985",45492500,1000,0.00272096,0,0,0,1,1
"90986",45493000,1000,0.00277637,0,0,1,1,2
"90987",45493500,1000,0.00256285,0,0,1,1,2
"90988",45494000,1000,0.0024073,0,0,0,0,0
"90989",45494500,1000,0.00256429,0,0,1,0,1
"90990",45495000,1000,0.0026281,0,0,1,0,1
"90991",45495500,1000,0.00266481,0,0,0,1,1
"90992",45496000,1000,0.00270438,0,0,0,1,1
"90993",45496500,1000,0.00270778,0,0,0,0,0
"90994",45497000,1000,0.00271868,0,0,0,1,1
"90995",45497500,1000,0.00265277,0,0,0,1,1
"90996",45498000,1000,0.00255896,0,0,0,0,0
"90997",45498500,1000,0.00273466,0,0,1,0,1
"90998",45499000,1000,0.0028282,0,0,2,1,3
"90999",45499500,1000,0.00265958,0,0,1,1,2
"91000",45500000,1000,0.00258911,0,0,0,0,0
"91001",45500500,1000,0.00270594,0,0,0,2,2
"91002",45501000,1000,0.00267105,0,0,0,2,2
"91003",45501500,1000,0.00262604,0,0,0,0,0
"91004",45502000,1000,0.00277166,0,0,0,2,2
"91005",45502500,1000,0.00280693,0,0,1,3,4
"91006",45503000,1000,0.00284627,0,0,1,1,2
"91007",45503500,1000,0.00265228,0,0,0,0,0
"91008",45504000,1000,0.00263479,0,0,0,2,2
"91009",45504500,1000,0.00281542,0,0,0,2,2
"91010",45505000,1000,0.00271749,0,0,0,0,0
"91011",45505500,1000,0.00254599,0,0,0,0,0
"91012",45506000,1000,0.00267373,0,0,0,1,1
"91013",45506500,1000,0.00285126,0,0,0,3,3
"91014",45507000,1000,0.00273964,0,0,0,2,2
"91015",45507500,1000,0.00262422,0,0,0,0,0
"91016",45508000,1000,0.0026031,0,0,0,0,0
"91017",45508500,1000,0.00266758,0,0,0,0,0
"91018",45509000,1000,0.00270835,0,0,0,0,0
"91019",45509500,1000,0.00260039,0,0,0,0,0
"91020",45510000,1000,0.00256993,0,0,0,1,1
"91021",45510500,1000,0.00265679,0,0,0,2,2
"91022",45511000,1000,0.00267332,0,0,0,1,1
"91023",45511500,1000,0.00256979,0,0,0,0,0
"91024",45512000,1000,0.00253968,0,0,0,0,0
"91025",45512500,1000,0.00266782,0,0,0,0,0
"91026",45513000,1000,0.00266117,0,0,0,1,1
"91027",45513500,1000,0.00264922,0,0,0,2,2
"91028",45514000,1000,0.00278903,0,0,1,1,2
"91029",45514500,1000,0.00289142,0,0,2,1,3
"91030",45515000,1000,0.00275274,0,0,1,1,2
"91031",45515500,1000,0.00265805,0,0,0,0,0
"91032",45516000,1000,0.00264667,0,0,0,0,0
"91033",45516500,1000,0.0026466,0,0,0,0,0
"91034",45517000,1000,0.00265915,0,0,0,1,1
"91035",45517500,1000,0.00265588,0,0,0,2,2
"91036",45518000,1000,0.00279413,0,0,1,1,2
"91037",45518500,1000,0.00286806,0,0,2,1,3
"91038",45519000,1000,0.00274657,0,0,1,1,2
"91039",45519500,1000,0.00266444,0,0,0,0,0
"91040",45520000,1000,0.00268168,0,0,0,1,1
"91041",45520500,1000,0.00267269,0,0,0,1,1
"91042",45521000,1000,0.00261863,0,0,0,1,1
"91043",45521500,1000,0.0025487,0,0,0,2,2
"91044",45522000,1000,0.00251975,0,0,0,2,2
"91045",45522500,1000,0.00255519,0,0,0,1,1
"91046",45523000,1000,0.0026389,0,0,0,1,1
"91047",45523500,1000,0.00268532,0,0,0,2,2
"91048",45524000,1000,0.0026736,0,0,1,1,2
"91049",45524500,1000,0.0027009,0,0,1,1,2
"91050",45525000,1000,0.002601,0,0,0,1,1
"91051",45525500,1000,0.00248197,0,0,0,1,1
"91052",45526000,1000,0.00261139,0,0,0,2,2
"91053",45526500,1000,0.00287694,0,0,1,3,4
"91054",45527000,1000,0.00279376,0,0,1,2,3
"91055",45527500,1000,0.00258014,0,0,0,0,0
"91056",45528000,1000,0.00261276,0,0,0,1,1
"91057",45528500,1000,0.00264859,0,0,0,1,1
"91058",45529000,1000,0.0026929,0,0,0,0,0
"91059",45529500,1000,0.00276069,0,0,1,0,1
"91060",45530000,1000,0.00284796,0,0,1,3,4
"91061",45530500,1000,0.00263269,0,0,0,3,3
"91062",45531000,1000,0.00245201,0,0,0,0,0
"91063",45531500,1000,0.00257149,0,0,0,0,0
"91064",45532000,1000,0.0025822,0,0,0,0,0
"91065",45532500,1000,0.00263564,0,0,0,2,2
"91066",45533000,1000,0.00273266,0,0,0,2,2
"91067",45533500,1000,0.00270008,0,0,0,0,0
"91068",45534000,1000,0.00267582,0,0,0,1,1
"91069",45534500,1000,0.00270862,0,0,0,1,1
"91070",45535000,1000,0.00262832,0,0,0,0,0
"91071",45535500,1000,0.00256493,0,0,0,0,0
"91072",45536000,1000,0.00251321,0,0,0,0,0
"91073",45536500,1000,0.00241267,0,0,0,0,0
"91074",45537000,1000,0.0025706,0,0,0,0,0
"91075",45537500,1000,0.00279882,0,0,0,2,2
"91076",45538000,1000,0.00284316,0,0,1,3,4
"91077",45538500,1000,0.00303537,0,0,3,5,8
"91078",45539000,1000,0.00289058,0,0,2,4,6
"91079",45539500,1000,0.00249594,0,0,0,0,0
"91080",45540000,1000,0.00266387,0,1,0,0,1
"91081",45540500,1000,0.00268423,0,1,0,0,1
"91082",45541000,1000,0.00250809,0,0,0,0,0
"91083",45541500,1000,0.00254119,0,0,0,0,0
"91084",45542000,1000,0.00253969,0,0,1,0,1
"91085",45542500,1000,0.00254588,0,0,1,0,1
"91086",45543000,1000,0.00262396,0,0,0,1,1
"91087",45543500,1000,0.00261865,0,0,0,1,1
"91088",45544000,1000,0.00259614,0,0,0,2,2
"91089",45544500,1000,0.00253662,0,0,0,2,2
"91090",45545000,1000,0.00249585,0,0,0,1,1
"91091",45545500,1000,0.00249974,0,0,0,1,1
"91092",45546000,1000,0.00247311,0,0,0,0,0
"91093",45546500,1000,0.00260771,0,0,0,2,2
"91094",45547000,1000,0.00266654,0,0,0,3,3
"91095",45547500,1000,0.00282262,0,0,0,2,2
"91096",45548000,1000,0.00309713,0,0,0,3,3
"91097",45548500,1000,0.00316182,0,0,1,3,4
"91098",45549000,1000,0.00320048,0,0,2,2,4
"91099",45549500,1000,0.00305117,0,0,1,1,2
"91100",45550000,1000,0.00273796,0,0,0,0,0
"91101",45550500,1000,0.0026541,0,0,0,1,1
"91102",45551000,1000,0.00276932,0,0,1,1,2
"91103",45551500,1000,0.00263799,0,0,1,0,1
"91104",45552000,1000,0.00253891,0,0,0,1,1
"91105",45552500,1000,0.00252939,0,0,0,1,1
"91106",45553000,1000,0.00261842,0,0,0,2,2
"91107",45553500,1000,0.00281219,0,0,0,3,3
"91108",45554000,1000,0.00271376,0,0,0,2,2
"91109",45554500,1000,0.00264742,0,0,0,1,1
"91110",45555000,1000,0.0026387,0,0,1,0,1
"91111",45555500,1000,0.00254611,0,0,1,0,1
"91112",45556000,1000,0.00256172,0,0,0,0,0
"91113",45556500,1000,0.00268578,0,0,0,2,2
"91114",45557000,1000,0.00277677,0,0,0,4,4
"91115",45557500,1000,0.00279907,0,0,1,3,4
"91116",45558000,1000,0.00264097,0,0,1,1,2
"91117",45558500,1000,0.00259595,0,0,0,1,1
"91118",45559000,1000,0.00279763,0,1,0,1,2
"91119",45559500,1000,0.00274028,0,1,0,1,2
"91120",45560000,1000,0.00274533,0,0,1,2,3
"91121",45560500,1000,0.00277844,0,0,1,1,2
"91122",45561000,1000,0.00264312,0,0,0,0,0
"91123",45561500,1000,0.00280012,0,0,1,2,3
"91124",45562000,1000,0.0027907,0,0,1,3,4
"91125",45562500,1000,0.00260225,0,0,0,1,1
"91126",45563000,1000,0.00255178,0,0,0,1,1
"91127",45563500,1000,0.00261829,0,0,1,1,2
"91128",45564000,1000,0.00260182,0,0,1,0,1
"91129",45564500,1000,0.00261285,0,0,0,1,1
"91130",45565000,1000,0.00261012,0,0,0,1,1
"91131",45565500,1000,0.00241658,0,0,0,0,0
"91132",45566000,1000,0.00244266,0,0,0,0,0
"91133",45566500,1000,0.00269848,0,0,1,1,2
"91134",45567000,1000,0.00277861,0,0,2,3,5
"91135",45567500,1000,0.00265358,0,0,1,2,3
"91136",45568000,1000,0.00254442,0,0,0,0,0
"91137",45568500,1000,0.00262651,0,0,1,1,2
"91138",45569000,1000,0.0027073,0,0,1,3,4
"91139",45569500,1000,0.00253902,0,0,0,2,2
"91140",45570000,1000,0.00264341,0,1,0,0,1
"91141",45570500,1000,0.00276844,0,1,0,2,3
"91142",45571000,1000,0.00255928,0,0,0,2,2
"91143",45571500,1000,0.00249234,0,0,0,1,1
"91144",45572000,1000,0.00248913,0,0,0,1,1
"91145",45572500,1000,0.00257007,0,0,0,0,0
"91146",45573000,1000,0.00274637,0,0,0,2,2
"91147",45573500,1000,0.00274803,0,0,0,3,3
"91148",45574000,1000,0.00267163,0,0,0,1,1
"91149",45574500,1000,0.0026508,0,0,0,0,0
"91150",45575000,1000,0.00272851,0,0,0,0,0
"91151",45575500,1000,0.00263895,0,0,0,0,0
"91152",45576000,1000,0.00254844,0,0,0,0,0
"91153",45576500,1000,0.00266789,0,0,1,0,1
"91154",45577000,1000,0.002775,0,0,1,1,2
"91155",45577500,1000,0.00281983,0,1,0,1,2
"91156",45578000,1000,0.00256433,0,1,0,0,1
"91157",45578500,1000,0.002583,0,0,0,2,2
"91158",45579000,1000,0.00284955,0,0,0,4,4
"91159",45579500,1000,0.00283364,0,0,0,2,2
"91160",45580000,1000,0.00268302,0,0,0,0,0
"91161",45580500,1000,0.00244536,0,0,0,1,1
"91162",45581000,1000,0.00251146,0,0,0,2,2
"91163",45581500,1000,0.00273548,0,0,0,1,1
"91164",45582000,1000,0.00268695,0,0,0,0,0
"91165",45582500,1000,0.00268276,0,0,1,1,2
"91166",45583000,1000,0.0025872,0,0,1,1,2
"91167",45583500,1000,0.0025351,0,0,0,0,0
"91168",45584000,1000,0.00258708,0,0,0,0,0
"91169",45584500,1000,0.00250143,0,0,0,0,0
"91170",45585000,1000,0.00241191,0,0,0,0,0
"91171",45585500,1000,0.00241501,0,0,0,0,0
"91172",45586000,1000,0.00276132,0,1,0,1,2
"91173",45586500,1000,0.0028993,0,1,0,1,2
"91174",45587000,1000,0.00263758,0,0,0,0,0
"91175",45587500,1000,0.00261197,0,0,1,1,2
"91176",45588000,1000,0.00289332,0,0,2,2,4
"91177",45588500,1000,0.0027713,0,0,1,2,3
"91178",45589000,1000,0.00261668,0,0,0,3,3
"91179",45589500,1000,0.00264318,0,0,0,2,2
"91180",45590000,1000,0.00263391,0,0,0,1,1
"91181",45590500,1000,0.00279937,0,0,1,2,3
"91182",45591000,1000,0.00280088,0,0,1,3,4
"91183",45591500,1000,0.00262461,0,0,0,2,2
"91184",45592000,1000,0.00265276,0,0,0,0,0
"91185",45592500,1000,0.00267874,0,0,0,1,1
"91186",45593000,1000,0.00260678,0,0,0,1,1
"91187",45593500,1000,0.00257175,0,0,0,0,0
"91188",45594000,1000,0.00253462,0,0,0,0,0
"91189",45594500,1000,0.00269439,0,0,0,1,1
"91190",45595000,1000,0.00288602,0,0,0,2,2
"91191",45595500,1000,0.00285776,0,0,0,3,3
"91192",45596000,1000,0.00275189,0,0,0,2,2
"91193",45596500,1000,0.0026868,0,0,0,0,0
"91194",45597000,1000,0.00276728,0,0,1,0,1
"91195",45597500,1000,0.00267507,0,0,1,0,1
"91196",45598000,1000,0.00248776,0,0,0,0,0
"91197",45598500,1000,0.00260078,0,0,0,0,0
"91198",45599000,1000,0.00265931,0,0,0,1,1
"91199",45599500,1000,0.00246823,0,0,0,1,1
"91200",45600000,1000,0.00241584,0,0,0,0,0
"91201",45600500,1000,0.00264724,0,0,0,0,0
"91202",45601000,1000,0.00280829,0,0,0,1,1
"91203",45601500,1000,0.00287268,0,0,0,1,1
"91204",45602000,1000,0.00267747,0,0,0,0,0
"91205",45602500,1000,0.00242371,0,0,0,0,0
"91206",45603000,1000,0.00257657,0,0,0,2,2
"91207",45603500,1000,0.00272404,0,0,0,4,4
"91208",45604000,1000,0.00272317,0,0,0,4,4
"91209",45604500,1000,0.00263559,0,0,0,2,2
"91210",45605000,1000,0.00264069,0,0,0,2,2
"91211",45605500,1000,0.00281657,0,0,0,5,5
"91212",45606000,1000,0.00277459,0,0,0,4,4
"91213",45606500,1000,0.00274958,0,0,0,2,2
"91214",45607000,1000,0.00286065,0,0,0,5,5
"91215",45607500,1000,0.00282839,0,0,1,4,5
"91216",45608000,1000,0.002687,0,0,2,1,3
"91217",45608500,1000,0.00259055,0,0,1,1,2
"91218",45609000,1000,0.00256438,0,0,0,0,0
"91219",45609500,1000,0.00256192,0,0,0,0,0
"91220",45610000,1000,0.00267005,0,0,1,0,1
"91221",45610500,1000,0.00271708,0,0,1,0,1
"91222",45611000,1000,0.00278338,0,1,0,1,2
"91223",45611500,1000,0.00279775,0,1,0,2,3
"91224",45612000,1000,0.00266266,0,0,0,2,2
"91225",45612500,1000,0.00262951,0,0,0,1,1
"91226",45613000,1000,0.00274581,0,0,0,1,1
"91227",45613500,1000,0.00276352,0,0,0,1,1
"91228",45614000,1000,0.00282109,0,0,1,1,2
"91229",45614500,1000,0.00285032,0,0,2,1,3
"91230",45615000,1000,0.00269586,0,0,1,0,1
"91231",45615500,1000,0.00262136,0,0,0,0,0
"91232",45616000,1000,0.00260427,0,0,0,1,1
"91233",45616500,1000,0.0026819,0,0,0,2,2
"91234",45617000,1000,0.0027118,0,0,0,2,2
"91235",45617500,1000,0.00275902,0,0,0,2,2
"91236",45618000,1000,0.0027209,0,0,0,3,3
"91237",45618500,1000,0.00261363,0,0,0,4,4
"91238",45619000,1000,0.00270881,0,0,1,3,4
"91239",45619500,1000,0.00264172,0,0,1,1,2
"91240",45620000,1000,0.00264269,0,0,0,1,1
"91241",45620500,1000,0.00254652,0,0,0,1,1
"91242",45621000,1000,0.00263518,0,1,0,0,1
"91243",45621500,1000,0.00269661,0,1,0,0,1
"91244",45622000,1000,0.00241755,0,0,0,0,0
"91245",45622500,1000,0.00253582,0,0,0,0,0
"91246",45623000,1000,0.00274503,0,0,0,1,1
"91247",45623500,1000,0.00260151,0,0,0,1,1
"91248",45624000,1000,0.00243494,0,0,0,0,0
"91249",45624500,1000,0.00266179,0,0,0,2,2
"91250",45625000,1000,0.00269701,0,0,0,2,2
"91251",45625500,1000,0.00263602,0,0,0,1,1
"91252",45626000,1000,0.00270952,0,0,0,2,2
"91253",45626500,1000,0.00272191,0,0,0,1,1
"91254",45627000,1000,0.00290364,0,0,1,3,4
"91255",45627500,1000,0.00301862,0,0,2,4,6
"91256",45628000,1000,0.00291153,0,0,1,1,2
"91257",45628500,1000,0.00281979,0,0,0,2,2
"91258",45629000,1000,0.00261858,0,0,0,2,2
"91259",45629500,1000,0.00258994,0,0,0,0,0
"91260",45630000,1000,0.00266947,0,0,0,1,1
"91261",45630500,1000,0.00279347,0,0,1,1,2
"91262",45631000,1000,0.00276666,0,0,1,0,1
"91263",45631500,1000,0.00264626,0,0,1,0,1
"91264",45632000,1000,0.00271069,0,0,1,0,1
"91265",45632500,1000,0.00280412,0,0,1,1,2
"91266",45633000,1000,0.00297488,0,1,1,1,3
"91267",45633500,1000,0.00288813,0,1,0,2,3
"91268",45634000,1000,0.00271954,0,0,0,2,2
"91269",45634500,1000,0.00270153,0,0,0,2,2
"91270",45635000,1000,0.0026241,0,0,0,2,2
"91271",45635500,1000,0.00268419,0,0,0,1,1
"91272",45636000,1000,0.00274337,0,0,0,2,2
"91273",45636500,1000,0.00265634,0,0,0,1,1
"91274",45637000,1000,0.00262054,0,0,0,1,1
"91275",45637500,1000,0.00265981,0,0,0,1,1
"91276",45638000,1000,0.00275902,0,0,0,1,1
"91277",45638500,1000,0.00260546,0,0,0,1,1
"91278",45639000,1000,0.0026168,0,0,0,2,2
"91279",45639500,1000,0.00276191,0,0,0,2,2
"91280",45640000,1000,0.00280749,0,0,0,2,2
"91281",45640500,1000,0.00295305,0,0,1,3,4
"91282",45641000,1000,0.00283754,0,0,1,2,3
"91283",45641500,1000,0.00261469,0,0,0,1,1
"91284",45642000,1000,0.00265405,0,0,0,0,0
"91285",45642500,1000,0.00276998,0,0,0,1,1
"91286",45643000,1000,0.00276324,0,0,0,2,2
"91287",45643500,1000,0.00294769,0,1,1,2,4
"91288",45644000,1000,0.00292421,0,1,1,3,5
"91289",45644500,1000,0.00272962,0,0,1,3,4
"91290",45645000,1000,0.00261621,0,0,1,1,2
"91291",45645500,1000,0.00257124,0,0,0,0,0
"91292",45646000,1000,0.00264745,0,0,0,1,1
"91293",45646500,1000,0.00261919,0,0,0,1,1
"91294",45647000,1000,0.00268086,0,0,0,1,1
"91295",45647500,1000,0.00265532,0,0,0,1,1
"91296",45648000,1000,0.00257391,0,0,0,0,0
"91297",45648500,1000,0.0027021,0,0,0,0,0
"91298",45649000,1000,0.00265969,0,0,0,0,0
"91299",45649500,1000,0.00267667,0,0,0,1,1
"91300",45650000,1000,0.00274682,0,0,0,2,2
"91301",45650500,1000,0.00268028,0,0,0,1,1
"91302",45651000,1000,0.00270533,0,0,0,0,0
"91303",45651500,1000,0.00265442,0,0,0,0,0
"91304",45652000,1000,0.00259434,0,0,0,0,0
"91305",45652500,1000,0.00294689,0,1,1,1,3
"91306",45653000,1000,0.00302109,0,1,2,2,5
"91307",45653500,1000,0.00265359,0,0,1,1,2
"91308",45654000,1000,0.00266264,0,0,0,0,0
"91309",45654500,1000,0.00288866,0,0,0,2,2
"91310",45655000,1000,0.00279436,0,0,0,2,2
"91311",45655500,1000,0.0025476,0,0,0,0,0
"91312",45656000,1000,0.00259101,0,0,0,0,0
"91313",45656500,1000,0.00266636,0,0,0,1,1
"91314",45657000,1000,0.00268141,0,0,0,2,2
"91315",45657500,1000,0.00278125,0,0,1,1,2
"91316",45658000,1000,0.00273476,0,0,1,0,1
"91317",45658500,1000,0.0025571,0,0,0,0,0
"91318",45659000,1000,0.00256481,0,0,0,2,2
"91319",45659500,1000,0.00270665,0,0,0,2,2
"91320",45660000,1000,0.00284132,0,0,0,0,0
"91321",45660500,1000,0.00273213,0,0,0,0,0
"91322",45661000,1000,0.00262407,0,0,0,1,1
"91323",45661500,1000,0.00279299,0,0,0,2,2
"91324",45662000,1000,0.00286076,0,0,0,3,3
"91325",45662500,1000,0.00276788,0,0,0,2,2
"91326",45663000,1000,0.00256741,0,0,0,0,0
"91327",45663500,1000,0.00254781,0,0,0,1,1
"91328",45664000,1000,0.00261415,0,0,0,1,1
"91329",45664500,1000,0.00253089,0,0,0,0,0
"91330",45665000,1000,0.00261767,0,0,0,0,0
"91331",45665500,1000,0.00274908,0,0,0,1,1
"91332",45666000,1000,0.00280917,0,0,0,1,1
"91333",45666500,1000,0.00278211,0,0,0,0,0
"91334",45667000,1000,0.0027599,0,0,0,1,1
"91335",45667500,1000,0.00283427,0,0,0,2,2
"91336",45668000,1000,0.00281481,0,0,0,2,2
"91337",45668500,1000,0.00294346,0,0,1,3,4
"91338",45669000,1000,0.0028609,0,0,1,2,3
"91339",45669500,1000,0.00278391,0,0,0,1,1
"91340",45670000,1000,0.00275969,0,0,0,1,1
"91341",45670500,1000,0.00257036,0,0,0,0,0
"91342",45671000,1000,0.00272712,0,0,1,1,2
"91343",45671500,1000,0.00282717,0,0,1,2,3
"91344",45672000,1000,0.00270072,0,0,0,1,1
"91345",45672500,1000,0.00281135,0,0,0,1,1
"91346",45673000,1000,0.00276444,0,0,0,1,1
"91347",45673500,1000,0.0025812,0,0,0,0,0
"91348",45674000,1000,0.00260591,0,0,0,0,0
"91349",45674500,1000,0.00277051,0,0,1,1,2
"91350",45675000,1000,0.00288206,0,0,1,2,3
"91351",45675500,1000,0.002679,0,0,0,1,1
"91352",45676000,1000,0.00259943,0,0,0,0,0
"91353",45676500,1000,0.00261349,0,0,0,1,1
"91354",45677000,1000,0.00258639,0,0,0,1,1
"91355",45677500,1000,0.00263529,0,0,0,0,0
"91356",45678000,1000,0.00260746,0,0,0,0,0
"91357",45678500,1000,0.00263019,0,0,0,1,1
"91358",45679000,1000,0.00272947,0,0,1,1,2
"91359",45679500,1000,0.00263601,0,0,1,0,1
"91360",45680000,1000,0.00274225,0,0,0,0,0
"91361",45680500,1000,0.00289219,0,0,0,3,3
"91362",45681000,1000,0.00276215,0,0,0,4,4
"91363",45681500,1000,0.00264745,0,0,0,1,1
"91364",45682000,1000,0.00264511,0,0,0,0,0
"91365",45682500,1000,0.00281765,0,0,1,1,2
"91366",45683000,1000,0.00278621,0,0,2,1,3
"91367",45683500,1000,0.00263188,0,0,1,1,2
"91368",45684000,1000,0.0026113,0,0,0,1,1
"91369",45684500,1000,0.00256835,0,0,0,0,0
"91370",45685000,1000,0.00263469,0,0,0,0,0
"91371",45685500,1000,0.00273838,0,0,0,1,1
"91372",45686000,1000,0.00272778,0,0,0,1,1
"91373",45686500,1000,0.00270526,0,0,0,2,2
"91374",45687000,1000,0.00264087,0,0,0,2,2
"91375",45687500,1000,0.00256739,0,0,0,0,0
"91376",45688000,1000,0.00265078,0,0,0,0,0
"91377",45688500,1000,0.00271071,0,0,0,0,0
"91378",45689000,1000,0.00273215,0,0,0,0,0
"91379",45689500,1000,0.00278232,0,1,0,0,1
"91380",45690000,1000,0.0026671,0,1,0,0,1
"91381",45690500,1000,0.0025454,0,0,0,0,0
"91382",45691000,1000,0.00257783,0,0,0,0,0
"91383",45691500,1000,0.00262463,0,0,0,0,0
"91384",45692000,1000,0.00257859,0,0,0,0,0
"91385",45692500,1000,0.00254264,0,0,0,0,0
"91386",45693000,1000,0.00265363,0,0,0,1,1
"91387",45693500,1000,0.00256896,0,0,0,1,1
"91388",45694000,1000,0.00242435,0,0,0,1,1
"91389",45694500,1000,0.00258817,0,0,0,2,2
"91390",45695000,1000,0.00266556,0,0,0,1,1
"91391",45695500,1000,0.00269974,0,0,0,1,1
"91392",45696000,1000,0.00278347,0,0,0,1,1
"91393",45696500,1000,0.00261879,0,0,0,0,0
"91394",45697000,1000,0.00264261,0,0,1,0,1
"91395",45697500,1000,0.00283833,0,0,1,0,1
"91396",45698000,1000,0.0029056,0,0,1,0,1
"91397",45698500,1000,0.00279865,0,0,1,0,1
"91398",45699000,1000,0.00267371,0,0,0,2,2
"91399",45699500,1000,0.00264004,0,0,0,2,2
"91400",45700000,1000,0.00265551,0,0,0,0,0
"91401",45700500,1000,0.00269163,0,0,0,0,0
"91402",45701000,1000,0.00260895,0,0,0,0,0
"91403",45701500,1000,0.00262189,0,0,0,0,0
"91404",45702000,1000,0.00264518,0,0,0,1,1
"91405",45702500,1000,0.00283304,0,0,1,1,2
"91406",45703000,1000,0.00286523,0,0,1,0,1
"91407",45703500,1000,0.00271328,0,0,0,1,1
"91408",45704000,1000,0.00279988,0,0,0,2,2
"91409",45704500,1000,0.00268845,0,0,0,1,1
"91410",45705000,1000,0.00264256,0,0,0,1,1
"91411",45705500,1000,0.00271648,0,0,0,1,1
"91412",45706000,1000,0.00261403,0,0,0,0,0
"91413",45706500,1000,0.002573,0,0,0,0,0
"91414",45707000,1000,0.0026174,0,0,0,0,0
"91415",45707500,1000,0.00259597,0,0,0,0,0
"91416",45708000,1000,0.00270031,0,0,0,1,1
"91417",45708500,1000,0.00276622,0,0,0,1,1
"91418",45709000,1000,0.00268922,0,0,1,0,1
"91419",45709500,1000,0.00267054,0,0,1,0,1
"91420",45710000,1000,0.00268455,0,0,0,1,1
"91421",45710500,1000,0.00255745,0,0,0,1,1
"91422",45711000,1000,0.00259705,0,0,0,0,0
"91423",45711500,1000,0.00272539,0,0,0,0,0
"91424",45712000,1000,0.00278647,0,0,1,1,2
"91425",45712500,1000,0.00295983,0,1,1,2,4
"91426",45713000,1000,0.00288314,0,1,0,2,3
"91427",45713500,1000,0.00262473,0,0,0,2,2
"91428",45714000,1000,0.0025421,0,0,0,1,1
"91429",45714500,1000,0.00260241,0,0,0,0,0
"91430",45715000,1000,0.00262185,0,0,0,0,0
"91431",45715500,1000,0.00280479,0,1,0,0,1
"91432",45716000,1000,0.00281181,0,1,0,0,1
"91433",45716500,1000,0.00271853,0,0,1,1,2
"91434",45717000,1000,0.0026729,0,0,1,1,2
"91435",45717500,1000,0.00249295,0,0,0,1,1
"91436",45718000,1000,0.00266085,0,0,0,1,1
"91437",45718500,1000,0.00265015,0,0,0,1,1
"91438",45719000,1000,0.00252345,0,0,0,3,3
"91439",45719500,1000,0.00265617,0,0,0,2,2
"91440",45720000,1000,0.00275958,0,0,0,1,1
"91441",45720500,1000,0.00277052,0,0,0,2,2
"91442",45721000,1000,0.00266512,0,0,0,1,1
"91443",45721500,1000,0.0027813,0,0,1,1,2
"91444",45722000,1000,0.00288646,0,0,1,1,2
"91445",45722500,1000,0.00283633,0,0,0,1,1
"91446",45723000,1000,0.00277331,0,0,0,1,1
"91447",45723500,1000,0.00267336,0,0,0,0,0
"91448",45724000,1000,0.00258564,0,0,0,0,0
"91449",45724500,1000,0.00267251,0,0,0,3,3
"91450",45725000,1000,0.00268179,0,0,0,3,3
"91451",45725500,1000,0.00270266,0,0,0,1,1
"91452",45726000,1000,0.00273591,0,0,0,1,1
"91453",45726500,1000,0.00269059,0,0,0,0,0
"91454",45727000,1000,0.00278177,0,0,0,0,0
"91455",45727500,1000,0.0028437,0,0,0,1,1
"91456",45728000,1000,0.0027418,0,0,0,2,2
"91457",45728500,1000,0.0026516,0,0,0,1,1
"91458",45729000,1000,0.00282316,0,0,0,1,1
"91459",45729500,1000,0.00282116,0,0,0,1,1
"91460",45730000,1000,0.00261258,0,0,0,0,0
"91461",45730500,1000,0.0025725,0,0,0,0,0
"91462",45731000,1000,0.00267569,0,0,0,0,0
"91463",45731500,1000,0.0026339,0,0,0,1,1
"91464",45732000,1000,0.00273893,0,0,1,1,2
"91465",45732500,1000,0.00277077,0,0,1,0,1
"91466",45733000,1000,0.00272314,0,0,0,0,0
"91467",45733500,1000,0.00272305,0,0,1,0,1
"91468",45734000,1000,0.00261726,0,0,1,0,1
"91469",45734500,1000,0.00259442,0,0,0,0,0
"91470",45735000,1000,0.00255596,0,0,0,0,0
"91471",45735500,1000,0.00257553,0,0,0,0,0
"91472",45736000,1000,0.00255093,0,0,0,0,0
"91473",45736500,1000,0.00258286,0,0,0,0,0
"91474",45737000,1000,0.00257994,0,0,0,0,0
"91475",45737500,1000,0.00248692,0,0,0,0,0
"91476",45738000,1000,0.00252972,0,0,0,0,0
"91477",45738500,1000,0.00265645,0,0,0,1,1
"91478",45739000,1000,0.00267151,0,0,0,1,1
"91479",45739500,1000,0.00265675,0,0,0,0,0
"91480",45740000,1000,0.00281287,0,0,0,1,1
"91481",45740500,1000,0.00284274,0,0,0,1,1
"91482",45741000,1000,0.00260547,0,0,0,0,0
"91483",45741500,1000,0.00252403,0,0,0,0,0
"91484",45742000,1000,0.0025991,0,0,0,0,0
"91485",45742500,1000,0.00293844,0,2,0,1,3
"91486",45743000,1000,0.00292777,0,2,0,1,3
"91487",45743500,1000,0.00282604,0,0,1,1,2
"91488",45744000,1000,0.00283915,0,0,1,1,2
"91489",45744500,1000,0.00276228,0,0,0,1,1
"91490",45745000,1000,0.00283781,0,0,0,1,1
"91491",45745500,1000,0.00269044,0,0,0,0,0
"91492",45746000,1000,0.00280552,0,0,1,0,1
"91493",45746500,1000,0.00284706,0,0,1,2,3
"91494",45747000,1000,0.00267645,0,0,0,3,3
"91495",45747500,1000,0.00258682,0,0,0,1,1
"91496",45748000,1000,0.00265165,0,0,0,0,0
"91497",45748500,1000,0.00290093,0,0,1,0,1
"91498",45749000,1000,0.00282186,0,0,1,0,1
"91499",45749500,1000,0.00264728,0,0,0,0,0
"91500",45750000,1000,0.00262576,0,0,0,0,0
"91501",45750500,1000,0.00255239,0,0,0,0,0
"91502",45751000,1000,0.00279967,0,1,0,0,1
"91503",45751500,1000,0.0028353,0,1,0,0,1
"91504",45752000,1000,0.00270148,0,0,0,0,0
"91505",45752500,1000,0.00271269,0,0,0,0,0
"91506",45753000,1000,0.00262886,0,0,0,0,0
"91507",45753500,1000,0.00267544,0,0,0,0,0
"91508",45754000,1000,0.002624,0,0,0,1,1
"91509",45754500,1000,0.00253378,0,0,0,1,1
"91510",45755000,1000,0.00267533,0,0,0,0,0
"91511",45755500,1000,0.00269589,0,0,0,0,0
"91512",45756000,1000,0.00268342,0,0,0,1,1
"91513",45756500,1000,0.00272333,0,0,0,1,1
"91514",45757000,1000,0.00284236,0,0,1,2,3
"91515",45757500,1000,0.00292859,0,0,1,3,4
"91516",45758000,1000,0.00277638,0,0,0,1,1
"91517",45758500,1000,0.00258366,0,0,0,0,0
"91518",45759000,1000,0.00250821,0,0,0,0,0
"91519",45759500,1000,0.00251824,0,0,0,0,0
"91520",45760000,1000,0.00252327,0,0,0,0,0
"91521",45760500,1000,0.00273011,0,0,1,1,2
"91522",45761000,1000,0.00285659,0,0,1,2,3
"91523",45761500,1000,0.00274363,0,0,0,1,1
"91524",45762000,1000,0.00263583,0,0,0,0,0
"91525",45762500,1000,0.00249891,0,0,0,0,0
"91526",45763000,1000,0.00252323,0,0,0,0,0
"91527",45763500,1000,0.00266426,0,0,0,0,0
"91528",45764000,1000,0.00268137,0,0,0,2,2
"91529",45764500,1000,0.0026701,0,0,0,3,3
"91530",45765000,1000,0.00258909,0,0,0,1,1
"91531",45765500,1000,0.00256335,0,0,0,0,0
"91532",45766000,1000,0.0025848,0,0,0,0,0
"91533",45766500,1000,0.00253871,0,0,0,0,0
"91534",45767000,1000,0.0025992,0,0,1,0,1
"91535",45767500,1000,0.00276583,0,0,1,1,2
"91536",45768000,1000,0.00277242,0,0,0,1,1
"91537",45768500,1000,0.0028025,0,0,0,0,0
"91538",45769000,1000,0.00280737,0,0,0,0,0
"91539",45769500,1000,0.00269714,0,0,0,2,2
"91540",45770000,1000,0.00269715,0,0,0,3,3
"91541",45770500,1000,0.00267097,0,0,0,2,2
"91542",45771000,1000,0.0028028,0,1,0,1,2
"91543",45771500,1000,0.00279952,0,1,0,0,1
"91544",45772000,1000,0.0026141,0,0,0,0,0
"91545",45772500,1000,0.00260772,0,0,0,2,2
"91546",45773000,1000,0.00252658,0,0,0,2,2
"91547",45773500,1000,0.00252751,0,0,0,1,1
"91548",45774000,1000,0.00273161,0,0,0,2,2
"91549",45774500,1000,0.00274747,0,0,0,1,1
"91550",45775000,1000,0.00266637,0,0,0,1,1
"91551",45775500,1000,0.00275661,0,0,0,2,2
"91552",45776000,1000,0.00274664,0,0,0,1,1
"91553",45776500,1000,0.00272933,0,1,0,0,1
"91554",45777000,1000,0.00276799,0,1,0,0,1
"91555",45777500,1000,0.00283256,0,0,0,2,2
"91556",45778000,1000,0.00278081,0,0,0,3,3
"91557",45778500,1000,0.00269035,0,0,0,3,3
"91558",45779000,1000,0.00261914,0,0,0,3,3
"91559",45779500,1000,0.00277223,0,1,0,4,5
"91560",45780000,1000,0.00285415,0,1,0,3,4
"91561",45780500,1000,0.00264235,0,0,0,0,0
"91562",45781000,1000,0.00268286,0,0,0,1,1
"91563",45781500,1000,0.00274029,0,0,0,1,1
"91564",45782000,1000,0.00274247,0,0,0,0,0
"91565",45782500,1000,0.00276122,0,0,0,0,0
"91566",45783000,1000,0.00259148,0,0,0,0,0
"91567",45783500,1000,0.00240203,0,0,0,0,0
"91568",45784000,1000,0.00235186,0,0,0,0,0
"91569",45784500,1000,0.00234744,0,0,0,0,0
"91570",45785000,1000,0.00230856,0,0,0,0,0
"91571",45785500,1000,0.00242056,0,0,0,1,1
"91572",45786000,1000,0.00250444,0,0,0,1,1
"91573",45786500,1000,0.0025698,0,0,0,2,2
"91574",45787000,1000,0.00270931,0,0,0,2,2
"91575",45787500,1000,0.00264027,0,0,0,0,0
"91576",45788000,1000,0.00275744,0,0,0,1,1
"91577",45788500,1000,0.00274489,0,0,0,1,1
"91578",45789000,1000,0.00268365,0,0,1,0,1
"91579",45789500,1000,0.00278254,0,0,1,1,2
"91580",45790000,1000,0.0027786,0,0,1,1,2
"91581",45790500,1000,0.00271616,0,0,1,1,2
"91582",45791000,1000,0.00262935,0,0,0,1,1
"91583",45791500,1000,0.00265824,0,0,0,0,0
"91584",45792000,1000,0.00278965,0,0,0,0,0
"91585",45792500,1000,0.00285799,0,0,0,0,0
"91586",45793000,1000,0.00274233,0,0,0,0,0
"91587",45793500,1000,0.00267906,0,0,0,1,1
"91588",45794000,1000,0.00275275,0,0,0,1,1
"91589",45794500,1000,0.00281754,0,0,0,1,1
"91590",45795000,1000,0.00281913,0,0,0,1,1
"91591",45795500,1000,0.00271037,0,0,1,0,1
"91592",45796000,1000,0.00262547,0,0,1,0,1
"91593",45796500,1000,0.00266371,0,0,0,0,0
"91594",45797000,1000,0.00274691,0,0,0,4,4
"91595",45797500,1000,0.00287561,0,1,0,4,5
"91596",45798000,1000,0.00292512,0,1,1,1,3
"91597",45798500,1000,0.00270048,0,0,1,1,2
"91598",45799000,1000,0.00253508,0,0,0,0,0
"91599",45799500,1000,0.00267903,0,0,0,1,1
"91600",45800000,1000,0.0027463,0,0,0,1,1
"91601",45800500,1000,0.00276859,0,0,0,0,0
"91602",45801000,1000,0.00269813,0,0,0,0,0
"91603",45801500,1000,0.00267029,0,0,0,1,1
"91604",45802000,1000,0.00273127,0,0,0,2,2
"91605",45802500,1000,0.00273164,0,0,0,1,1
"91606",45803000,1000,0.00267739,0,0,0,0,0
"91607",45803500,1000,0.00262592,0,0,0,0,0
"91608",45804000,1000,0.00270775,0,0,0,0,0
"91609",45804500,1000,0.00264372,0,0,0,0,0
"91610",45805000,1000,0.00260255,0,0,0,2,2
"91611",45805500,1000,0.00265005,0,0,0,2,2
"91612",45806000,1000,0.00265355,0,0,0,0,0
"91613",45806500,1000,0.00272214,0,0,0,1,1
"91614",45807000,1000,0.00277333,0,0,0,1,1
"91615",45807500,1000,0.00271512,0,0,0,0,0
"91616",45808000,1000,0.00271981,0,0,0,0,0
"91617",45808500,1000,0.00269327,0,0,0,0,0
"91618",45809000,1000,0.00271484,0,0,0,0,0
"91619",45809500,1000,0.00263503,0,0,0,0,0
"91620",45810000,1000,0.00258851,0,0,1,1,2
"91621",45810500,1000,0.00271994,0,0,1,1,2
"91622",45811000,1000,0.00258006,0,0,0,0,0
"91623",45811500,1000,0.00252492,0,0,0,1,1
"91624",45812000,1000,0.00257229,0,0,0,1,1
"91625",45812500,1000,0.00270937,0,0,1,0,1
"91626",45813000,1000,0.0027459,0,0,1,0,1
"91627",45813500,1000,0.00269,0,0,0,0,0
"91628",45814000,1000,0.00270257,0,0,0,1,1
"91629",45814500,1000,0.00266721,0,0,0,1,1
"91630",45815000,1000,0.00263971,0,0,0,0,0
"91631",45815500,1000,0.00262115,0,0,0,0,0
"91632",45816000,1000,0.00284149,0,1,0,0,1
"91633",45816500,1000,0.00282272,0,1,0,0,1
"91634",45817000,1000,0.00276721,0,0,1,0,1
"91635",45817500,1000,0.00282076,0,0,1,1,2
"91636",45818000,1000,0.00271334,0,0,0,1,1
"91637",45818500,1000,0.00274869,0,0,0,0,0
"91638",45819000,1000,0.00269235,0,0,0,0,0
"91639",45819500,1000,0.00277217,0,0,0,2,2
"91640",45820000,1000,0.00289359,0,0,0,3,3
"91641",45820500,1000,0.00276987,0,0,0,2,2
"91642",45821000,1000,0.00270272,0,0,0,1,1
"91643",45821500,1000,0.00270939,0,0,0,0,0
"91644",45822000,1000,0.00278447,0,0,1,0,1
"91645",45822500,1000,0.00295099,0,0,2,3,5
"91646",45823000,1000,0.00283515,0,0,1,4,5
"91647",45823500,1000,0.00267519,0,0,0,3,3
"91648",45824000,1000,0.00277183,0,0,0,3,3
"91649",45824500,1000,0.0027885,0,0,0,2,2
"91650",45825000,1000,0.00270845,0,0,0,1,1
"91651",45825500,1000,0.00273808,0,0,0,1,1
"91652",45826000,1000,0.00272338,0,0,0,2,2
"91653",45826500,1000,0.00265166,0,0,0,2,2
"91654",45827000,1000,0.00264133,0,0,0,1,1
"91655",45827500,1000,0.00263299,0,0,0,0,0
"91656",45828000,1000,0.00267167,0,0,0,0,0
"91657",45828500,1000,0.00279651,0,0,0,1,1
"91658",45829000,1000,0.00291862,0,0,0,2,2
"91659",45829500,1000,0.00283748,0,0,0,1,1
"91660",45830000,1000,0.00285721,0,0,0,0,0
"91661",45830500,1000,0.00288678,0,0,0,1,1
"91662",45831000,1000,0.00270607,0,0,0,2,2
"91663",45831500,1000,0.00272354,0,0,0,1,1
"91664",45832000,1000,0.00288104,0,0,0,2,2
"91665",45832500,1000,0.00287071,0,0,0,3,3
"91666",45833000,1000,0.00287407,0,0,0,1,1
"91667",45833500,1000,0.00288505,0,0,0,0,0
"91668",45834000,1000,0.00268046,0,0,0,0,0
"91669",45834500,1000,0.00284169,0,0,0,3,3
"91670",45835000,1000,0.0029422,0,0,0,4,4
"91671",45835500,1000,0.00287045,0,0,1,2,3
"91672",45836000,1000,0.0028133,0,0,1,1,2
"91673",45836500,1000,0.00272717,0,0,0,1,1
"91674",45837000,1000,0.00278598,0,0,0,1,1
"91675",45837500,1000,0.00273801,0,0,0,1,1
"91676",45838000,1000,0.00270679,0,0,0,1,1
"91677",45838500,1000,0.00263005,0,0,0,0,0
"91678",45839000,1000,0.0025703,0,0,0,0,0
"91679",45839500,1000,0.00262561,0,0,0,1,1
"91680",45840000,1000,0.00266346,0,0,0,1,1
"91681",45840500,1000,0.00275302,0,0,0,2,2
"91682",45841000,1000,0.00280845,0,0,0,2,2
"91683",45841500,1000,0.002657,0,0,0,0,0
"91684",45842000,1000,0.00266406,0,0,0,1,1
"91685",45842500,1000,0.0027892,0,0,0,3,3
"91686",45843000,1000,0.00279371,0,0,0,2,2
"91687",45843500,1000,0.00276095,0,0,0,1,1
"91688",45844000,1000,0.0027927,0,0,0,1,1
"91689",45844500,1000,0.00282038,0,0,1,0,1
"91690",45845000,1000,0.00285731,0,0,1,0,1
"91691",45845500,1000,0.0029194,0,0,0,2,2
"91692",45846000,1000,0.00285898,0,0,0,2,2
"91693",45846500,1000,0.00270591,0,0,0,0,0
"91694",45847000,1000,0.00284024,0,1,0,0,1
"91695",45847500,1000,0.0029827,0,2,0,0,2
"91696",45848000,1000,0.00281837,0,1,0,0,1
"91697",45848500,1000,0.00271572,0,0,0,1,1
"91698",45849000,1000,0.00274765,0,0,0,2,2
"91699",45849500,1000,0.00271505,0,0,0,1,1
"91700",45850000,1000,0.00270504,0,0,0,1,1
"91701",45850500,1000,0.00277371,0,0,0,1,1
"91702",45851000,1000,0.00278231,0,0,0,1,1
"91703",45851500,1000,0.00288066,0,1,0,2,3
"91704",45852000,1000,0.00294396,0,1,0,3,4
"91705",45852500,1000,0.00275289,0,0,0,2,2
"91706",45853000,1000,0.00262843,0,0,0,1,1
"91707",45853500,1000,0.00277943,0,0,2,1,3
"91708",45854000,1000,0.00272746,0,0,2,0,2
"91709",45854500,1000,0.00276759,0,0,1,3,4
"91710",45855000,1000,0.00280414,0,0,1,3,4
"91711",45855500,1000,0.00251144,0,0,0,0,0
"91712",45856000,1000,0.00244696,0,0,0,0,0
"91713",45856500,1000,0.00265864,0,0,0,1,1
"91714",45857000,1000,0.00275127,0,0,0,3,3
"91715",45857500,1000,0.00261815,0,0,0,2,2
"91716",45858000,1000,0.00258924,0,0,0,0,0
"91717",45858500,1000,0.00276899,0,0,1,1,2
"91718",45859000,1000,0.00291617,0,0,1,3,4
"91719",45859500,1000,0.0028607,0,0,0,4,4
"91720",45860000,1000,0.00275895,0,0,0,2,2
"91721",45860500,1000,0.00280143,0,0,0,2,2
"91722",45861000,1000,0.00278815,0,0,0,2,2
"91723",45861500,1000,0.00258501,0,0,0,0,0
"91724",45862000,1000,0.00243768,0,0,0,0,0
"91725",45862500,1000,0.0025264,0,0,0,0,0
"91726",45863000,1000,0.00270892,0,0,1,0,1
"91727",45863500,1000,0.00269114,0,0,1,0,1
"91728",45864000,1000,0.00274399,0,0,0,1,1
"91729",45864500,1000,0.00274763,0,0,0,1,1
"91730",45865000,1000,0.00267009,0,0,0,0,0
"91731",45865500,1000,0.00270645,0,0,1,0,1
"91732",45866000,1000,0.00274586,0,0,1,0,1
"91733",45866500,1000,0.00263153,0,0,0,1,1
"91734",45867000,1000,0.00257873,0,0,0,1,1
"91735",45867500,1000,0.0026499,0,0,0,0,0
"91736",45868000,1000,0.00267873,0,0,0,0,0
"91737",45868500,1000,0.00272311,0,0,0,0,0
"91738",45869000,1000,0.00281327,0,0,1,2,3
"91739",45869500,1000,0.00271998,0,0,1,2,3
"91740",45870000,1000,0.00263304,0,0,0,0,0
"91741",45870500,1000,0.00273662,0,0,0,1,1
"91742",45871000,1000,0.00285358,0,0,1,1,2
"91743",45871500,1000,0.00276554,0,0,1,0,1
"91744",45872000,1000,0.00265166,0,0,0,0,0
"91745",45872500,1000,0.00272043,0,0,0,0,0
"91746",45873000,1000,0.00271237,0,0,0,0,0
"91747",45873500,1000,0.00268069,0,0,0,0,0
"91748",45874000,1000,0.00260505,0,0,0,0,0
"91749",45874500,1000,0.00257843,0,0,0,0,0
"91750",45875000,1000,0.00268631,0,0,1,1,2
"91751",45875500,1000,0.00274068,0,0,1,2,3
"91752",45876000,1000,0.00264371,0,0,0,2,2
"91753",45876500,1000,0.00266396,0,0,0,2,2
"91754",45877000,1000,0.00262317,0,0,0,1,1
"91755",45877500,1000,0.00261339,0,0,0,0,0
"91756",45878000,1000,0.00261154,0,0,0,0,0
"91757",45878500,1000,0.00260222,0,0,0,0,0
"91758",45879000,1000,0.00273859,0,0,0,2,2
"91759",45879500,1000,0.00282962,0,0,0,3,3
"91760",45880000,1000,0.00284444,0,0,0,3,3
"91761",45880500,1000,0.00287458,0,0,0,4,4
"91762",45881000,1000,0.00284583,0,0,0,3,3
"91763",45881500,1000,0.00270149,0,0,0,2,2
"91764",45882000,1000,0.00285321,0,0,2,1,3
"91765",45882500,1000,0.00288864,0,0,2,0,2
"91766",45883000,1000,0.00272753,0,0,0,0,0
"91767",45883500,1000,0.00276375,0,0,0,0,0
"91768",45884000,1000,0.00276369,0,0,0,1,1
"91769",45884500,1000,0.00281408,0,0,0,4,4
"91770",45885000,1000,0.00288084,0,0,0,4,4
"91771",45885500,1000,0.00276643,0,0,0,1,1
"91772",45886000,1000,0.00279295,0,0,0,3,3
"91773",45886500,1000,0.00274359,0,0,0,3,3
"91774",45887000,1000,0.0026168,0,0,0,1,1
"91775",45887500,1000,0.00264243,0,0,0,2,2
"91776",45888000,1000,0.0026132,0,0,0,1,1
"91777",45888500,1000,0.00267439,0,0,0,0,0
"91778",45889000,1000,0.0028715,0,0,0,0,0
"91779",45889500,1000,0.00280569,0,0,0,0,0
"91780",45890000,1000,0.00265754,0,0,0,0,0
"91781",45890500,1000,0.00263827,0,0,0,0,0
"91782",45891000,1000,0.00251583,0,0,0,0,0
"91783",45891500,1000,0.00262023,0,0,0,1,1
"91784",45892000,1000,0.00273053,0,0,0,1,1
"91785",45892500,1000,0.00277299,0,0,1,1,2
"91786",45893000,1000,0.0029161,0,0,2,2,4
"91787",45893500,1000,0.0028043,0,0,1,1,2
"91788",45894000,1000,0.00253396,0,0,0,0,0
"91789",45894500,1000,0.0024034,0,0,0,0,0
"91790",45895000,1000,0.00249315,0,0,0,0,0
"91791",45895500,1000,0.00249755,0,0,0,0,0
"91792",45896000,1000,0.00237505,0,0,0,0,0
"91793",45896500,1000,0.00238954,0,0,0,0,0
"91794",45897000,1000,0.00239474,0,0,0,0,0
"91795",45897500,1000,0.00250901,0,0,0,0,0
"91796",45898000,1000,0.00257423,0,0,0,0,0
"91797",45898500,1000,0.00253143,0,0,0,0,0
"91798",45899000,1000,0.0026019,0,0,0,0,0
"91799",45899500,1000,0.00273447,0,0,0,1,1
"91800",45900000,1000,0.00269438,0,0,0,1,1
"91801",45900500,1000,0.00260646,0,0,0,0,0
"91802",45901000,1000,0.00284688,0,1,1,0,2
"91803",45901500,1000,0.00269602,0,1,1,0,2
"91804",45902000,1000,0.0024743,0,0,0,1,1
"91805",45902500,1000,0.00263906,0,0,0,2,2
"91806",45903000,1000,0.00277489,0,0,0,2,2
"91807",45903500,1000,0.00249233,0,0,0,2,2
"91808",45904000,1000,0.00200723,0,0,0,1,1
"91809",45904500,1000,0.0022174,0,0,0,0,0
"91810",45905000,1000,0.00257694,0,0,0,0,0
"91811",45905500,1000,0.00265537,0,0,1,0,1
"91812",45906000,1000,0.00265639,0,0,2,0,2
"91813",45906500,1000,0.00256851,0,0,1,0,1
"91814",45907000,1000,0.00265861,0,0,0,2,2
"91815",45907500,1000,0.00269464,0,0,0,2,2
"91816",45908000,1000,0.00257381,0,0,0,0,0
"91817",45908500,1000,0.00252224,0,0,0,0,0
"91818",45909000,1000,0.00260532,0,0,0,1,1
"91819",45909500,1000,0.00272992,0,0,0,3,3
"91820",45910000,1000,0.00265025,0,0,0,2,2
"91821",45910500,1000,0.00251681,0,0,0,0,0
"91822",45911000,1000,0.002568,0,0,0,0,0
"91823",45911500,1000,0.00267115,0,0,0,1,1
"91824",45912000,1000,0.00266214,0,0,0,1,1
"91825",45912500,1000,0.00269943,0,0,0,0,0
"91826",45913000,1000,0.00279634,0,0,0,1,1
"91827",45913500,1000,0.00276551,0,0,0,1,1
"91828",45914000,1000,0.00272866,0,0,0,0,0
"91829",45914500,1000,0.00269638,0,0,0,1,1
"91830",45915000,1000,0.0027019,0,0,0,1,1
"91831",45915500,1000,0.00278167,0,0,0,1,1
"91832",45916000,1000,0.00268753,0,0,0,1,1
"91833",45916500,1000,0.00271244,0,0,0,1,1
"91834",45917000,1000,0.00279657,0,0,0,1,1
"91835",45917500,1000,0.00279514,0,0,0,2,2
"91836",45918000,1000,0.00278991,0,0,0,3,3
"91837",45918500,1000,0.0028286,0,0,1,1,2
"91838",45919000,1000,0.00281076,0,0,2,0,2
"91839",45919500,1000,0.00267053,0,0,1,1,2
"91840",45920000,1000,0.00265614,0,0,0,1,1
"91841",45920500,1000,0.0027166,0,0,0,1,1
"91842",45921000,1000,0.00270387,0,0,0,2,2
"91843",45921500,1000,0.00267226,0,0,0,1,1
"91844",45922000,1000,0.00261592,0,0,0,0,0
"91845",45922500,1000,0.00255801,0,0,0,0,0
"91846",45923000,1000,0.00268313,0,0,0,1,1
"91847",45923500,1000,0.00269826,0,0,0,1,1
"91848",45924000,1000,0.00271824,0,0,0,1,1
"91849",45924500,1000,0.00277712,0,0,0,1,1
"91850",45925000,1000,0.00261408,0,0,0,0,0
"91851",45925500,1000,0.00255203,0,0,0,0,0
"91852",45926000,1000,0.00256363,0,0,0,1,1
"91853",45926500,1000,0.00255503,0,0,0,1,1
"91854",45927000,1000,0.00258456,0,0,0,0,0
"91855",45927500,1000,0.00269422,0,0,1,1,2
"91856",45928000,1000,0.00268968,0,0,1,1,2
"91857",45928500,1000,0.00273103,0,0,1,1,2
"91858",45929000,1000,0.00264613,0,0,1,1,2
"91859",45929500,1000,0.00253609,0,0,0,0,0
"91860",45930000,1000,0.00266897,0,0,0,1,1
"91861",45930500,1000,0.00266315,0,0,0,1,1
"91862",45931000,1000,0.0026771,0,0,0,1,1
"91863",45931500,1000,0.00269566,0,0,0,1,1
"91864",45932000,1000,0.00272812,0,0,0,2,2
"91865",45932500,1000,0.00273995,0,0,0,3,3
"91866",45933000,1000,0.00288857,0,1,0,2,3
"91867",45933500,1000,0.00293585,0,1,0,2,3
"91868",45934000,1000,0.00266876,0,0,0,2,2
"91869",45934500,1000,0.00258219,0,0,0,2,2
"91870",45935000,1000,0.00264293,0,0,0,1,1
"91871",45935500,1000,0.00278949,0,0,0,2,2
"91872",45936000,1000,0.00285156,0,0,0,3,3
"91873",45936500,1000,0.00270192,0,0,0,1,1
"91874",45937000,1000,0.00279276,0,0,0,2,2
"91875",45937500,1000,0.00276399,0,0,0,2,2
"91876",45938000,1000,0.00256001,0,0,0,0,0
"91877",45938500,1000,0.00255765,0,0,0,0,0
"91878",45939000,1000,0.002717,0,0,0,2,2
"91879",45939500,1000,0.00293597,0,1,0,2,3
"91880",45940000,1000,0.00286045,0,1,1,0,2
"91881",45940500,1000,0.00268519,0,0,1,0,1
"91882",45941000,1000,0.00262191,0,0,0,0,0
"91883",45941500,1000,0.00257308,0,0,0,0,0
"91884",45942000,1000,0.0025462,0,0,0,0,0
"91885",45942500,1000,0.00253388,0,0,0,0,0
"91886",45943000,1000,0.00277607,0,1,0,0,1
"91887",45943500,1000,0.00290392,0,1,0,0,1
"91888",45944000,1000,0.00278876,0,0,0,1,1
"91889",45944500,1000,0.00279217,0,0,0,1,1
"91890",45945000,1000,0.00272566,0,0,0,0,0
"91891",45945500,1000,0.00276238,0,0,1,2,3
"91892",45946000,1000,0.00289228,0,0,2,2,4
"91893",45946500,1000,0.00273968,0,0,1,1,2
"91894",45947000,1000,0.00263862,0,0,0,1,1
"91895",45947500,1000,0.00289196,0,1,1,1,3
"91896",45948000,1000,0.00284432,0,1,1,2,4
"91897",45948500,1000,0.00268909,0,0,0,1,1
"91898",45949000,1000,0.00263181,0,0,0,0,0
"91899",45949500,1000,0.00250935,0,0,0,0,0
"91900",45950000,1000,0.00252371,0,0,0,0,0
"91901",45950500,1000,0.00258658,0,0,0,1,1
"91902",45951000,1000,0.0026424,0,0,0,2,2
"91903",45951500,1000,0.00258357,0,0,0,1,1
"91904",45952000,1000,0.00265807,0,0,0,0,0
"91905",45952500,1000,0.0027287,0,0,0,1,1
"91906",45953000,1000,0.00285656,0,0,1,1,2
"91907",45953500,1000,0.00300345,0,1,1,0,2
"91908",45954000,1000,0.00285973,0,1,0,1,2
"91909",45954500,1000,0.00273047,0,0,0,2,2
"91910",45955000,1000,0.00267371,0,0,0,1,1
"91911",45955500,1000,0.00276902,0,0,1,0,1
"91912",45956000,1000,0.00300051,0,1,1,1,3
"91913",45956500,1000,0.00291804,0,1,0,1,2
"91914",45957000,1000,0.00270874,0,0,0,1,1
"91915",45957500,1000,0.00272702,0,0,0,2,2
"91916",45958000,1000,0.0025646,0,0,0,1,1
"91917",45958500,1000,0.00254821,0,0,0,1,1
"91918",45959000,1000,0.00262789,0,0,0,1,1
"91919",45959500,1000,0.00251905,0,0,0,0,0
"91920",45960000,1000,0.00251797,0,0,0,0,0
"91921",45960500,1000,0.00251231,0,0,0,1,1
"91922",45961000,1000,0.00247855,0,0,0,1,1
"91923",45961500,1000,0.00263457,0,0,1,1,2
"91924",45962000,1000,0.00276813,0,0,1,1,2
"91925",45962500,1000,0.00264517,0,0,0,0,0
"91926",45963000,1000,0.00259107,0,0,0,0,0
"91927",45963500,1000,0.00268465,0,0,0,1,1
"91928",45964000,1000,0.00276247,0,0,0,2,2
"91929",45964500,1000,0.00271188,0,0,0,1,1
"91930",45965000,1000,0.00277472,0,0,1,1,2
"91931",45965500,1000,0.00285779,0,0,1,3,4
"91932",45966000,1000,0.002717,0,0,0,2,2
"91933",45966500,1000,0.00259516,0,0,0,1,1
"91934",45967000,1000,0.00259216,0,0,0,1,1
"91935",45967500,1000,0.00269792,0,0,0,0,0
"91936",45968000,1000,0.00269978,0,0,0,0,0
"91937",45968500,1000,0.00271076,0,0,0,1,1
"91938",45969000,1000,0.00269711,0,0,0,1,1
"91939",45969500,1000,0.00247026,0,0,0,0,0
"91940",45970000,1000,0.00227888,0,0,0,0,0
"91941",45970500,1000,0.00254787,0,0,0,2,2
"91942",45971000,1000,0.00275864,0,0,0,2,2
"91943",45971500,1000,0.00263568,0,0,0,0,0
"91944",45972000,1000,0.00266562,0,0,0,1,1
"91945",45972500,1000,0.00263345,0,0,0,1,1
"91946",45973000,1000,0.00268769,0,0,0,0,0
"91947",45973500,1000,0.00268161,0,0,0,0,0
"91948",45974000,1000,0.00256921,0,0,0,0,0
"91949",45974500,1000,0.0029097,0,0,1,2,3
"91950",45975000,1000,0.00292548,0,0,1,2,3
"91951",45975500,1000,0.00264303,0,0,0,0,0
"91952",45976000,1000,0.00275586,0,0,0,0,0
"91953",45976500,1000,0.0027694,0,0,0,0,0
"91954",45977000,1000,0.00267815,0,0,0,0,0
"91955",45977500,1000,0.00267599,0,0,0,0,0
"91956",45978000,1000,0.00274409,0,0,0,1,1
"91957",45978500,1000,0.00281688,0,0,0,3,3
"91958",45979000,1000,0.00267033,0,0,0,2,2
"91959",45979500,1000,0.0027333,0,0,1,2,3
"91960",45980000,1000,0.00278021,0,0,1,2,3
"91961",45980500,1000,0.00259575,0,0,0,0,0
"91962",45981000,1000,0.0027089,0,0,0,0,0
"91963",45981500,1000,0.00284698,0,0,1,1,2
"91964",45982000,1000,0.00278502,0,0,1,2,3
"91965",45982500,1000,0.00277384,0,1,0,1,2
"91966",45983000,1000,0.00280167,0,1,0,0,1
"91967",45983500,1000,0.00275828,0,0,1,0,1
"91968",45984000,1000,0.00270917,0,0,1,0,1
"91969",45984500,1000,0.00272367,0,0,0,1,1
"91970",45985000,1000,0.00271277,0,0,0,2,2
"91971",45985500,1000,0.00280368,0,1,0,1,2
"91972",45986000,1000,0.00288823,0,1,0,1,2
"91973",45986500,1000,0.00269671,0,0,0,1,1
"91974",45987000,1000,0.00264254,0,0,0,0,0
"91975",45987500,1000,0.00267334,0,0,0,1,1
"91976",45988000,1000,0.00284691,0,1,0,1,2
"91977",45988500,1000,0.00274827,0,1,0,0,1
"91978",45989000,1000,0.0027467,0,0,1,1,2
"91979",45989500,1000,0.00281539,0,0,1,1,2
"91980",45990000,1000,0.00256652,0,0,0,1,1
"91981",45990500,1000,0.0026195,0,0,0,1,1
"91982",45991000,1000,0.00275711,0,0,1,0,1
"91983",45991500,1000,0.00266917,0,0,1,0,1
"91984",45992000,1000,0.00262853,0,0,1,0,1
"91985",45992500,1000,0.00270936,0,0,2,1,3
"91986",45993000,1000,0.00281628,0,1,1,1,3
"91987",45993500,1000,0.00286204,0,1,1,0,2
"91988",45994000,1000,0.0026983,0,0,1,0,1
"91989",45994500,1000,0.00272674,0,0,0,2,2
"91990",45995000,1000,0.00276384,0,0,0,2,2
"91991",45995500,1000,0.00272118,0,0,0,1,1
"91992",45996000,1000,0.00268107,0,0,0,1,1
"91993",45996500,1000,0.00262079,0,0,0,0,0
"91994",45997000,1000,0.00296561,0,1,0,0,1
"91995",45997500,1000,0.00314828,0,1,1,1,3
"91996",45998000,1000,0.00287011,0,0,1,1,2
"91997",45998500,1000,0.00269992,0,0,0,0,0
"91998",45999000,1000,0.00259696,0,0,0,0,0
"91999",45999500,1000,0.00257486,0,0,0,0,0
"92000",46000000,1000,0.00260358,0,0,0,1,1
"92001",46000500,1000,0.00267019,0,0,0,1,1
"92002",46001000,1000,0.00271454,0,0,0,1,1
"92003",46001500,1000,0.00263194,0,0,0,1,1
"92004",46002000,1000,0.00268173,0,0,0,0,0
"92005",46002500,1000,0.00269859,0,0,0,1,1
"92006",46003000,1000,0.00260552,0,0,0,2,2
"92007",46003500,1000,0.00267071,0,0,0,3,3
"92008",46004000,1000,0.00278379,0,0,0,4,4
"92009",46004500,1000,0.00269478,0,0,0,3,3
"92010",46005000,1000,0.00257663,0,0,0,2,2
"92011",46005500,1000,0.00272778,0,0,1,1,2
"92012",46006000,1000,0.0029054,0,1,1,1,3
"92013",46006500,1000,0.00279076,0,1,1,2,4
"92014",46007000,1000,0.00253746,0,0,1,1,2
"92015",46007500,1000,0.0024342,0,0,0,0,0
"92016",46008000,1000,0.0025564,0,0,0,1,1
"92017",46008500,1000,0.00255142,0,0,0,1,1
"92018",46009000,1000,0.0026339,0,0,1,1,2
"92019",46009500,1000,0.00285497,0,0,1,2,3
"92020",46010000,1000,0.00269052,0,0,0,1,1
"92021",46010500,1000,0.00261319,0,0,0,1,1
"92022",46011000,1000,0.00267717,0,0,0,2,2
"92023",46011500,1000,0.00271885,0,0,0,1,1
"92024",46012000,1000,0.00285673,0,0,1,1,2
"92025",46012500,1000,0.00269064,0,0,1,1,2
"92026",46013000,1000,0.00260279,0,0,0,1,1
"92027",46013500,1000,0.0027174,0,0,0,1,1
"92028",46014000,1000,0.00282086,0,0,1,0,1
"92029",46014500,1000,0.00289472,0,0,1,2,3
"92030",46015000,1000,0.00277734,0,0,0,3,3
"92031",46015500,1000,0.00261468,0,0,0,1,1
"92032",46016000,1000,0.00270211,0,0,1,0,1
"92033",46016500,1000,0.00281325,0,0,1,2,3
"92034",46017000,1000,0.00270085,0,0,0,2,2
"92035",46017500,1000,0.00280144,0,0,0,4,4
"92036",46018000,1000,0.00283679,0,0,0,4,4
"92037",46018500,1000,0.0028195,0,0,0,2,2
"92038",46019000,1000,0.00270884,0,0,0,2,2
"92039",46019500,1000,0.00266392,0,0,0,3,3
"92040",46020000,1000,0.00278999,0,0,0,3,3
"92041",46020500,1000,0.00271701,0,0,0,0,0
"92042",46021000,1000,0.00263003,0,0,0,0,0
"92043",46021500,1000,0.00267567,0,0,0,0,0
"92044",46022000,1000,0.00266882,0,0,0,1,1
"92045",46022500,1000,0.00271431,0,0,0,2,2
"92046",46023000,1000,0.00280351,0,0,0,1,1
"92047",46023500,1000,0.0029313,0,1,0,1,2
"92048",46024000,1000,0.00282754,0,1,0,1,2
"92049",46024500,1000,0.00276587,0,0,1,0,1
"92050",46025000,1000,0.00277668,0,0,1,0,1
"92051",46025500,1000,0.00262803,0,0,0,0,0
"92052",46026000,1000,0.00274673,0,0,0,0,0
"92053",46026500,1000,0.00282161,0,0,0,1,1
"92054",46027000,1000,0.00274316,0,0,0,1,1
"92055",46027500,1000,0.00271647,0,0,0,0,0
"92056",46028000,1000,0.00270811,0,0,0,0,0
"92057",46028500,1000,0.00278173,0,0,1,2,3
"92058",46029000,1000,0.00275791,0,0,1,2,3
"92059",46029500,1000,0.0025693,0,0,0,0,0
"92060",46030000,1000,0.00250483,0,0,0,0,0
"92061",46030500,1000,0.00257957,0,0,0,0,0
"92062",46031000,1000,0.0027723,0,0,0,0,0
"92063",46031500,1000,0.00272404,0,0,0,0,0
"92064",46032000,1000,0.00259358,0,0,0,0,0
"92065",46032500,1000,0.00253037,0,0,0,0,0
"92066",46033000,1000,0.0026893,0,0,0,0,0
"92067",46033500,1000,0.0028048,0,0,0,0,0
"92068",46034000,1000,0.00269387,0,0,0,1,1
"92069",46034500,1000,0.00258601,0,0,0,1,1
"92070",46035000,1000,0.00263322,0,0,0,0,0
"92071",46035500,1000,0.00276923,0,0,0,1,1
"92072",46036000,1000,0.00268793,0,0,0,2,2
"92073",46036500,1000,0.00271867,0,0,1,2,3
"92074",46037000,1000,0.00274264,0,0,1,2,3
"92075",46037500,1000,0.00260304,0,0,0,1,1
"92076",46038000,1000,0.00265505,0,0,0,0,0
"92077",46038500,1000,0.00274901,0,0,0,0,0
"92078",46039000,1000,0.00270809,0,0,0,0,0
"92079",46039500,1000,0.00268597,0,0,0,0,0
"92080",46040000,1000,0.00266898,0,0,0,1,1
"92081",46040500,1000,0.00263887,0,0,0,1,1
"92082",46041000,1000,0.0026725,0,0,0,1,1
"92083",46041500,1000,0.00265457,0,0,0,1,1
"92084",46042000,1000,0.0026051,0,0,0,1,1
"92085",46042500,1000,0.00259163,0,0,0,1,1
"92086",46043000,1000,0.00253792,0,0,0,0,0
"92087",46043500,1000,0.00267306,0,0,0,2,2
"92088",46044000,1000,0.00276947,0,0,0,2,2
"92089",46044500,1000,0.00270752,0,0,0,0,0
"92090",46045000,1000,0.0027848,0,0,1,1,2
"92091",46045500,1000,0.00277609,0,0,1,1,2
"92092",46046000,1000,0.00265299,0,0,0,0,0
"92093",46046500,1000,0.00263299,0,0,0,1,1
"92094",46047000,1000,0.00265058,0,0,0,1,1
"92095",46047500,1000,0.00261029,0,0,0,0,0
"92096",46048000,1000,0.00271906,0,0,1,2,3
"92097",46048500,1000,0.0026446,0,0,1,2,3
"92098",46049000,1000,0.00258288,0,0,0,1,1
"92099",46049500,1000,0.00283952,0,0,1,2,3
"92100",46050000,1000,0.00284228,0,0,1,3,4
"92101",46050500,1000,0.00272965,0,0,0,3,3
"92102",46051000,1000,0.00265382,0,0,0,1,1
"92103",46051500,1000,0.00264253,0,0,0,2,2
"92104",46052000,1000,0.00276813,0,0,0,3,3
"92105",46052500,1000,0.00268984,0,0,0,1,1
"92106",46053000,1000,0.00266223,0,0,1,1,2
"92107",46053500,1000,0.00285009,0,0,1,3,4
"92108",46054000,1000,0.00285523,0,0,0,4,4
"92109",46054500,1000,0.00271692,0,0,0,2,2
"92110",46055000,1000,0.00278943,0,0,1,2,3
"92111",46055500,1000,0.00281778,0,1,1,2,4
"92112",46056000,1000,0.00270937,0,1,0,2,3
"92113",46056500,1000,0.00257707,0,0,0,2,2
"92114",46057000,1000,0.00249727,0,0,0,0,0
"92115",46057500,1000,0.00261834,0,0,0,1,1
"92116",46058000,1000,0.00265609,0,0,0,1,1
"92117",46058500,1000,0.00256052,0,0,0,0,0
"92118",46059000,1000,0.00257988,0,0,1,0,1
"92119",46059500,1000,0.00269629,0,0,1,0,1
"92120",46060000,1000,0.00257638,0,0,0,0,0
"92121",46060500,1000,0.00246725,0,0,0,0,0
"92122",46061000,1000,0.0024385,0,0,0,0,0
"92123",46061500,1000,0.00251576,0,0,0,1,1
"92124",46062000,1000,0.00258251,0,0,0,1,1
"92125",46062500,1000,0.00282913,0,0,1,3,4
"92126",46063000,1000,0.00284213,0,0,1,3,4
"92127",46063500,1000,0.00251884,0,0,0,0,0
"92128",46064000,1000,0.00249099,0,0,0,0,0
"92129",46064500,1000,0.00258528,0,0,0,0,0
"92130",46065000,1000,0.0026609,0,0,0,1,1
"92131",46065500,1000,0.00258085,0,0,0,1,1
"92132",46066000,1000,0.00251401,0,0,0,0,0
"92133",46066500,1000,0.00268675,0,0,0,1,1
"92134",46067000,1000,0.00278959,0,0,0,1,1
"92135",46067500,1000,0.00279099,0,0,0,0,0
"92136",46068000,1000,0.00284163,0,0,1,0,1
"92137",46068500,1000,0.00265468,0,0,1,0,1
"92138",46069000,1000,0.00255415,0,0,0,1,1
"92139",46069500,1000,0.00271508,0,0,1,2,3
"92140",46070000,1000,0.00261251,0,0,1,1,2
"92141",46070500,1000,0.00243172,0,0,0,0,0
"92142",46071000,1000,0.00256254,0,0,0,1,1
"92143",46071500,1000,0.00260272,0,0,0,1,1
"92144",46072000,1000,0.0024825,0,0,0,0,0
"92145",46072500,1000,0.00237057,0,0,0,0,0
"92146",46073000,1000,0.00237983,0,0,0,0,0
"92147",46073500,1000,0.00244657,0,0,0,0,0
"92148",46074000,1000,0.00246139,0,0,0,0,0
"92149",46074500,1000,0.00244033,0,0,0,0,0
"92150",46075000,1000,0.00250439,0,0,0,0,0
"92151",46075500,1000,0.0026752,0,1,0,0,1
"92152",46076000,1000,0.00270487,0,1,0,1,2
"92153",46076500,1000,0.00249757,0,0,0,1,1
"92154",46077000,1000,0.00249389,0,0,0,0,0
"92155",46077500,1000,0.00265503,0,0,0,1,1
"92156",46078000,1000,0.00258854,0,0,0,1,1
"92157",46078500,1000,0.00256446,0,0,0,0,0
"92158",46079000,1000,0.00255706,0,0,0,0,0
"92159",46079500,1000,0.0026115,0,0,0,1,1
"92160",46080000,1000,0.00255487,0,0,0,1,1
"92161",46080500,1000,0.00244491,0,0,1,0,1
"92162",46081000,1000,0.00246211,0,0,1,0,1
"92163",46081500,1000,0.00243775,0,0,0,0,0
"92164",46082000,1000,0.0025225,0,0,0,0,0
"92165",46082500,1000,0.00276013,0,0,0,0,0
"92166",46083000,1000,0.00269411,0,0,0,0,0
"92167",46083500,1000,0.00259368,0,0,0,1,1
"92168",46084000,1000,0.00280124,0,0,0,2,2
"92169",46084500,1000,0.0027574,0,0,0,1,1
"92170",46085000,1000,0.00254751,0,0,0,0,0
"92171",46085500,1000,0.00258971,0,0,0,1,1
"92172",46086000,1000,0.00255585,0,0,0,1,1
"92173",46086500,1000,0.00259189,0,0,0,1,1
"92174",46087000,1000,0.00264141,0,0,0,1,1
"92175",46087500,1000,0.00256171,0,0,0,0,0
"92176",46088000,1000,0.00279896,0,0,1,0,1
"92177",46088500,1000,0.00290284,0,0,1,2,3
"92178",46089000,1000,0.00264906,0,0,0,2,2
"92179",46089500,1000,0.00261538,0,0,1,0,1
"92180",46090000,1000,0.00271952,0,0,1,0,1
"92181",46090500,1000,0.00261355,0,0,0,1,1
"92182",46091000,1000,0.0024554,0,0,0,1,1
"92183",46091500,1000,0.00245074,0,0,0,0,0
"92184",46092000,1000,0.00258248,0,0,0,0,0
"92185",46092500,1000,0.0024867,0,0,0,0,0
"92186",46093000,1000,0.00240081,0,0,0,0,0
"92187",46093500,1000,0.00257054,0,0,1,1,2
"92188",46094000,1000,0.0027579,0,0,1,4,5
"92189",46094500,1000,0.00277346,0,0,0,4,4
"92190",46095000,1000,0.00260047,0,0,0,1,1
"92191",46095500,1000,0.00244936,0,0,0,0,0
"92192",46096000,1000,0.0024261,0,0,0,0,0
"92193",46096500,1000,0.00274366,0,0,1,2,3
"92194",46097000,1000,0.00286521,0,0,1,3,4
"92195",46097500,1000,0.00259315,0,0,0,1,1
"92196",46098000,1000,0.00249835,0,0,0,0,0
"92197",46098500,1000,0.00257462,0,0,0,1,1
"92198",46099000,1000,0.00270037,0,0,1,2,3
"92199",46099500,1000,0.00265725,0,0,1,1,2
"92200",46100000,1000,0.00257858,0,0,0,0,0
"92201",46100500,1000,0.00252355,0,0,0,0,0
"92202",46101000,1000,0.00251694,0,0,0,0,0
"92203",46101500,1000,0.0025296,0,0,0,0,0
"92204",46102000,1000,0.00272437,0,0,1,1,2
"92205",46102500,1000,0.00276517,0,0,1,1,2
"92206",46103000,1000,0.00263113,0,0,1,0,1
"92207",46103500,1000,0.00272372,0,0,1,2,3
"92208",46104000,1000,0.00265115,0,0,0,2,2
"92209",46104500,1000,0.00255005,0,0,0,0,0
"92210",46105000,1000,0.00277142,0,0,0,4,4
"92211",46105500,1000,0.00288895,0,0,0,6,6
"92212",46106000,1000,0.00274697,0,0,0,2,2
"92213",46106500,1000,0.00273642,0,0,0,2,2
"92214",46107000,1000,0.00274535,0,0,0,3,3
"92215",46107500,1000,0.00267111,0,0,0,2,2
"92216",46108000,1000,0.00268133,0,0,0,1,1
"92217",46108500,1000,0.00260695,0,0,0,0,0
"92218",46109000,1000,0.0025985,0,0,0,2,2
"92219",46109500,1000,0.00269876,0,0,0,2,2
"92220",46110000,1000,0.00261665,0,0,0,0,0
"92221",46110500,1000,0.00256743,0,0,0,1,1
"92222",46111000,1000,0.0026161,0,0,0,3,3
"92223",46111500,1000,0.00255066,0,0,0,2,2
"92224",46112000,1000,0.00275599,0,1,0,2,3
"92225",46112500,1000,0.00287889,0,1,0,2,3
"92226",46113000,1000,0.00262737,0,0,1,0,1
"92227",46113500,1000,0.00250152,0,0,1,0,1
"92228",46114000,1000,0.00259413,0,0,0,2,2
"92229",46114500,1000,0.00259852,0,0,0,2,2
"92230",46115000,1000,0.00255384,0,0,0,1,1
"92231",46115500,1000,0.00253306,0,0,0,1,1
"92232",46116000,1000,0.00251507,0,0,0,1,1
"92233",46116500,1000,0.00254909,0,0,0,1,1
"92234",46117000,1000,0.0024692,0,0,0,0,0
"92235",46117500,1000,0.00240417,0,0,0,0,0
"92236",46118000,1000,0.00250444,0,0,0,1,1
"92237",46118500,1000,0.00266541,0,0,0,2,2
"92238",46119000,1000,0.00268641,0,0,0,2,2
"92239",46119500,1000,0.00278497,0,0,0,3,3
"92240",46120000,1000,0.00274138,0,0,0,3,3
"92241",46120500,1000,0.00250483,0,0,0,1,1
"92242",46121000,1000,0.00259653,0,0,0,0,0
"92243",46121500,1000,0.00263472,0,0,0,0,0
"92244",46122000,1000,0.00255358,0,0,0,1,1
"92245",46122500,1000,0.00258888,0,0,0,1,1
"92246",46123000,1000,0.002624,0,0,0,1,1
"92247",46123500,1000,0.00270302,0,0,0,1,1
"92248",46124000,1000,0.00273156,0,0,0,0,0
"92249",46124500,1000,0.0027192,0,0,0,0,0
"92250",46125000,1000,0.00253333,0,0,0,0,0
"92251",46125500,1000,0.00247986,0,0,0,0,0
"92252",46126000,1000,0.00275976,0,0,1,2,3
"92253",46126500,1000,0.00276432,0,0,1,2,3
"92254",46127000,1000,0.00260362,0,0,0,0,0
"92255",46127500,1000,0.00256068,0,0,0,0,0
"92256",46128000,1000,0.00254795,0,0,0,0,0
"92257",46128500,1000,0.00267225,0,0,0,0,0
"92258",46129000,1000,0.00269854,0,0,0,1,1
"92259",46129500,1000,0.00268773,0,0,0,2,2
"92260",46130000,1000,0.0026979,0,0,0,2,2
"92261",46130500,1000,0.00266668,0,0,0,1,1
"92262",46131000,1000,0.00257935,0,0,0,1,1
"92263",46131500,1000,0.00262242,0,0,0,1,1
"92264",46132000,1000,0.00269038,0,0,0,0,0
"92265",46132500,1000,0.00268957,0,0,0,1,1
"92266",46133000,1000,0.00263538,0,0,0,1,1
"92267",46133500,1000,0.00247833,0,0,0,0,0
"92268",46134000,1000,0.00263983,0,0,0,3,3
"92269",46134500,1000,0.00287476,0,0,0,5,5
"92270",46135000,1000,0.00270667,0,0,0,2,2
"92271",46135500,1000,0.00249509,0,0,0,0,0
"92272",46136000,1000,0.0025354,0,0,0,0,0
"92273",46136500,1000,0.00255918,0,0,0,0,0
"92274",46137000,1000,0.00254224,0,0,0,0,0
"92275",46137500,1000,0.00263159,0,0,1,0,1
"92276",46138000,1000,0.00264071,0,0,1,0,1
"92277",46138500,1000,0.00268636,0,0,0,0,0
"92278",46139000,1000,0.00267851,0,0,0,0,0
"92279",46139500,1000,0.00263734,0,0,0,0,0
"92280",46140000,1000,0.00257902,0,0,0,0,0
"92281",46140500,1000,0.00248324,0,0,0,0,0
"92282",46141000,1000,0.00256904,0,0,0,0,0
"92283",46141500,1000,0.00258508,0,0,0,0,0
"92284",46142000,1000,0.00254051,0,0,0,1,1
"92285",46142500,1000,0.00248431,0,0,0,1,1
"92286",46143000,1000,0.00252988,0,0,0,1,1
"92287",46143500,1000,0.00263905,0,0,0,2,2
"92288",46144000,1000,0.00270667,0,0,1,1,2
"92289",46144500,1000,0.00271774,0,0,1,1,2
"92290",46145000,1000,0.0026366,0,0,0,1,1
"92291",46145500,1000,0.00274734,0,0,1,0,1
"92292",46146000,1000,0.00286107,0,0,2,0,2
"92293",46146500,1000,0.0029087,0,0,2,1,3
"92294",46147000,1000,0.0028359,0,0,2,1,3
"92295",46147500,1000,0.0026402,0,0,1,1,2
"92296",46148000,1000,0.00253854,0,0,0,1,1
"92297",46148500,1000,0.002603,0,1,0,0,1
"92298",46149000,1000,0.00278308,0,1,1,1,3
"92299",46149500,1000,0.00281547,0,0,2,2,4
"92300",46150000,1000,0.00267036,0,0,1,1,2
"92301",46150500,1000,0.0024877,0,0,0,0,0
"92302",46151000,1000,0.00254134,0,0,0,0,0
"92303",46151500,1000,0.00255184,0,0,0,0,0
"92304",46152000,1000,0.00252895,0,0,0,0,0
"92305",46152500,1000,0.00266617,0,0,1,0,1
"92306",46153000,1000,0.002594,0,0,1,0,1
"92307",46153500,1000,0.00265943,0,0,0,1,1
"92308",46154000,1000,0.00282735,0,0,0,2,2
"92309",46154500,1000,0.00276821,0,0,0,2,2
"92310",46155000,1000,0.0026575,0,0,0,2,2
"92311",46155500,1000,0.00248192,0,0,0,1,1
"92312",46156000,1000,0.00252217,0,0,0,1,1
"92313",46156500,1000,0.00256695,0,0,0,1,1
"92314",46157000,1000,0.00248071,0,0,0,0,0
"92315",46157500,1000,0.00263295,0,0,1,0,1
"92316",46158000,1000,0.00261042,0,0,1,0,1
"92317",46158500,1000,0.00264539,0,0,0,2,2
"92318",46159000,1000,0.00271751,0,0,0,2,2
"92319",46159500,1000,0.00250545,0,0,0,0,0
"92320",46160000,1000,0.00249702,0,0,0,1,1
"92321",46160500,1000,0.00258085,0,0,0,2,2
"92322",46161000,1000,0.00268216,0,0,1,2,3
"92323",46161500,1000,0.00260058,0,0,1,1,2
"92324",46162000,1000,0.0024388,0,0,0,0,0
"92325",46162500,1000,0.0024979,0,0,0,0,0
"92326",46163000,1000,0.00254619,0,0,0,0,0
"92327",46163500,1000,0.00268946,0,0,2,0,2
"92328",46164000,1000,0.00270172,0,0,2,0,2
"92329",46164500,1000,0.00259895,0,0,0,1,1
"92330",46165000,1000,0.00260475,0,0,0,2,2
"92331",46165500,1000,0.00271804,0,0,1,2,3
"92332",46166000,1000,0.00293076,0,0,2,2,4
"92333",46166500,1000,0.00277316,0,0,1,1,2
"92334",46167000,1000,0.00252702,0,0,0,1,1
"92335",46167500,1000,0.00246722,0,0,0,1,1
"92336",46168000,1000,0.0025591,0,0,0,0,0
"92337",46168500,1000,0.00259415,0,0,0,0,0
"92338",46169000,1000,0.00242546,0,0,0,0,0
"92339",46169500,1000,0.0025763,0,0,0,2,2
"92340",46170000,1000,0.00267454,0,0,0,2,2
"92341",46170500,1000,0.00269636,0,0,0,0,0
"92342",46171000,1000,0.00277386,0,0,0,0,0
"92343",46171500,1000,0.00272866,0,0,0,0,0
"92344",46172000,1000,0.0027429,0,0,0,1,1
"92345",46172500,1000,0.00260913,0,0,0,1,1
"92346",46173000,1000,0.0025719,0,0,0,0,0
"92347",46173500,1000,0.00258935,0,0,0,0,0
"92348",46174000,1000,0.00258063,0,0,0,2,2
"92349",46174500,1000,0.00259004,0,0,0,2,2
"92350",46175000,1000,0.00253364,0,0,0,1,1
"92351",46175500,1000,0.00259644,0,0,0,3,3
"92352",46176000,1000,0.00273084,0,0,0,4,4
"92353",46176500,1000,0.00275101,0,0,0,3,3
"92354",46177000,1000,0.00261768,0,0,0,1,1
"92355",46177500,1000,0.00262086,0,0,1,1,2
"92356",46178000,1000,0.00264297,0,0,1,1,2
"92357",46178500,1000,0.00268624,0,0,1,1,2
"92358",46179000,1000,0.00278155,0,0,1,2,3
"92359",46179500,1000,0.00263338,0,0,0,1,1
"92360",46180000,1000,0.00257185,0,0,0,1,1
"92361",46180500,1000,0.0025865,0,0,0,2,2
"92362",46181000,1000,0.00261113,0,0,0,1,1
"92363",46181500,1000,0.00276726,0,0,1,0,1
"92364",46182000,1000,0.00274854,0,0,1,0,1
"92365",46182500,1000,0.00257053,0,0,0,0,0
"92366",46183000,1000,0.00254073,0,0,0,1,1
"92367",46183500,1000,0.00266658,0,0,0,3,3
"92368",46184000,1000,0.00277512,0,0,1,2,3
"92369",46184500,1000,0.00274728,0,0,1,0,1
"92370",46185000,1000,0.00260623,0,0,0,0,0
"92371",46185500,1000,0.00256612,0,0,0,0,0
"92372",46186000,1000,0.00272205,0,0,1,1,2
"92373",46186500,1000,0.00276593,0,0,1,3,4
"92374",46187000,1000,0.00267735,0,0,0,3,3
"92375",46187500,1000,0.00259177,0,0,0,1,1
"92376",46188000,1000,0.0025532,0,0,0,0,0
"92377",46188500,1000,0.00259275,0,0,0,0,0
"92378",46189000,1000,0.00254444,0,0,0,0,0
"92379",46189500,1000,0.00258478,0,0,1,1,2
"92380",46190000,1000,0.00273171,0,0,2,1,3
"92381",46190500,1000,0.00262094,0,0,1,0,1
"92382",46191000,1000,0.00240099,0,0,0,0,0
"92383",46191500,1000,0.00245997,0,0,0,0,0
"92384",46192000,1000,0.00257136,0,0,0,1,1
"92385",46192500,1000,0.00252479,0,0,0,1,1
"92386",46193000,1000,0.00234346,0,0,0,0,0
"92387",46193500,1000,0.00228992,0,0,0,0,0
"92388",46194000,1000,0.00239462,0,0,0,0,0
"92389",46194500,1000,0.00248944,0,0,0,0,0
"92390",46195000,1000,0.00247918,0,0,0,0,0
"92391",46195500,1000,0.00253348,0,0,0,1,1
"92392",46196000,1000,0.00267906,0,0,0,1,1
"92393",46196500,1000,0.00262848,0,0,0,0,0
"92394",46197000,1000,0.00262573,0,0,0,0,0
"92395",46197500,1000,0.0026372,0,0,0,0,0
"92396",46198000,1000,0.00250964,0,0,0,1,1
"92397",46198500,1000,0.0024524,0,0,0,2,2
"92398",46199000,1000,0.00251286,0,0,0,1,1
"92399",46199500,1000,0.00243862,0,0,0,0,0
"92400",46200000,1000,0.00244444,0,0,0,0,0
"92401",46200500,1000,0.00253058,0,0,0,0,0
"92402",46201000,1000,0.00258792,0,0,1,0,1
"92403",46201500,1000,0.00269586,0,0,1,0,1
"92404",46202000,1000,0.00265378,0,0,0,0,0
"92405",46202500,1000,0.00252456,0,0,0,0,0
"92406",46203000,1000,0.00257648,0,0,0,1,1
"92407",46203500,1000,0.00257858,0,0,0,1,1
"92408",46204000,1000,0.00259954,0,0,1,1,2
"92409",46204500,1000,0.00262637,0,0,1,1,2
"92410",46205000,1000,0.00266889,0,0,1,1,2
"92411",46205500,1000,0.00266842,0,0,1,1,2
"92412",46206000,1000,0.00249603,0,0,0,0,0
"92413",46206500,1000,0.00251749,0,0,0,0,0
"92414",46207000,1000,0.00274494,0,0,0,3,3
"92415",46207500,1000,0.00280972,0,0,0,4,4
"92416",46208000,1000,0.00274888,0,0,0,3,3
"92417",46208500,1000,0.00284737,0,0,1,3,4
"92418",46209000,1000,0.0027285,0,0,1,1,2
"92419",46209500,1000,0.00271847,0,0,1,1,2
"92420",46210000,1000,0.00278898,0,0,2,2,4
"92421",46210500,1000,0.00260729,0,0,1,1,2
"92422",46211000,1000,0.00251011,0,0,0,0,0
"92423",46211500,1000,0.00246562,0,0,0,0,0
"92424",46212000,1000,0.00262306,0,0,1,1,2
"92425",46212500,1000,0.00263618,0,0,1,1,2
"92426",46213000,1000,0.00250155,0,0,0,0,0
"92427",46213500,1000,0.00272711,0,0,0,4,4
"92428",46214000,1000,0.00274985,0,0,0,5,5
"92429",46214500,1000,0.00264173,0,0,0,1,1
"92430",46215000,1000,0.00273089,0,0,0,1,1
"92431",46215500,1000,0.00291604,0,0,1,2,3
"92432",46216000,1000,0.00289473,0,0,1,3,4
"92433",46216500,1000,0.00271592,0,0,0,2,2
"92434",46217000,1000,0.00282835,0,0,1,1,2
"92435",46217500,1000,0.00304719,0,0,2,4,6
"92436",46218000,1000,0.00291555,0,0,1,3,4
"92437",46218500,1000,0.0026949,0,0,0,1,1
"92438",46219000,1000,0.00268824,0,0,0,2,2
"92439",46219500,1000,0.0028151,0,0,1,2,3
"92440",46220000,1000,0.0028624,0,0,2,2,4
"92441",46220500,1000,0.00276048,0,0,1,2,3
"92442",46221000,1000,0.00265684,0,0,0,1,1
"92443",46221500,1000,0.00245977,0,0,0,0,0
"92444",46222000,1000,0.00251551,0,0,0,0,0
"92445",46222500,1000,0.00262394,0,0,0,1,1
"92446",46223000,1000,0.00263271,0,0,0,1,1
"92447",46223500,1000,0.00253886,0,0,0,0,0
"92448",46224000,1000,0.00266151,0,1,0,0,1
"92449",46224500,1000,0.00269175,0,1,0,0,1
"92450",46225000,1000,0.00247326,0,0,0,1,1
"92451",46225500,1000,0.00257337,0,0,0,1,1
"92452",46226000,1000,0.00258709,0,0,0,1,1
"92453",46226500,1000,0.00273135,0,0,1,4,5
"92454",46227000,1000,0.00270378,0,0,1,3,4
"92455",46227500,1000,0.00267417,0,0,0,3,3
"92456",46228000,1000,0.00280511,0,0,0,4,4
"92457",46228500,1000,0.00268123,0,0,0,2,2
"92458",46229000,1000,0.0026188,0,0,0,1,1
"92459",46229500,1000,0.00260327,0,0,0,1,1
"92460",46230000,1000,0.00258295,0,0,0,1,1
"92461",46230500,1000,0.00269804,0,0,1,0,1
"92462",46231000,1000,0.00282921,0,0,2,1,3
"92463",46231500,1000,0.00276486,0,0,1,1,2
"92464",46232000,1000,0.00269076,0,0,0,0,0
"92465",46232500,1000,0.00279383,0,0,0,1,1
"92466",46233000,1000,0.00277725,0,0,0,2,2
"92467",46233500,1000,0.00264241,0,0,0,2,2
"92468",46234000,1000,0.00264766,0,0,0,2,2
"92469",46234500,1000,0.00274884,0,1,0,1,2
"92470",46235000,1000,0.00273268,0,1,0,0,1
"92471",46235500,1000,0.00267225,0,0,0,1,1
"92472",46236000,1000,0.00262288,0,0,0,1,1
"92473",46236500,1000,0.00269268,0,0,1,1,2
"92474",46237000,1000,0.00260442,0,0,1,1,2
"92475",46237500,1000,0.00249508,0,0,0,0,0
"92476",46238000,1000,0.00277321,0,0,1,1,2
"92477",46238500,1000,0.00296021,0,0,1,5,6
"92478",46239000,1000,0.0028819,0,0,0,5,5
"92479",46239500,1000,0.00282526,0,0,0,3,3
"92480",46240000,1000,0.0028352,0,0,0,4,4
"92481",46240500,1000,0.00275615,0,0,0,4,4
"92482",46241000,1000,0.00262953,0,0,0,2,2
"92483",46241500,1000,0.00259846,0,0,0,1,1
"92484",46242000,1000,0.00268244,0,0,0,3,3
"92485",46242500,1000,0.00273472,0,0,0,4,4
"92486",46243000,1000,0.00256155,0,0,0,2,2
"92487",46243500,1000,0.0023933,0,0,0,0,0
"92488",46244000,1000,0.00281624,0,0,0,1,1
"92489",46244500,1000,0.00298274,0,0,0,2,2
"92490",46245000,1000,0.00274263,0,0,0,1,1
"92491",46245500,1000,0.00273174,0,1,0,0,1
"92492",46246000,1000,0.00256911,0,1,0,0,1
"92493",46246500,1000,0.00252636,0,0,0,1,1
"92494",46247000,1000,0.00261297,0,0,0,1,1
"92495",46247500,1000,0.0025427,0,0,0,0,0
"92496",46248000,1000,0.00249681,0,0,0,0,0
"92497",46248500,1000,0.00265964,0,0,1,0,1
"92498",46249000,1000,0.00278244,0,0,1,0,1
"92499",46249500,1000,0.00269005,0,0,0,0,0
"92500",46250000,1000,0.00272208,0,0,0,3,3
"92501",46250500,1000,0.00289632,0,0,0,4,4
"92502",46251000,1000,0.00288336,0,0,0,2,2
"92503",46251500,1000,0.00268721,0,0,0,1,1
"92504",46252000,1000,0.0025316,0,0,0,0,0
"92505",46252500,1000,0.00248758,0,0,0,0,0
"92506",46253000,1000,0.00253304,0,0,0,0,0
"92507",46253500,1000,0.00261605,0,0,0,0,0
"92508",46254000,1000,0.00272113,0,0,0,0,0
"92509",46254500,1000,0.0026645,0,0,0,0,0
"92510",46255000,1000,0.00264105,0,0,0,1,1
"92511",46255500,1000,0.00277223,0,0,1,2,3
"92512",46256000,1000,0.00277892,0,0,1,2,3
"92513",46256500,1000,0.00264343,0,0,0,1,1
"92514",46257000,1000,0.00263636,0,0,0,2,2
"92515",46257500,1000,0.00264074,0,0,0,3,3
"92516",46258000,1000,0.00282599,0,1,0,2,3
"92517",46258500,1000,0.00289942,0,1,1,2,4
"92518",46259000,1000,0.00257659,0,0,1,1,2
"92519",46259500,1000,0.00262959,0,0,0,0,0
"92520",46260000,1000,0.00290903,0,1,0,1,2
"92521",46260500,1000,0.00279447,0,1,0,1,2
"92522",46261000,1000,0.0025389,0,0,0,0,0
"92523",46261500,1000,0.00252236,0,0,0,1,1
"92524",46262000,1000,0.00273279,0,0,0,3,3
"92525",46262500,1000,0.00284054,0,0,0,4,4
"92526",46263000,1000,0.00278764,0,0,0,5,5
"92527",46263500,1000,0.00274267,0,0,0,4,4
"92528",46264000,1000,0.00261578,0,0,0,1,1
"92529",46264500,1000,0.0025448,0,0,0,0,0
"92530",46265000,1000,0.00293892,0,0,0,1,1
"92531",46265500,1000,0.00299577,0,0,0,2,2
"92532",46266000,1000,0.00273944,0,0,1,1,2
"92533",46266500,1000,0.00255988,0,0,1,0,1
"92534",46267000,1000,0.00242989,0,0,0,0,0
"92535",46267500,1000,0.00254079,0,0,0,0,0
"92536",46268000,1000,0.00261539,0,0,0,2,2
"92537",46268500,1000,0.00276897,0,0,0,4,4
"92538",46269000,1000,0.0027669,0,0,0,2,2
"92539",46269500,1000,0.0025471,0,0,0,0,0
"92540",46270000,1000,0.00266658,0,0,1,1,2
"92541",46270500,1000,0.00284985,0,0,1,3,4
"92542",46271000,1000,0.0026906,0,0,0,2,2
"92543",46271500,1000,0.0027792,0,0,0,2,2
"92544",46272000,1000,0.00270336,0,0,0,2,2
"92545",46272500,1000,0.0025948,0,0,1,0,1
"92546",46273000,1000,0.00258798,0,0,1,0,1
"92547",46273500,1000,0.00250289,0,0,0,0,0
"92548",46274000,1000,0.00269301,0,0,1,0,1
"92549",46274500,1000,0.00272986,0,0,1,0,1
"92550",46275000,1000,0.00257122,0,0,0,0,0
"92551",46275500,1000,0.00247522,0,0,0,0,0
"92552",46276000,1000,0.00246821,0,0,0,0,0
"92553",46276500,1000,0.00246425,0,0,0,0,0
"92554",46277000,1000,0.00248765,0,0,0,1,1
"92555",46277500,1000,0.00268611,0,0,1,2,3
"92556",46278000,1000,0.00279996,0,0,2,2,4
"92557",46278500,1000,0.00278054,0,0,1,3,4
"92558",46279000,1000,0.00269527,0,0,0,3,3
"92559",46279500,1000,0.00263549,0,0,0,2,2
"92560",46280000,1000,0.00262171,0,0,0,1,1
"92561",46280500,1000,0.00265476,0,1,0,0,1
"92562",46281000,1000,0.00263902,0,1,0,0,1
"92563",46281500,1000,0.0027478,0,0,0,3,3
"92564",46282000,1000,0.0027764,0,0,0,4,4
"92565",46282500,1000,0.00269897,0,0,0,4,4
"92566",46283000,1000,0.00262498,0,0,0,3,3
"92567",46283500,1000,0.00258964,0,0,0,0,0
"92568",46284000,1000,0.00266377,0,0,0,0,0
"92569",46284500,1000,0.00261653,0,0,0,0,0
"92570",46285000,1000,0.00270467,0,0,0,2,2
"92571",46285500,1000,0.00273468,0,0,0,2,2
"92572",46286000,1000,0.00255032,0,0,0,0,0
"92573",46286500,1000,0.00249663,0,0,0,0,0
"92574",46287000,1000,0.00270855,0,0,1,0,1
"92575",46287500,1000,0.00273329,0,0,1,0,1
"92576",46288000,1000,0.00272113,0,0,1,0,1
"92577",46288500,1000,0.00287795,0,0,2,2,4
"92578",46289000,1000,0.00277327,0,0,1,2,3
"92579",46289500,1000,0.00262829,0,0,1,1,2
"92580",46290000,1000,0.00261719,0,0,1,1,2
"92581",46290500,1000,0.00270508,0,0,1,1,2
"92582",46291000,1000,0.00272432,0,0,1,2,3
"92583",46291500,1000,0.00254426,0,0,0,1,1
"92584",46292000,1000,0.00269246,0,0,0,2,2
"92585",46292500,1000,0.00265463,0,0,0,2,2
"92586",46293000,1000,0.00253103,0,0,0,1,1
"92587",46293500,1000,0.00254805,0,0,0,1,1
"92588",46294000,1000,0.00264263,0,0,1,0,1
"92589",46294500,1000,0.00277809,0,0,1,1,2
"92590",46295000,1000,0.00269881,0,0,0,1,1
"92591",46295500,1000,0.00277601,0,0,0,0,0
"92592",46296000,1000,0.00303139,0,0,1,1,2
"92593",46296500,1000,0.00317671,0,0,2,2,4
"92594",46297000,1000,0.00317859,0,0,1,3,4
"92595",46297500,1000,0.00308102,0,0,0,3,3
"92596",46298000,1000,0.00280236,0,0,0,2,2
"92597",46298500,1000,0.00266468,0,0,0,3,3
"92598",46299000,1000,0.00258585,0,0,0,2,2
"92599",46299500,1000,0.00246786,0,0,0,0,0
"92600",46300000,1000,0.00252261,0,0,0,1,1
"92601",46300500,1000,0.00250753,0,0,0,1,1
"92602",46301000,1000,0.00250364,0,0,0,2,2
"92603",46301500,1000,0.00258828,0,0,0,2,2
"92604",46302000,1000,0.00265611,0,0,0,1,1
"92605",46302500,1000,0.00263247,0,0,0,1,1
"92606",46303000,1000,0.00253791,0,0,1,0,1
"92607",46303500,1000,0.00253561,0,0,1,0,1
"92608",46304000,1000,0.00253498,0,0,0,0,0
"92609",46304500,1000,0.00252793,0,0,0,0,0
"92610",46305000,1000,0.00265086,0,1,0,0,1
"92611",46305500,1000,0.00265767,0,1,0,0,1
"92612",46306000,1000,0.00258732,0,0,0,2,2
"92613",46306500,1000,0.00294668,0,0,3,4,7
"92614",46307000,1000,0.00294053,0,0,3,3,6
"92615",46307500,1000,0.00276338,0,0,0,3,3
"92616",46308000,1000,0.00277144,0,0,0,2,2
"92617",46308500,1000,0.00252748,0,0,0,0,0
"92618",46309000,1000,0.00239671,0,0,0,0,0
"92619",46309500,1000,0.00250702,0,0,0,0,0
"92620",46310000,1000,0.00261478,0,0,0,0,0
"92621",46310500,1000,0.00263263,0,0,0,0,0
"92622",46311000,1000,0.00269868,0,0,0,1,1
"92623",46311500,1000,0.0027019,0,0,0,1,1
"92624",46312000,1000,0.00268319,0,0,0,0,0
"92625",46312500,1000,0.00272727,0,0,0,2,2
"92626",46313000,1000,0.00263774,0,0,0,2,2
"92627",46313500,1000,0.00256651,0,0,0,0,0
"92628",46314000,1000,0.00256772,0,0,0,1,1
"92629",46314500,1000,0.00255607,0,0,0,2,2
"92630",46315000,1000,0.00257499,0,0,0,1,1
"92631",46315500,1000,0.0026032,0,0,0,1,1
"92632",46316000,1000,0.00274571,0,0,1,1,2
"92633",46316500,1000,0.0027402,0,0,1,0,1
"92634",46317000,1000,0.00267725,0,0,0,0,0
"92635",46317500,1000,0.00267941,0,0,0,0,0
"92636",46318000,1000,0.00262711,0,0,0,1,1
"92637",46318500,1000,0.00266235,0,0,0,1,1
"92638",46319000,1000,0.00255503,0,0,0,0,0
"92639",46319500,1000,0.00273531,0,0,1,2,3
"92640",46320000,1000,0.00290847,0,0,1,3,4
"92641",46320500,1000,0.00258984,0,0,0,2,2
"92642",46321000,1000,0.00247869,0,0,0,1,1
"92643",46321500,1000,0.00258707,0,0,0,1,1
"92644",46322000,1000,0.00258446,0,0,1,1,2
"92645",46322500,1000,0.00252332,0,0,1,0,1
"92646",46323000,1000,0.00254058,0,0,0,0,0
"92647",46323500,1000,0.00267667,0,0,1,0,1
"92648",46324000,1000,0.0027208,0,0,1,0,1
"92649",46324500,1000,0.00262514,0,0,0,1,1
"92650",46325000,1000,0.00278919,0,0,2,1,3
"92651",46325500,1000,0.00270904,0,0,2,0,2
"92652",46326000,1000,0.00262467,0,0,0,1,1
"92653",46326500,1000,0.00273478,0,0,0,2,2
"92654",46327000,1000,0.0026652,0,0,0,2,2
"92655",46327500,1000,0.00254544,0,0,0,2,2
"92656",46328000,1000,0.00253518,0,0,0,2,2
"92657",46328500,1000,0.00262032,0,0,0,2,2
"92658",46329000,1000,0.00256692,0,0,0,1,1
"92659",46329500,1000,0.00260297,0,0,0,1,1
"92660",46330000,1000,0.00266983,0,0,0,1,1
"92661",46330500,1000,0.00267422,0,0,0,0,0
"92662",46331000,1000,0.00278044,0,0,1,1,2
"92663",46331500,1000,0.00293715,0,0,2,1,3
"92664",46332000,1000,0.00280816,0,0,1,1,2
"92665",46332500,1000,0.00265421,0,0,0,2,2
"92666",46333000,1000,0.00269796,0,0,0,1,1
"92667",46333500,1000,0.00266579,0,0,0,0,0
"92668",46334000,1000,0.00257445,0,0,0,0,0
"92669",46334500,1000,0.00260136,0,0,0,0,0
"92670",46335000,1000,0.00266508,0,0,0,1,1
"92671",46335500,1000,0.00265428,0,0,0,2,2
"92672",46336000,1000,0.00265705,0,0,0,1,1
"92673",46336500,1000,0.00263757,0,0,0,0,0
"92674",46337000,1000,0.00262944,0,0,0,0,0
"92675",46337500,1000,0.00264237,0,0,0,0,0
"92676",46338000,1000,0.00266186,0,0,0,0,0
"92677",46338500,1000,0.00278516,0,0,0,2,2
"92678",46339000,1000,0.00266783,0,0,0,2,2
"92679",46339500,1000,0.00268417,0,0,0,0,0
"92680",46340000,1000,0.00287356,0,0,1,1,2
"92681",46340500,1000,0.00281034,0,0,1,2,3
"92682",46341000,1000,0.00277027,0,0,0,2,2
"92683",46341500,1000,0.00265134,0,0,0,1,1
"92684",46342000,1000,0.00270069,0,0,0,3,3
"92685",46342500,1000,0.00272681,0,0,0,3,3
"92686",46343000,1000,0.0025978,0,0,0,0,0
"92687",46343500,1000,0.00261379,0,0,0,2,2
"92688",46344000,1000,0.00275211,0,0,1,2,3
"92689",46344500,1000,0.00269633,0,0,1,0,1
"92690",46345000,1000,0.00261654,0,0,0,1,1
"92691",46345500,1000,0.00267217,0,0,0,1,1
"92692",46346000,1000,0.00265992,0,0,0,0,0
"92693",46346500,1000,0.00277271,0,0,0,1,1
"92694",46347000,1000,0.00268335,0,0,0,1,1
"92695",46347500,1000,0.00264567,0,0,1,0,1
"92696",46348000,1000,0.00263521,0,0,1,0,1
"92697",46348500,1000,0.00256525,0,0,0,0,0
"92698",46349000,1000,0.0026417,0,0,0,0,0
"92699",46349500,1000,0.00270741,0,0,1,1,2
"92700",46350000,1000,0.00263721,0,0,1,1,2
"92701",46350500,1000,0.0025945,0,0,0,1,1
"92702",46351000,1000,0.00271128,0,0,1,2,3
"92703",46351500,1000,0.00257528,0,0,1,1,2
"92704",46352000,1000,0.00252522,0,0,0,0,0
"92705",46352500,1000,0.00262737,0,0,0,0,0
"92706",46353000,1000,0.00263091,0,0,0,0,0
"92707",46353500,1000,0.00278261,0,0,1,1,2
"92708",46354000,1000,0.00280233,0,0,1,1,2
"92709",46354500,1000,0.00262271,0,0,0,1,1
"92710",46355000,1000,0.00247031,0,0,0,1,1
"92711",46355500,1000,0.00253884,0,0,1,1,2
"92712",46356000,1000,0.00276682,0,0,2,2,4
"92713",46356500,1000,0.00288599,0,0,2,2,4
"92714",46357000,1000,0.00286852,0,0,1,1,2
"92715",46357500,1000,0.00275142,0,0,0,1,1
"92716",46358000,1000,0.00257993,0,0,0,1,1
"92717",46358500,1000,0.00266275,0,0,0,1,1
"92718",46359000,1000,0.00279752,0,0,0,2,2
"92719",46359500,1000,0.00269585,0,0,1,1,2
"92720",46360000,1000,0.00261134,0,0,1,0,1
"92721",46360500,1000,0.00254537,0,0,0,1,1
"92722",46361000,1000,0.00261303,0,0,1,1,2
"92723",46361500,1000,0.00260427,0,0,1,0,1
"92724",46362000,1000,0.00249075,0,0,0,0,0
"92725",46362500,1000,0.00259044,0,0,0,1,1
"92726",46363000,1000,0.00265466,0,0,0,2,2
"92727",46363500,1000,0.00260107,0,0,0,1,1
"92728",46364000,1000,0.00260555,0,0,0,0,0
"92729",46364500,1000,0.00258954,0,0,0,0,0
"92730",46365000,1000,0.00263751,0,0,1,1,2
"92731",46365500,1000,0.00270875,0,0,2,2,4
"92732",46366000,1000,0.00267024,0,0,1,1,2
"92733",46366500,1000,0.00259277,0,0,0,0,0
"92734",46367000,1000,0.00272088,0,0,1,1,2
"92735",46367500,1000,0.0027002,0,0,1,1,2
"92736",46368000,1000,0.0030161,0,2,0,0,2
"92737",46368500,1000,0.00303507,0,2,0,0,2
"92738",46369000,1000,0.00268603,0,0,0,0,0
"92739",46369500,1000,0.0028411,0,0,1,1,2
"92740",46370000,1000,0.0029153,0,0,1,5,6
"92741",46370500,1000,0.00295133,0,0,1,5,6
"92742",46371000,1000,0.00276529,0,0,1,1,2
"92743",46371500,1000,0.00282371,0,1,1,0,2
"92744",46372000,1000,0.00274616,0,1,1,0,2
"92745",46372500,1000,0.00240339,0,0,0,0,0
"92746",46373000,1000,0.00249884,0,0,0,1,1
"92747",46373500,1000,0.00268814,0,0,0,3,3
"92748",46374000,1000,0.00270022,0,0,0,2,2
"92749",46374500,1000,0.00258805,0,0,0,0,0
"92750",46375000,1000,0.00258567,0,0,0,0,0
"92751",46375500,1000,0.00286528,0,0,1,3,4
"92752",46376000,1000,0.00279481,0,0,1,3,4
"92753",46376500,1000,0.00258167,0,0,0,0,0
"92754",46377000,1000,0.00264745,0,0,0,0,0
"92755",46377500,1000,0.0026367,0,0,0,1,1
"92756",46378000,1000,0.00260042,0,0,0,1,1
"92757",46378500,1000,0.00263113,0,0,0,0,0
"92758",46379000,1000,0.00255613,0,0,0,0,0
"92759",46379500,1000,0.0025455,0,0,0,0,0
"92760",46380000,1000,0.00273651,0,0,1,2,3
"92761",46380500,1000,0.0028059,0,0,2,3,5
"92762",46381000,1000,0.00265116,0,0,1,1,2
"92763",46381500,1000,0.00247587,0,0,0,0,0
"92764",46382000,1000,0.00259792,0,0,0,1,1
"92765",46382500,1000,0.00267243,0,0,0,1,1
"92766",46383000,1000,0.00263373,0,0,0,0,0
"92767",46383500,1000,0.00251965,0,0,0,0,0
"92768",46384000,1000,0.00246205,0,0,0,0,0
"92769",46384500,1000,0.00261762,0,0,0,1,1
"92770",46385000,1000,0.00263794,0,0,0,1,1
"92771",46385500,1000,0.0025826,0,0,0,0,0
"92772",46386000,1000,0.00282934,0,1,0,1,2
"92773",46386500,1000,0.00292461,0,2,0,1,3
"92774",46387000,1000,0.00263357,0,1,0,0,1
"92775",46387500,1000,0.00262453,0,0,0,2,2
"92776",46388000,1000,0.00266214,0,0,0,2,2
"92777",46388500,1000,0.00260458,0,0,0,2,2
"92778",46389000,1000,0.00262056,0,0,0,2,2
"92779",46389500,1000,0.0025703,0,0,0,0,0
"92780",46390000,1000,0.00267682,0,0,1,1,2
"92781",46390500,1000,0.0026629,0,0,1,1,2
"92782",46391000,1000,0.00266826,0,0,0,1,1
"92783",46391500,1000,0.00270738,0,0,1,1,2
"92784",46392000,1000,0.00251056,0,0,1,0,1
"92785",46392500,1000,0.00252093,0,0,0,1,1
"92786",46393000,1000,0.00256526,0,0,0,1,1
"92787",46393500,1000,0.00249679,0,0,0,0,0
"92788",46394000,1000,0.00256207,0,0,1,0,1
"92789",46394500,1000,0.00268086,0,0,1,1,2
"92790",46395000,1000,0.00275906,0,0,1,1,2
"92791",46395500,1000,0.00282818,0,0,2,1,3
"92792",46396000,1000,0.00277664,0,0,1,2,3
"92793",46396500,1000,0.00270948,0,0,0,1,1
"92794",46397000,1000,0.0027634,0,1,0,0,1
"92795",46397500,1000,0.00280344,0,1,1,1,3
"92796",46398000,1000,0.00259331,0,0,1,1,2
"92797",46398500,1000,0.00251019,0,0,0,1,1
"92798",46399000,1000,0.00249615,0,0,0,1,1
"92799",46399500,1000,0.00246801,0,0,0,0,0
"92800",46400000,1000,0.00271773,0,0,0,0,0
"92801",46400500,1000,0.00282047,0,0,1,2,3
"92802",46401000,1000,0.00269758,0,0,1,2,3
"92803",46401500,1000,0.0026889,0,0,0,1,1
"92804",46402000,1000,0.00255845,0,0,0,1,1
"92805",46402500,1000,0.00244243,0,0,0,1,1
"92806",46403000,1000,0.00256159,0,0,0,2,2
"92807",46403500,1000,0.00269996,0,0,1,2,3
"92808",46404000,1000,0.00265275,0,0,1,1,2
"92809",46404500,1000,0.00263925,0,0,1,2,3
"92810",46405000,1000,0.00266719,0,0,1,2,3
"92811",46405500,1000,0.00259883,0,0,0,2,2
"92812",46406000,1000,0.00256547,0,0,0,2,2
"92813",46406500,1000,0.00252072,0,0,0,0,0
"92814",46407000,1000,0.00258328,0,0,0,0,0
"92815",46407500,1000,0.002627,0,0,0,0,0
"92816",46408000,1000,0.00263811,0,0,0,0,0
"92817",46408500,1000,0.00260151,0,0,0,0,0
"92818",46409000,1000,0.00264561,0,0,0,0,0
"92819",46409500,1000,0.00262635,0,0,0,0,0
"92820",46410000,1000,0.00267686,0,0,0,1,1
"92821",46410500,1000,0.00273199,0,0,0,1,1
"92822",46411000,1000,0.00262756,0,0,0,0,0
"92823",46411500,1000,0.00267552,0,0,0,0,0
"92824",46412000,1000,0.00271121,0,0,0,0,0
"92825",46412500,1000,0.00270808,0,0,1,0,1
"92826",46413000,1000,0.00266685,0,0,1,1,2
"92827",46413500,1000,0.00265945,0,0,1,1,2
"92828",46414000,1000,0.00261206,0,0,1,0,1
"92829",46414500,1000,0.00248347,0,0,0,0,0
"92830",46415000,1000,0.00265076,0,0,1,0,1
"92831",46415500,1000,0.00276161,0,0,1,2,3
"92832",46416000,1000,0.0025974,0,0,0,2,2
"92833",46416500,1000,0.00262769,0,0,1,1,2
"92834",46417000,1000,0.00274632,0,0,1,1,2
"92835",46417500,1000,0.00264812,0,0,0,0,0
"92836",46418000,1000,0.00252432,0,0,0,0,0
"92837",46418500,1000,0.0025347,0,0,0,0,0
"92838",46419000,1000,0.00255539,0,0,0,2,2
"92839",46419500,1000,0.00257099,0,0,0,2,2
"92840",46420000,1000,0.00263049,0,0,0,1,1
"92841",46420500,1000,0.0026327,0,0,0,1,1
"92842",46421000,1000,0.00266911,0,0,1,0,1
"92843",46421500,1000,0.0026927,0,0,1,0,1
"92844",46422000,1000,0.00259597,0,0,0,0,0
"92845",46422500,1000,0.00247012,0,0,0,0,0
"92846",46423000,1000,0.00253089,0,0,0,0,0
"92847",46423500,1000,0.0027024,0,0,0,1,1
"92848",46424000,1000,0.0026102,0,0,0,1,1
"92849",46424500,1000,0.0023966,0,0,0,0,0
"92850",46425000,1000,0.00245805,0,0,0,0,0
"92851",46425500,1000,0.00248178,0,0,0,1,1
"92852",46426000,1000,0.00240357,0,0,0,1,1
"92853",46426500,1000,0.00242407,0,0,0,0,0
"92854",46427000,1000,0.00263437,0,0,1,0,1
"92855",46427500,1000,0.00258211,0,0,1,0,1
"92856",46428000,1000,0.00233619,0,0,0,0,0
"92857",46428500,1000,0.00253999,0,0,1,1,2
"92858",46429000,1000,0.00258087,0,0,1,2,3
"92859",46429500,1000,0.00259142,0,0,0,1,1
"92860",46430000,1000,0.00268203,0,0,0,0,0
"92861",46430500,1000,0.00268844,0,0,0,2,2
"92862",46431000,1000,0.0026528,0,0,0,3,3
"92863",46431500,1000,0.00258243,0,0,0,2,2
"92864",46432000,1000,0.00261641,0,0,0,1,1
"92865",46432500,1000,0.00268483,0,0,0,0,0
"92866",46433000,1000,0.00279047,0,0,0,1,1
"92867",46433500,1000,0.0027008,0,0,0,2,2
"92868",46434000,1000,0.00266202,0,0,1,1,2
"92869",46434500,1000,0.00265644,0,0,1,0,1
"92870",46435000,1000,0.0025245,0,0,0,0,0
"92871",46435500,1000,0.00259993,0,0,1,0,1
"92872",46436000,1000,0.00270521,0,0,1,1,2
"92873",46436500,1000,0.00256463,0,0,0,1,1
"92874",46437000,1000,0.00237333,0,0,0,0,0
"92875",46437500,1000,0.00248953,0,0,0,0,0
"92876",46438000,1000,0.00258091,0,0,0,0,0
"92877",46438500,1000,0.00252518,0,0,0,0,0
"92878",46439000,1000,0.00252234,0,0,0,0,0
"92879",46439500,1000,0.0025073,0,0,0,0,0
"92880",46440000,1000,0.00252815,0,0,0,0,0
"92881",46440500,1000,0.00266756,0,0,0,1,1
"92882",46441000,1000,0.00261377,0,0,0,1,1
"92883",46441500,1000,0.00244422,0,0,0,0,0
"92884",46442000,1000,0.00252546,0,0,0,0,0
"92885",46442500,1000,0.00258594,0,0,0,0,0
"92886",46443000,1000,0.00265032,0,0,0,2,2
"92887",46443500,1000,0.0026143,0,0,0,2,2
"92888",46444000,1000,0.00278751,0,0,2,3,5
"92889",46444500,1000,0.00289433,0,0,2,4,6
"92890",46445000,1000,0.00261926,0,0,0,1,1
"92891",46445500,1000,0.00253713,0,0,0,0,0
"92892",46446000,1000,0.00263623,0,0,0,0,0
"92893",46446500,1000,0.00267932,0,0,0,1,1
"92894",46447000,1000,0.00265099,0,0,0,2,2
"92895",46447500,1000,0.00259987,0,0,0,1,1
"92896",46448000,1000,0.00263995,0,0,1,0,1
"92897",46448500,1000,0.00266131,0,0,1,0,1
"92898",46449000,1000,0.00261585,0,0,0,0,0
"92899",46449500,1000,0.00251915,0,0,0,0,0
"92900",46450000,1000,0.00256376,0,0,0,0,0
"92901",46450500,1000,0.00290522,0,1,0,0,1
"92902",46451000,1000,0.00287834,0,1,1,1,3
"92903",46451500,1000,0.00283187,0,0,2,4,6
"92904",46452000,1000,0.00286259,0,0,1,5,6
"92905",46452500,1000,0.00280582,0,0,0,4,4
"92906",46453000,1000,0.00274256,0,0,0,2,2
"92907",46453500,1000,0.00250124,0,0,0,0,0
"92908",46454000,1000,0.00239131,0,0,0,0,0
"92909",46454500,1000,0.0025229,0,0,0,0,0
"92910",46455000,1000,0.00269532,0,0,0,0,0
"92911",46455500,1000,0.00264145,0,0,0,0,0
"92912",46456000,1000,0.00248868,0,0,0,0,0
"92913",46456500,1000,0.00257181,0,0,0,0,0
"92914",46457000,1000,0.00269961,0,0,0,1,1
"92915",46457500,1000,0.00265279,0,0,0,1,1
"92916",46458000,1000,0.00250215,0,0,0,0,0
"92917",46458500,1000,0.00252141,0,0,0,0,0
"92918",46459000,1000,0.00257018,0,0,0,0,0
"92919",46459500,1000,0.00255862,0,0,0,0,0
"92920",46460000,1000,0.00271091,0,0,1,0,1
"92921",46460500,1000,0.00264422,0,0,1,0,1
"92922",46461000,1000,0.00252704,0,0,1,0,1
"92923",46461500,1000,0.00251296,0,0,1,0,1
"92924",46462000,1000,0.00247959,0,0,0,0,0
"92925",46462500,1000,0.00245278,0,0,0,0,0
"92926",46463000,1000,0.0024799,0,0,0,0,0
"92927",46463500,1000,0.00260046,0,0,0,1,1
"92928",46464000,1000,0.00259865,0,0,0,1,1
"92929",46464500,1000,0.00261517,0,0,0,0,0
"92930",46465000,1000,0.00272006,0,0,0,1,1
"92931",46465500,1000,0.00268846,0,0,0,1,1
"92932",46466000,1000,0.00266782,0,0,0,0,0
"92933",46466500,1000,0.00262413,0,0,0,0,0
"92934",46467000,1000,0.00239769,0,0,0,0,0
"92935",46467500,1000,0.00248797,0,0,0,1,1
"92936",46468000,1000,0.00265029,0,0,0,1,1
"92937",46468500,1000,0.00247405,0,0,0,0,0
"92938",46469000,1000,0.00253308,0,0,0,2,2
"92939",46469500,1000,0.00261263,0,0,0,3,3
"92940",46470000,1000,0.00251797,0,0,0,1,1
"92941",46470500,1000,0.00253918,0,0,0,1,1
"92942",46471000,1000,0.00252422,0,0,0,2,2
"92943",46471500,1000,0.00246036,0,0,0,1,1
"92944",46472000,1000,0.00250254,0,0,0,1,1
"92945",46472500,1000,0.00266823,0,0,1,2,3
"92946",46473000,1000,0.00266209,0,0,1,2,3
"92947",46473500,1000,0.00272748,0,0,1,2,3
"92948",46474000,1000,0.00276562,0,0,2,2,4
"92949",46474500,1000,0.00257004,0,0,1,1,2
"92950",46475000,1000,0.00261039,0,0,0,1,1
"92951",46475500,1000,0.00263528,0,0,0,2,2
"92952",46476000,1000,0.0026166,0,0,0,1,1
"92953",46476500,1000,0.00279332,0,0,1,0,1
"92954",46477000,1000,0.00299357,0,0,3,1,4
"92955",46477500,1000,0.00280086,0,0,2,1,3
"92956",46478000,1000,0.00252507,0,0,0,0,0
"92957",46478500,1000,0.00255658,0,0,0,0,0
"92958",46479000,1000,0.00259365,0,0,0,0,0
"92959",46479500,1000,0.00262313,0,0,0,1,1
"92960",46480000,1000,0.00270269,0,0,1,2,3
"92961",46480500,1000,0.00269582,0,0,2,1,3
"92962",46481000,1000,0.00256615,0,0,1,0,1
"92963",46481500,1000,0.00270622,0,0,1,2,3
"92964",46482000,1000,0.00267696,0,0,1,2,3
"92965",46482500,1000,0.00246243,0,0,0,0,0
"92966",46483000,1000,0.00259326,0,0,1,0,1
"92967",46483500,1000,0.0027013,0,0,2,1,3
"92968",46484000,1000,0.00279233,0,0,1,4,5
"92969",46484500,1000,0.00265821,0,0,0,3,3
"92970",46485000,1000,0.00251315,0,0,0,0,0
"92971",46485500,1000,0.00264244,0,0,0,2,2
"92972",46486000,1000,0.0025978,0,0,0,2,2
"92973",46486500,1000,0.00249822,0,0,0,0,0
"92974",46487000,1000,0.00251946,0,0,0,0,0
"92975",46487500,1000,0.00253628,0,0,0,0,0
"92976",46488000,1000,0.00273304,0,0,1,1,2
"92977",46488500,1000,0.00273163,0,0,1,1,2
"92978",46489000,1000,0.00262503,0,0,1,1,2
"92979",46489500,1000,0.00279837,0,0,1,3,4
"92980",46490000,1000,0.00274847,0,0,0,2,2
"92981",46490500,1000,0.00252983,0,0,0,0,0
"92982",46491000,1000,0.00250106,0,0,0,1,1
"92983",46491500,1000,0.00249399,0,0,0,1,1
"92984",46492000,1000,0.00252756,0,0,0,2,2
"92985",46492500,1000,0.00275227,0,1,0,2,3
"92986",46493000,1000,0.00264226,0,1,0,0,1
"92987",46493500,1000,0.00258593,0,0,0,2,2
"92988",46494000,1000,0.00277226,0,0,1,3,4
"92989",46494500,1000,0.00262497,0,0,1,1,2
"92990",46495000,1000,0.0025549,0,0,0,0,0
"92991",46495500,1000,0.00265466,0,0,1,2,3
"92992",46496000,1000,0.00276159,0,0,2,3,5
"92993",46496500,1000,0.00267899,0,0,1,1,2
"92994",46497000,1000,0.00243852,0,0,0,0,0
"92995",46497500,1000,0.00252086,0,0,0,1,1
"92996",46498000,1000,0.00268582,0,0,0,2,2
"92997",46498500,1000,0.00262713,0,0,0,1,1
"92998",46499000,1000,0.00259223,0,0,1,0,1
"92999",46499500,1000,0.00259731,0,0,1,1,2
"93000",46500000,1000,0.00253563,0,0,0,1,1
"93001",46500500,1000,0.0025891,0,0,0,1,1
"93002",46501000,1000,0.00279094,0,0,1,3,4
"93003",46501500,1000,0.00278666,0,0,1,2,3
"93004",46502000,1000,0.00264776,0,0,0,0,0
"93005",46502500,1000,0.00277666,0,0,1,1,2
"93006",46503000,1000,0.00274793,0,0,1,2,3
"93007",46503500,1000,0.00276069,0,1,0,1,2
"93008",46504000,1000,0.00279494,0,1,0,1,2
"93009",46504500,1000,0.00256775,0,0,0,1,1
"93010",46505000,1000,0.00264165,0,0,1,1,2
"93011",46505500,1000,0.00272442,0,0,1,2,3
"93012",46506000,1000,0.0026628,0,0,0,2,2
"93013",46506500,1000,0.00274651,0,0,0,3,3
"93014",46507000,1000,0.00266531,0,0,0,2,2
"93015",46507500,1000,0.00255802,0,0,1,0,1
"93016",46508000,1000,0.00263354,0,0,1,0,1
"93017",46508500,1000,0.00264298,0,0,0,1,1
"93018",46509000,1000,0.00271053,0,0,0,2,2
"93019",46509500,1000,0.00279887,0,0,0,3,3
"93020",46510000,1000,0.00264414,0,0,0,2,2
"93021",46510500,1000,0.00255474,0,0,0,1,1
"93022",46511000,1000,0.00251549,0,0,0,1,1
"93023",46511500,1000,0.00262643,0,0,1,0,1
"93024",46512000,1000,0.00274499,0,0,1,1,2
"93025",46512500,1000,0.00266811,0,0,0,1,1
"93026",46513000,1000,0.002749,0,0,0,0,0
"93027",46513500,1000,0.00302958,0,0,1,1,2
"93028",46514000,1000,0.00319171,0,0,2,2,4
"93029",46514500,1000,0.00315843,0,0,1,3,4
"93030",46515000,1000,0.00307203,0,0,0,2,2
"93031",46515500,1000,0.00284475,0,0,0,2,2
"93032",46516000,1000,0.00273285,0,0,0,4,4
"93033",46516500,1000,0.00262978,0,0,0,2,2
"93034",46517000,1000,0.00246998,0,0,0,0,0
"93035",46517500,1000,0.00248423,0,0,0,1,1
"93036",46518000,1000,0.0024938,0,0,0,1,1
"93037",46518500,1000,0.00253464,0,0,0,2,2
"93038",46519000,1000,0.00258959,0,0,0,2,2
"93039",46519500,1000,0.00260242,0,0,0,1,1
"93040",46520000,1000,0.00261814,0,0,0,1,1
"93041",46520500,1000,0.0025843,0,0,1,0,1
"93042",46521000,1000,0.00251697,0,0,1,0,1
"93043",46521500,1000,0.00255287,0,0,0,0,0
"93044",46522000,1000,0.00257663,0,0,0,0,0
"93045",46522500,1000,0.00269964,0,1,0,0,1
"93046",46523000,1000,0.00267701,0,1,0,0,1
"93047",46523500,1000,0.00249513,0,0,0,0,0
"93048",46524000,1000,0.00287981,0,0,2,4,6
"93049",46524500,1000,0.00302569,0,0,3,5,8
"93050",46525000,1000,0.00282863,0,0,1,3,4
"93051",46525500,1000,0.00281085,0,0,0,2,2
"93052",46526000,1000,0.00260642,0,0,0,0,0
"93053",46526500,1000,0.00240336,0,0,0,0,0
"93054",46527000,1000,0.00247897,0,0,0,0,0
"93055",46527500,1000,0.00255604,0,0,0,0,0
"93056",46528000,1000,0.00261958,0,0,0,0,0
"93057",46528500,1000,0.00273924,0,0,0,1,1
"93058",46529000,1000,0.00273082,0,0,0,1,1
"93059",46529500,1000,0.00270948,0,0,0,0,0
"93060",46530000,1000,0.00265464,0,0,0,1,1
"93061",46530500,1000,0.00253792,0,0,0,1,1
"93062",46531000,1000,0.00255546,0,0,0,0,0
"93063",46531500,1000,0.00260299,0,0,0,1,1
"93064",46532000,1000,0.00254647,0,0,0,2,2
"93065",46532500,1000,0.00256218,0,0,0,1,1
"93066",46533000,1000,0.00263908,0,0,0,1,1
"93067",46533500,1000,0.00273051,0,0,1,1,2
"93068",46534000,1000,0.00270974,0,0,1,0,1
"93069",46534500,1000,0.00261625,0,0,0,0,0
"93070",46535000,1000,0.00267115,0,0,0,0,0
"93071",46535500,1000,0.00271791,0,0,0,1,1
"93072",46536000,1000,0.00263926,0,0,0,1,1
"93073",46536500,1000,0.00263095,0,0,0,0,0
"93074",46537000,1000,0.00265156,0,0,1,0,1
"93075",46537500,1000,0.00270163,0,0,1,2,3
"93076",46538000,1000,0.00275627,0,0,0,3,3
"93077",46538500,1000,0.00258303,0,0,0,2,2
"93078",46539000,1000,0.00248092,0,0,0,1,1
"93079",46539500,1000,0.00268669,0,0,1,1,2
"93080",46540000,1000,0.00262143,0,0,1,1,2
"93081",46540500,1000,0.00240171,0,0,0,0,0
"93082",46541000,1000,0.00263431,0,0,1,0,1
"93083",46541500,1000,0.00271883,0,0,1,0,1
"93084",46542000,1000,0.00263688,0,0,0,1,1
"93085",46542500,1000,0.00270392,0,0,1,1,2
"93086",46543000,1000,0.00271713,0,0,2,0,2
"93087",46543500,1000,0.00267443,0,0,1,1,2
"93088",46544000,1000,0.00271741,0,0,0,2,2
"93089",46544500,1000,0.00267705,0,0,0,1,1
"93090",46545000,1000,0.00253214,0,0,0,1,1
"93091",46545500,1000,0.00253654,0,0,0,2,2
"93092",46546000,1000,0.00254254,0,0,0,2,2
"93093",46546500,1000,0.00263477,0,0,0,2,2
"93094",46547000,1000,0.00268116,0,0,0,2,2
"93095",46547500,1000,0.0026476,0,0,0,1,1
"93096",46548000,1000,0.0026656,0,0,0,0,0
"93097",46548500,1000,0.00266127,0,0,0,1,1
"93098",46549000,1000,0.00270899,0,0,1,1,2
"93099",46549500,1000,0.00285628,0,0,2,0,2
"93100",46550000,1000,0.00277876,0,0,1,2,3
"93101",46550500,1000,0.00267622,0,0,0,2,2
"93102",46551000,1000,0.00274165,0,0,0,0,0
"93103",46551500,1000,0.00264166,0,0,0,0,0
"93104",46552000,1000,0.00255261,0,0,0,0,0
"93105",46552500,1000,0.00262802,0,0,0,0,0
"93106",46553000,1000,0.00268907,0,0,0,2,2
"93107",46553500,1000,0.00261759,0,0,0,2,2
"93108",46554000,1000,0.00257657,0,0,0,0,0
"93109",46554500,1000,0.0026385,0,0,0,0,0
"93110",46555000,1000,0.002705,0,0,0,0,0
"93111",46555500,1000,0.00269885,0,0,0,0,0
"93112",46556000,1000,0.00271405,0,0,0,1,1
"93113",46556500,1000,0.00273195,0,0,0,2,2
"93114",46557000,1000,0.0026386,0,0,0,1,1
"93115",46557500,1000,0.00267037,0,0,0,0,0
"93116",46558000,1000,0.00284346,0,0,1,1,2
"93117",46558500,1000,0.00279396,0,0,1,2,3
"93118",46559000,1000,0.0027534,0,0,0,2,2
"93119",46559500,1000,0.00265233,0,0,0,1,1
"93120",46560000,1000,0.00269067,0,0,0,3,3
"93121",46560500,1000,0.0027804,0,0,0,3,3
"93122",46561000,1000,0.00259119,0,0,0,0,0
"93123",46561500,1000,0.00254058,0,0,0,2,2
"93124",46562000,1000,0.00276255,0,0,1,2,3
"93125",46562500,1000,0.00270898,0,0,1,0,1
"93126",46563000,1000,0.00259952,0,0,0,1,1
"93127",46563500,1000,0.00269612,0,0,0,1,1
"93128",46564000,1000,0.00267755,0,0,0,0,0
"93129",46564500,1000,0.00273104,0,0,0,1,1
"93130",46565000,1000,0.00266191,0,0,0,1,1
"93131",46565500,1000,0.00268304,0,0,1,0,1
"93132",46566000,1000,0.00265101,0,0,1,0,1
"93133",46566500,1000,0.00255226,0,0,0,0,0
"93134",46567000,1000,0.00275922,0,0,1,1,2
"93135",46567500,1000,0.00270449,0,0,1,1,2
"93136",46568000,1000,0.00247447,0,0,0,0,0
"93137",46568500,1000,0.00258119,0,0,0,1,1
"93138",46569000,1000,0.0027311,0,0,1,2,3
"93139",46569500,1000,0.00263472,0,0,1,1,2
"93140",46570000,1000,0.00255217,0,0,0,0,0
"93141",46570500,1000,0.00257558,0,0,0,0,0
"93142",46571000,1000,0.00259714,0,0,0,0,0
"93143",46571500,1000,0.002803,0,0,1,1,2
"93144",46572000,1000,0.00284654,0,0,1,1,2
"93145",46572500,1000,0.00260544,0,0,0,1,1
"93146",46573000,1000,0.00243269,0,0,0,1,1
"93147",46573500,1000,0.00260095,0,0,1,1,2
"93148",46574000,1000,0.00280519,0,0,2,2,4
"93149",46574500,1000,0.00290979,0,0,2,2,4
"93150",46575000,1000,0.00289256,0,0,1,1,2
"93151",46575500,1000,0.00269898,0,0,0,1,1
"93152",46576000,1000,0.00256693,0,0,0,1,1
"93153",46576500,1000,0.00266153,0,0,0,1,1
"93154",46577000,1000,0.00276628,0,0,0,2,2
"93155",46577500,1000,0.00269165,0,0,1,1,2
"93156",46578000,1000,0.00263608,0,0,1,1,2
"93157",46578500,1000,0.00253081,0,0,0,1,1
"93158",46579000,1000,0.00257798,0,0,1,0,1
"93159",46579500,1000,0.00259968,0,0,1,0,1
"93160",46580000,1000,0.00257138,0,0,0,1,1
"93161",46580500,1000,0.00257792,0,0,0,1,1
"93162",46581000,1000,0.0025776,0,0,0,1,1
"93163",46581500,1000,0.00263285,0,0,0,1,1
"93164",46582000,1000,0.00265215,0,0,0,0,0
"93165",46582500,1000,0.0025765,0,0,0,0,0
"93166",46583000,1000,0.00258743,0,0,1,1,2
"93167",46583500,1000,0.00266609,0,0,2,2,4
"93168",46584000,1000,0.00268425,0,0,1,1,2
"93169",46584500,1000,0.00265908,0,0,0,0,0
"93170",46585000,1000,0.0027308,0,0,1,1,2
"93171",46585500,1000,0.00268194,0,0,1,1,2
"93172",46586000,1000,0.00301227,0,2,0,0,2
"93173",46586500,1000,0.00305504,0,2,0,0,2
"93174",46587000,1000,0.00277513,0,0,1,0,1
"93175",46587500,1000,0.00287091,0,0,1,2,3
"93176",46588000,1000,0.00284916,0,0,0,6,6
"93177",46588500,1000,0.00292865,0,0,1,4,5
"93178",46589000,1000,0.00275257,0,0,1,0,1
"93179",46589500,1000,0.00280481,0,1,1,0,2
"93180",46590000,1000,0.002751,0,1,1,0,2
"93181",46590500,1000,0.00245027,0,0,0,1,1
"93182",46591000,1000,0.00247961,0,0,0,1,1
"93183",46591500,1000,0.00266993,0,0,0,2,2
"93184",46592000,1000,0.00270382,0,0,0,2,2
"93185",46592500,1000,0.00257008,0,0,0,0,0
"93186",46593000,1000,0.00277989,0,0,1,2,3
"93187",46593500,1000,0.00287471,0,0,1,3,4
"93188",46594000,1000,0.00261131,0,0,0,1,1
"93189",46594500,1000,0.0025794,0,0,0,0,0
"93190",46595000,1000,0.00262882,0,0,0,0,0
"93191",46595500,1000,0.00262724,0,0,0,1,1
"93192",46596000,1000,0.00264883,0,0,0,1,1
"93193",46596500,1000,0.00267013,0,0,0,0,0
"93194",46597000,1000,0.00255804,0,0,0,0,0
"93195",46597500,1000,0.00249824,0,0,0,0,0
"93196",46598000,1000,0.00272777,0,0,1,2,3
"93197",46598500,1000,0.0027256,0,0,1,2,3
"93198",46599000,1000,0.00253923,0,0,0,0,0
"93199",46599500,1000,0.00252433,0,0,0,0,0
"93200",46600000,1000,0.00269323,0,0,0,1,1
"93201",46600500,1000,0.00267343,0,0,0,1,1
"93202",46601000,1000,0.00249524,0,0,0,0,0
"93203",46601500,1000,0.00247886,0,0,0,0,0
"93204",46602000,1000,0.00263327,0,0,0,1,1
"93205",46602500,1000,0.00258511,0,0,0,1,1
"93206",46603000,1000,0.00256,0,0,0,0,0
"93207",46603500,1000,0.00289676,0,1,0,1,2
"93208",46604000,1000,0.00293164,0,2,0,1,3
"93209",46604500,1000,0.00262351,0,1,0,0,1
"93210",46605000,1000,0.00261779,0,0,0,2,2
"93211",46605500,1000,0.00264619,0,0,0,2,2
"93212",46606000,1000,0.00250578,0,0,0,1,1
"93213",46606500,1000,0.00262594,0,0,0,2,2
"93214",46607000,1000,0.00262872,0,0,0,1,1
"93215",46607500,1000,0.00252531,0,0,0,0,0
"93216",46608000,1000,0.00266854,0,0,1,1,2
"93217",46608500,1000,0.0027698,0,0,1,1,2
"93218",46609000,1000,0.00276002,0,0,1,1,2
"93219",46609500,1000,0.00259163,0,0,1,1,2
"93220",46610000,1000,0.00250321,0,0,0,1,1
"93221",46610500,1000,0.00254094,0,0,0,1,1
"93222",46611000,1000,0.0024751,0,0,0,0,0
"93223",46611500,1000,0.00258722,0,0,1,0,1
"93224",46612000,1000,0.00267666,0,0,1,1,2
"93225",46612500,1000,0.00261491,0,0,0,1,1
"93226",46613000,1000,0.00283462,0,0,2,1,3
"93227",46613500,1000,0.00290335,0,0,2,2,4
"93228",46614000,1000,0.00270601,0,0,0,1,1
"93229",46614500,1000,0.00274828,0,1,0,0,1
"93230",46615000,1000,0.00266799,0,1,0,0,1
"93231",46615500,1000,0.00260091,0,0,1,1,2
"93232",46616000,1000,0.00265309,0,0,1,2,3
"93233",46616500,1000,0.00251462,0,0,0,1,1
"93234",46617000,1000,0.00249438,0,0,0,0,0
"93235",46617500,1000,0.00267011,0,0,0,0,0
"93236",46618000,1000,0.00280215,0,0,1,2,3
"93237",46618500,1000,0.00268994,0,0,1,2,3
"93238",46619000,1000,0.00261796,0,0,0,0,0
"93239",46619500,1000,0.0026243,0,0,0,1,1
"93240",46620000,1000,0.00245243,0,0,0,1,1
"93241",46620500,1000,0.00250885,0,0,0,2,2
"93242",46621000,1000,0.00261746,0,0,0,2,2
"93243",46621500,1000,0.00264838,0,0,1,1,2
"93244",46622000,1000,0.00272316,0,0,2,2,4
"93245",46622500,1000,0.00265584,0,0,1,2,3
"93246",46623000,1000,0.0026657,0,0,0,3,3
"93247",46623500,1000,0.00257207,0,0,0,2,2
"93248",46624000,1000,0.0025181,0,0,0,0,0
"93249",46624500,1000,0.00256532,0,0,0,0,0
"93250",46625000,1000,0.0025661,0,0,0,0,0
"93251",46625500,1000,0.00270072,0,0,0,0,0
"93252",46626000,1000,0.00262369,0,0,0,0,0
"93253",46626500,1000,0.00260897,0,0,0,0,0
"93254",46627000,1000,0.00264296,0,0,0,0,0
"93255",46627500,1000,0.0026809,0,0,0,1,1
"93256",46628000,1000,0.00272096,0,0,0,1,1
"93257",46628500,1000,0.00263693,0,0,0,0,0
"93258",46629000,1000,0.00266723,0,0,0,0,0
"93259",46629500,1000,0.00266783,0,0,0,0,0
"93260",46630000,1000,0.00273027,0,0,1,0,1
"93261",46630500,1000,0.00269263,0,0,1,1,2
"93262",46631000,1000,0.00267335,0,0,1,1,2
"93263",46631500,1000,0.00261812,0,0,1,0,1
"93264",46632000,1000,0.00244646,0,0,0,0,0
"93265",46632500,1000,0.00260338,0,0,1,0,1
"93266",46633000,1000,0.00278407,0,0,1,2,3
"93267",46633500,1000,0.00263991,0,0,0,2,2
"93268",46634000,1000,0.00260132,0,0,1,1,2
"93269",46634500,1000,0.00271883,0,0,1,1,2
"93270",46635000,1000,0.00264892,0,0,0,0,0
"93271",46635500,1000,0.00258223,0,0,0,0,0
"93272",46636000,1000,0.00254092,0,0,0,0,0
"93273",46636500,1000,0.00246616,0,0,0,0,0
"93274",46637000,1000,0.00257413,0,0,0,2,2
"93275",46637500,1000,0.00269926,0,0,0,3,3
"93276",46638000,1000,0.00263903,0,0,0,1,1
"93277",46638500,1000,0.0026738,0,0,1,0,1
"93278",46639000,1000,0.00265943,0,0,1,0,1
"93279",46639500,1000,0.0026107,0,0,0,0,0
"93280",46640000,1000,0.00247688,0,0,0,0,0
"93281",46640500,1000,0.00251612,0,0,0,0,0
"93282",46641000,1000,0.00274041,0,0,0,1,1
"93283",46641500,1000,0.0026361,0,0,0,1,1
"93284",46642000,1000,0.00238567,0,0,0,0,0
"93285",46642500,1000,0.00240206,0,0,0,0,0
"93286",46643000,1000,0.00251685,0,0,0,1,1
"93287",46643500,1000,0.0024332,0,0,0,1,1
"93288",46644000,1000,0.00240834,0,0,0,0,0
"93289",46644500,1000,0.00264122,0,0,1,0,1
"93290",46645000,1000,0.0026068,0,0,1,0,1
"93291",46645500,1000,0.00232597,0,0,0,0,0
"93292",46646000,1000,0.00252874,0,0,1,1,2
"93293",46646500,1000,0.00255495,0,0,1,1,2
"93294",46647000,1000,0.00254078,0,0,0,1,1
"93295",46647500,1000,0.0027001,0,0,0,1,1
"93296",46648000,1000,0.00266267,0,0,0,1,1
"93297",46648500,1000,0.00269144,0,0,0,3,3
"93298",46649000,1000,0.00264367,0,0,0,3,3
"93299",46649500,1000,0.00258731,0,0,0,1,1
"93300",46650000,1000,0.00269892,0,0,0,0,0
"93301",46650500,1000,0.00276535,0,0,0,1,1
"93302",46651000,1000,0.00267927,0,0,0,2,2
"93303",46651500,1000,0.0027075,0,0,1,1,2
"93304",46652000,1000,0.00269133,0,0,1,0,1
"93305",46652500,1000,0.00248632,0,0,0,0,0
"93306",46653000,1000,0.00259394,0,0,1,0,1
"93307",46653500,1000,0.00272115,0,0,1,1,2
"93308",46654000,1000,0.00256034,0,0,0,1,1
"93309",46654500,1000,0.00240839,0,0,0,0,0
"93310",46655000,1000,0.0024234,0,0,0,0,0
"93311",46655500,1000,0.00258628,0,0,0,0,0
"93312",46656000,1000,0.0025976,0,0,0,0,0
"93313",46656500,1000,0.00250304,0,0,0,0,0
"93314",46657000,1000,0.00249169,0,0,0,0,0
"93315",46657500,1000,0.0025086,0,0,0,0,0
"93316",46658000,1000,0.00263225,0,0,0,1,1
"93317",46658500,1000,0.00264983,0,0,0,1,1
"93318",46659000,1000,0.00247282,0,0,0,0,0
"93319",46659500,1000,0.00250922,0,0,0,0,0
"93320",46660000,1000,0.00259837,0,0,0,0,0
"93321",46660500,1000,0.00267067,0,0,0,2,2
"93322",46661000,1000,0.00260803,0,0,0,2,2
"93323",46661500,1000,0.00264677,0,0,1,2,3
"93324",46662000,1000,0.00293367,0,0,2,5,7
"93325",46662500,1000,0.00275423,0,0,1,3,4
"93326",46663000,1000,0.00256296,0,0,0,0,0
"93327",46663500,1000,0.00258428,0,0,0,0,0
"93328",46664000,1000,0.00263222,0,0,0,1,1
"93329",46664500,1000,0.00271382,0,0,0,2,2
"93330",46665000,1000,0.00263066,0,0,0,1,1
"93331",46665500,1000,0.00254125,0,0,0,0,0
"93332",46666000,1000,0.00261645,0,0,1,0,1
"93333",46666500,1000,0.00271701,0,0,1,0,1
"93334",46667000,1000,0.002565,0,0,0,0,0
"93335",46667500,1000,0.00254187,0,0,0,0,0
"93336",46668000,1000,0.00292161,0,1,0,0,1
"93337",46668500,1000,0.00289096,0,1,0,1,2
"93338",46669000,1000,0.00275312,0,0,2,2,4
"93339",46669500,1000,0.00281031,0,0,2,3,5
"93340",46670000,1000,0.00276735,0,0,0,4,4
"93341",46670500,1000,0.00279874,0,0,0,3,3
"93342",46671000,1000,0.00260489,0,0,0,1,1
"93343",46671500,1000,0.0024101,0,0,0,0,0
"93344",46672000,1000,0.00246498,0,0,0,0,0
"93345",46672500,1000,0.00265655,0,0,0,0,0
"93346",46673000,1000,0.00265423,0,0,0,0,0
"93347",46673500,1000,0.00253093,0,0,0,0,0
"93348",46674000,1000,0.0025405,0,0,0,0,0
"93349",46674500,1000,0.00267561,0,0,0,1,1
"93350",46675000,1000,0.00271519,0,0,0,1,1
"93351",46675500,1000,0.00255472,0,0,0,0,0
"93352",46676000,1000,0.00254191,0,0,0,0,0
"93353",46676500,1000,0.00253789,0,0,0,0,0
"93354",46677000,1000,0.00245002,0,0,0,0,0
"93355",46677500,1000,0.00266195,0,0,0,0,0
"93356",46678000,1000,0.0027298,0,0,1,0,1
"93357",46678500,1000,0.00249667,0,0,1,0,1
"93358",46679000,1000,0.00249821,0,0,1,0,1
"93359",46679500,1000,0.00255955,0,0,1,0,1
"93360",46680000,1000,0.00252093,0,0,0,0,0
"93361",46680500,1000,0.00246902,0,0,0,0,0
"93362",46681000,1000,0.00259829,0,0,0,1,1
"93363",46681500,1000,0.00269331,0,0,0,1,1
"93364",46682000,1000,0.00253479,0,0,0,0,0
"93365",46682500,1000,0.00263605,0,0,0,1,1
"93366",46683000,1000,0.00274545,0,0,0,1,1
"93367",46683500,1000,0.00262486,0,0,0,0,0
"93368",46684000,1000,0.00265302,0,0,0,0,0
"93369",46684500,1000,0.00250747,0,0,0,0,0
"93370",46685000,1000,0.00244908,0,0,0,1,1
"93371",46685500,1000,0.00259188,0,0,0,1,1
"93372",46686000,1000,0.00248833,0,0,0,0,0
"93373",46686500,1000,0.00248247,0,0,0,1,1
"93374",46687000,1000,0.00257507,0,0,0,2,2
"93375",46687500,1000,0.00263604,0,0,0,2,2
"93376",46688000,1000,0.0025399,0,0,0,2,2
"93377",46688500,1000,0.0024116,0,0,0,1,1
"93378",46689000,1000,0.00250666,0,0,0,1,1
"93379",46689500,1000,0.00254994,0,0,0,2,2
"93380",46690000,1000,0.00264744,0,0,1,2,3
"93381",46690500,1000,0.00263085,0,0,1,2,3
"93382",46691000,1000,0.00267531,0,0,1,2,3
"93383",46691500,1000,0.00286069,0,0,2,2,4
"93384",46692000,1000,0.00264346,0,0,1,1,2
"93385",46692500,1000,0.0025131,0,0,0,0,0
"93386",46693000,1000,0.00266649,0,0,0,2,2
"93387",46693500,1000,0.00261648,0,0,0,2,2
"93388",46694000,1000,0.00259851,0,0,0,0,0
"93389",46694500,1000,0.0028979,0,0,2,0,2
"93390",46695000,1000,0.00295855,0,0,3,1,4
"93391",46695500,1000,0.0026904,0,0,1,1,2
"93392",46696000,1000,0.0025512,0,0,0,0,0
"93393",46696500,1000,0.00255775,0,0,0,0,0
"93394",46697000,1000,0.00263869,0,0,0,1,1
"93395",46697500,1000,0.00271574,0,0,1,2,3
"93396",46698000,1000,0.00269972,0,0,2,1,3
"93397",46698500,1000,0.00257039,0,0,1,0,1
"93398",46699000,1000,0.00260157,0,0,0,1,1
"93399",46699500,1000,0.00269051,0,0,1,2,3
"93400",46700000,1000,0.00255719,0,0,1,1,2
"93401",46700500,1000,0.00257039,0,0,1,0,1
"93402",46701000,1000,0.00273913,0,0,2,1,3
"93403",46701500,1000,0.00270799,0,0,1,2,3
"93404",46702000,1000,0.00266425,0,0,0,3,3
"93405",46702500,1000,0.00264803,0,0,0,2,2
"93406",46703000,1000,0.00261139,0,0,0,2,2
"93407",46703500,1000,0.00257258,0,0,0,2,2
"93408",46704000,1000,0.00254854,0,0,0,0,0
"93409",46704500,1000,0.0025184,0,0,0,0,0
"93410",46705000,1000,0.00249428,0,0,0,0,0
"93411",46705500,1000,0.00259271,0,0,0,0,0
"93412",46706000,1000,0.00274113,0,0,1,1,2
"93413",46706500,1000,0.00269621,0,0,1,1,2
"93414",46707000,1000,0.00265365,0,0,1,1,2
"93415",46707500,1000,0.00265512,0,0,1,1,2
"93416",46708000,1000,0.0025441,0,0,0,1,1
"93417",46708500,1000,0.00263406,0,0,0,2,2
"93418",46709000,1000,0.00262139,0,0,0,3,3
"93419",46709500,1000,0.0025282,0,0,0,3,3
"93420",46710000,1000,0.00258328,0,0,0,1,1
"93421",46710500,1000,0.0025622,0,0,0,0,0
"93422",46711000,1000,0.00260624,0,0,0,0,0
"93423",46711500,1000,0.00264605,0,0,0,0,0
"93424",46712000,1000,0.00258773,0,0,0,0,0
"93425",46712500,1000,0.00261271,0,0,0,0,0
"93426",46713000,1000,0.00259959,0,0,0,0,0
"93427",46713500,1000,0.00259288,0,0,0,0,0
"93428",46714000,1000,0.00256907,0,0,0,0,0
"93429",46714500,1000,0.00251634,0,0,0,0,0
"93430",46715000,1000,0.00249957,0,0,0,0,0
"93431",46715500,1000,0.00243461,0,0,0,0,0
"93432",46716000,1000,0.00252582,0,0,0,2,2
"93433",46716500,1000,0.00257502,0,0,0,2,2
"93434",46717000,1000,0.0025947,0,0,1,0,1
"93435",46717500,1000,0.00273536,0,0,1,1,2
"93436",46718000,1000,0.00277259,0,0,0,1,1
"93437",46718500,1000,0.00262141,0,0,0,1,1
"93438",46719000,1000,0.00246278,0,0,0,1,1
"93439",46719500,1000,0.00249243,0,0,0,0,0
"93440",46720000,1000,0.0025595,0,0,0,0,0
"93441",46720500,1000,0.00259239,0,0,0,0,0
"93442",46721000,1000,0.00278505,0,0,0,3,3
"93443",46721500,1000,0.00276772,0,0,0,3,3
"93444",46722000,1000,0.00300475,0,1,0,1,2
"93445",46722500,1000,0.00304014,0,1,0,1,2
"93446",46723000,1000,0.00257305,0,0,0,0,0
"93447",46723500,1000,0.00265586,0,0,0,0,0
"93448",46724000,1000,0.00269852,0,0,0,0,0
"93449",46724500,1000,0.00259055,0,0,0,0,0
"93450",46725000,1000,0.0025686,0,0,0,1,1
"93451",46725500,1000,0.00257097,0,0,0,1,1
"93452",46726000,1000,0.00259333,0,0,0,0,0
"93453",46726500,1000,0.00256404,0,0,0,0,0
"93454",46727000,1000,0.00259752,0,0,0,1,1
"93455",46727500,1000,0.00262241,0,0,0,1,1
"93456",46728000,1000,0.00254156,0,0,0,0,0
"93457",46728500,1000,0.00248804,0,0,0,0,0
"93458",46729000,1000,0.00244974,0,0,0,0,0
"93459",46729500,1000,0.00246026,0,0,0,0,0
"93460",46730000,1000,0.00246999,0,0,0,0,0
"93461",46730500,1000,0.00255968,0,0,0,0,0
"93462",46731000,1000,0.00260837,0,0,0,0,0
"93463",46731500,1000,0.00280894,0,1,0,0,1
"93464",46732000,1000,0.00274336,0,1,0,0,1
"93465",46732500,1000,0.00254772,0,0,0,0,0
"93466",46733000,1000,0.00268982,0,0,0,0,0
"93467",46733500,1000,0.00269206,0,0,0,0,0
"93468",46734000,1000,0.00256288,0,0,0,0,0
"93469",46734500,1000,0.00257086,0,0,0,1,1
"93470",46735000,1000,0.00257667,0,0,0,1,1
"93471",46735500,1000,0.00273607,0,0,0,2,2
"93472",46736000,1000,0.00280127,0,0,0,3,3
"93473",46736500,1000,0.00247384,0,0,0,1,1
"93474",46737000,1000,0.0025415,0,0,0,1,1
"93475",46737500,1000,0.00261311,0,0,0,1,1
"93476",46738000,1000,0.00251684,0,0,0,1,1
"93477",46738500,1000,0.00257862,0,0,0,2,2
"93478",46739000,1000,0.0027729,0,0,1,3,4
"93479",46739500,1000,0.00277051,0,0,1,4,5
"93480",46740000,1000,0.00254425,0,0,0,2,2
"93481",46740500,1000,0.00261835,0,0,1,0,1
"93482",46741000,1000,0.00264944,0,0,1,0,1
"93483",46741500,1000,0.00263023,0,0,1,0,1
"93484",46742000,1000,0.00263067,0,0,1,0,1
"93485",46742500,1000,0.00257968,0,0,0,0,0
"93486",46743000,1000,0.00280647,0,0,1,2,3
"93487",46743500,1000,0.00290375,0,0,1,3,4
"93488",46744000,1000,0.00261233,0,0,0,1,1
"93489",46744500,1000,0.00245232,0,0,0,0,0
"93490",46745000,1000,0.00258987,0,0,0,0,0
"93491",46745500,1000,0.00258514,0,0,0,0,0
"93492",46746000,1000,0.0024916,0,0,0,0,0
"93493",46746500,1000,0.00252966,0,0,0,1,1
"93494",46747000,1000,0.00267938,0,1,0,1,2
"93495",46747500,1000,0.00267803,0,1,0,0,1
"93496",46748000,1000,0.00259293,0,0,0,2,2
"93497",46748500,1000,0.00271364,0,0,0,3,3
"93498",46749000,1000,0.00252542,0,0,0,1,1
"93499",46749500,1000,0.00242474,0,0,0,0,0
"93500",46750000,1000,0.00276548,0,0,1,1,2
"93501",46750500,1000,0.00266692,0,0,1,1,2
"93502",46751000,1000,0.00247768,0,0,0,1,1
"93503",46751500,1000,0.00258868,0,0,0,1,1
"93504",46752000,1000,0.00257985,0,0,0,0,0
"93505",46752500,1000,0.00262618,0,0,1,0,1
"93506",46753000,1000,0.00255224,0,0,1,0,1
"93507",46753500,1000,0.00252492,0,0,0,1,1
"93508",46754000,1000,0.00259287,0,0,0,2,2
"93509",46754500,1000,0.00255748,0,0,0,1,1
"93510",46755000,1000,0.00263398,0,0,0,1,1
"93511",46755500,1000,0.00263875,0,0,0,2,2
"93512",46756000,1000,0.0026143,0,0,0,2,2
"93513",46756500,1000,0.00258811,0,0,0,1,1
"93514",46757000,1000,0.00262165,0,0,0,2,2
"93515",46757500,1000,0.00265567,0,0,0,3,3
"93516",46758000,1000,0.00265693,0,0,0,2,2
"93517",46758500,1000,0.0027211,0,0,1,1,2
"93518",46759000,1000,0.00267349,0,0,1,0,1
"93519",46759500,1000,0.00263237,0,0,0,0,0
"93520",46760000,1000,0.00265914,0,0,0,2,2
"93521",46760500,1000,0.00261781,0,0,0,2,2
"93522",46761000,1000,0.00266221,0,0,0,0,0
"93523",46761500,1000,0.00279658,0,0,1,1,2
"93524",46762000,1000,0.00297135,0,1,1,2,4
"93525",46762500,1000,0.00276244,0,1,0,1,2
"93526",46763000,1000,0.00276008,0,1,0,0,1
"93527",46763500,1000,0.00295156,0,1,0,1,2
"93528",46764000,1000,0.00272252,0,0,0,1,1
"93529",46764500,1000,0.00267903,0,0,0,0,0
"93530",46765000,1000,0.0027468,0,0,0,1,1
"93531",46765500,1000,0.00273355,0,0,0,1,1
"93532",46766000,1000,0.00276638,0,0,0,2,2
"93533",46766500,1000,0.002826,0,0,0,2,2
"93534",46767000,1000,0.00272323,0,0,0,0,0
"93535",46767500,1000,0.00262771,0,0,0,0,0
"93536",46768000,1000,0.00278024,0,0,1,1,2
"93537",46768500,1000,0.00292074,0,0,1,2,3
"93538",46769000,1000,0.00278994,0,0,0,2,2
"93539",46769500,1000,0.00261077,0,0,0,1,1
"93540",46770000,1000,0.0026203,0,0,0,0,0
"93541",46770500,1000,0.00266038,0,0,0,0,0
"93542",46771000,1000,0.0024507,0,0,0,0,0
"93543",46771500,1000,0.00212547,0,0,0,0,0
"93544",46772000,1000,0.00218299,0,0,0,0,0
"93545",46772500,1000,0.00247728,0,0,0,0,0
"93546",46773000,1000,0.00254663,0,0,0,0,0
"93547",46773500,1000,0.00259046,0,0,0,0,0
"93548",46774000,1000,0.00267181,0,0,1,0,1
"93549",46774500,1000,0.00278759,0,0,1,2,3
"93550",46775000,1000,0.00276517,0,0,0,2,2
"93551",46775500,1000,0.00273217,0,0,1,1,2
"93552",46776000,1000,0.0027071,0,0,1,1,2
"93553",46776500,1000,0.00267373,0,0,0,0,0
"93554",46777000,1000,0.00275882,0,0,1,0,1
"93555",46777500,1000,0.0027428,0,0,1,0,1
"93556",46778000,1000,0.00273302,0,0,0,2,2
"93557",46778500,1000,0.00275106,0,0,0,3,3
"93558",46779000,1000,0.00265318,0,0,0,1,1
"93559",46779500,1000,0.00267982,0,0,0,1,1
"93560",46780000,1000,0.0028026,0,0,0,1,1
"93561",46780500,1000,0.00275897,0,0,1,1,2
"93562",46781000,1000,0.00278747,0,0,2,2,4
"93563",46781500,1000,0.00275425,0,0,1,1,2
"93564",46782000,1000,0.00265009,0,0,0,0,0
"93565",46782500,1000,0.0028499,0,1,0,0,1
"93566",46783000,1000,0.00286567,0,1,0,0,1
"93567",46783500,1000,0.00266965,0,0,0,0,0
"93568",46784000,1000,0.00270661,0,0,0,2,2
"93569",46784500,1000,0.0027364,0,0,1,3,4
"93570",46785000,1000,0.00269718,0,0,1,1,2
"93571",46785500,1000,0.0026665,0,0,0,0,0
"93572",46786000,1000,0.00267886,0,0,0,0,0
"93573",46786500,1000,0.00269779,0,0,0,0,0
"93574",46787000,1000,0.00277332,0,0,0,1,1
"93575",46787500,1000,0.00279525,0,0,0,2,2
"93576",46788000,1000,0.00271597,0,0,0,1,1
"93577",46788500,1000,0.0026768,0,0,0,0,0
"93578",46789000,1000,0.00265928,0,0,0,0,0
"93579",46789500,1000,0.00265563,0,0,0,0,0
"93580",46790000,1000,0.0027658,0,1,0,0,1
"93581",46790500,1000,0.00273392,0,1,0,0,1
"93582",46791000,1000,0.00267589,0,0,0,2,2
"93583",46791500,1000,0.00278497,0,0,0,3,3
"93584",46792000,1000,0.00273308,0,0,0,1,1
"93585",46792500,1000,0.00264579,0,0,0,0,0
"93586",46793000,1000,0.00275632,0,0,0,0,0
"93587",46793500,1000,0.00281871,0,0,0,0,0
"93588",46794000,1000,0.00278263,0,0,0,0,0
"93589",46794500,1000,0.00291633,0,1,0,1,2
"93590",46795000,1000,0.00282347,0,1,0,1,2
"93591",46795500,1000,0.00267813,0,0,0,0,0
"93592",46796000,1000,0.00269925,0,0,0,0,0
"93593",46796500,1000,0.00262049,0,0,0,0,0
"93594",46797000,1000,0.00255949,0,0,0,0,0
"93595",46797500,1000,0.0025645,0,0,0,1,1
"93596",46798000,1000,0.00277071,0,0,1,1,2
"93597",46798500,1000,0.00295767,0,0,2,1,3
"93598",46799000,1000,0.00289756,0,0,2,1,3
"93599",46799500,1000,0.00284575,0,0,2,1,3
"93600",46800000,1000,0.00286529,0,0,1,3,4
"93601",46800500,1000,0.00290749,0,0,0,4,4
"93602",46801000,1000,0.00298286,0,1,0,3,4
"93603",46801500,1000,0.00274468,0,1,0,1,2
"93604",46802000,1000,0.00260488,0,0,1,1,2
"93605",46802500,1000,0.00272524,0,0,1,2,3
"93606",46803000,1000,0.00273881,0,0,0,2,2
"93607",46803500,1000,0.00271551,0,0,0,1,1
"93608",46804000,1000,0.00288933,0,1,1,1,3
"93609",46804500,1000,0.00286105,0,1,1,1,3
"93610",46805000,1000,0.00272668,0,0,0,2,2
"93611",46805500,1000,0.00273456,0,0,0,2,2
"93612",46806000,1000,0.00259866,0,0,0,0,0
"93613",46806500,1000,0.00291177,0,1,0,1,2
"93614",46807000,1000,0.0029735,0,1,0,1,2
"93615",46807500,1000,0.00265619,0,0,0,0,0
"93616",46808000,1000,0.00271657,0,0,1,0,1
"93617",46808500,1000,0.00278521,0,0,1,1,2
"93618",46809000,1000,0.00276989,0,0,0,3,3
"93619",46809500,1000,0.0027829,0,0,0,3,3
"93620",46810000,1000,0.00279939,0,0,0,2,2
"93621",46810500,1000,0.00281014,0,0,0,2,2
"93622",46811000,1000,0.00262929,0,0,0,1,1
"93623",46811500,1000,0.00264172,0,0,0,0,0
"93624",46812000,1000,0.00271745,0,0,0,1,1
"93625",46812500,1000,0.00254917,0,0,0,1,1
"93626",46813000,1000,0.00279319,0,1,1,0,2
"93627",46813500,1000,0.00291361,0,1,1,0,2
"93628",46814000,1000,0.00272196,0,0,0,1,1
"93629",46814500,1000,0.00268042,0,0,0,1,1
"93630",46815000,1000,0.00276407,0,0,0,0,0
"93631",46815500,1000,0.00277828,0,0,0,0,0
"93632",46816000,1000,0.00290391,0,0,1,2,3
"93633",46816500,1000,0.00291221,0,0,1,2,3
"93634",46817000,1000,0.00260342,0,0,0,0,0
"93635",46817500,1000,0.00248259,0,0,0,0,0
"93636",46818000,1000,0.00252327,0,0,0,0,0
"93637",46818500,1000,0.00253647,0,0,0,0,0
"93638",46819000,1000,0.00265696,0,0,1,1,2
"93639",46819500,1000,0.00267547,0,0,1,2,3
"93640",46820000,1000,0.00250276,0,0,0,1,1
"93641",46820500,1000,0.00266696,0,0,0,2,2
"93642",46821000,1000,0.00284399,0,0,1,2,3
"93643",46821500,1000,0.00273549,0,0,1,0,1
"93644",46822000,1000,0.00264452,0,0,0,1,1
"93645",46822500,1000,0.00263923,0,0,0,1,1
"93646",46823000,1000,0.00251916,0,0,1,1,2
"93647",46823500,1000,0.00260367,0,0,1,3,4
"93648",46824000,1000,0.00278156,0,0,0,4,4
"93649",46824500,1000,0.00265973,0,0,0,2,2
"93650",46825000,1000,0.00255767,0,0,0,0,0
"93651",46825500,1000,0.00267149,0,0,0,1,1
"93652",46826000,1000,0.00274728,0,0,0,1,1
"93653",46826500,1000,0.0027958,0,0,0,3,3
"93654",46827000,1000,0.00285514,0,0,0,4,4
"93655",46827500,1000,0.00265884,0,0,0,1,1
"93656",46828000,1000,0.00270387,0,0,1,1,2
"93657",46828500,1000,0.00280509,0,0,1,2,3
"93658",46829000,1000,0.0027339,0,0,1,2,3
"93659",46829500,1000,0.00272998,0,0,1,1,2
"93660",46830000,1000,0.00277323,0,0,0,0,0
"93661",46830500,1000,0.00274384,0,0,0,0,0
"93662",46831000,1000,0.0026438,0,0,0,0,0
"93663",46831500,1000,0.0027223,0,0,0,1,1
"93664",46832000,1000,0.00264111,0,0,0,1,1
"93665",46832500,1000,0.0024948,0,0,0,0,0
"93666",46833000,1000,0.00254852,0,0,0,0,0
"93667",46833500,1000,0.00270471,0,0,0,0,0
"93668",46834000,1000,0.00274499,0,0,0,0,0
"93669",46834500,1000,0.00274788,0,0,0,0,0
"93670",46835000,1000,0.00281583,0,0,1,0,1
"93671",46835500,1000,0.00276241,0,0,1,1,2
"93672",46836000,1000,0.00257626,0,0,0,1,1
"93673",46836500,1000,0.00255684,0,0,1,0,1
"93674",46837000,1000,0.00267369,0,0,1,1,2
"93675",46837500,1000,0.00281319,0,0,0,3,3
"93676",46838000,1000,0.0027424,0,0,0,3,3
"93677",46838500,1000,0.00254415,0,0,0,2,2
"93678",46839000,1000,0.00262494,0,0,1,2,3
"93679",46839500,1000,0.00268793,0,0,1,1,2
"93680",46840000,1000,0.00269456,0,0,1,1,2
"93681",46840500,1000,0.00262658,0,0,1,1,2
"93682",46841000,1000,0.00252041,0,0,0,0,0
"93683",46841500,1000,0.0025175,0,0,0,0,0
"93684",46842000,1000,0.00259928,0,0,0,0,0
"93685",46842500,1000,0.0026679,0,0,0,1,1
"93686",46843000,1000,0.00260673,0,0,0,1,1
"93687",46843500,1000,0.00263848,0,0,0,0,0
"93688",46844000,1000,0.00272477,0,0,0,1,1
"93689",46844500,1000,0.0027211,0,0,0,2,2
"93690",46845000,1000,0.00286811,0,0,1,2,3
"93691",46845500,1000,0.00289929,0,0,1,3,4
"93692",46846000,1000,0.00283636,0,0,0,4,4
"93693",46846500,1000,0.00283792,0,0,1,2,3
"93694",46847000,1000,0.00269572,0,0,1,1,2
"93695",46847500,1000,0.00306923,0,2,0,2,4
"93696",46848000,1000,0.00308866,0,2,0,1,3
"93697",46848500,1000,0.00270739,0,0,0,1,1
"93698",46849000,1000,0.00272536,0,0,0,1,1
"93699",46849500,1000,0.00266058,0,0,0,0,0
"93700",46850000,1000,0.0027478,0,1,0,0,1
"93701",46850500,1000,0.00276256,0,1,0,0,1
"93702",46851000,1000,0.00251053,0,0,0,0,0
"93703",46851500,1000,0.00237928,0,0,0,0,0
"93704",46852000,1000,0.0024554,0,0,0,0,0
"93705",46852500,1000,0.00256504,0,0,0,1,1
"93706",46853000,1000,0.00267014,0,0,0,1,1
"93707",46853500,1000,0.00270751,0,0,0,1,1
"93708",46854000,1000,0.00279488,0,0,0,2,2
"93709",46854500,1000,0.00283176,0,0,0,3,3
"93710",46855000,1000,0.00287685,0,1,0,2,3
"93711",46855500,1000,0.00296572,0,1,1,1,3
"93712",46856000,1000,0.00289579,0,1,1,1,3
"93713",46856500,1000,0.00281922,0,1,0,2,3
"93714",46857000,1000,0.00270389,0,0,0,3,3
"93715",46857500,1000,0.00260698,0,0,0,1,1
"93716",46858000,1000,0.00266843,0,0,0,2,2
"93717",46858500,1000,0.00271965,0,0,0,3,3
"93718",46859000,1000,0.0027505,0,0,0,3,3
"93719",46859500,1000,0.0026154,0,0,0,2,2
"93720",46860000,1000,0.00260143,0,0,0,0,0
"93721",46860500,1000,0.00280501,0,0,0,3,3
"93722",46861000,1000,0.00278031,0,0,0,3,3
"93723",46861500,1000,0.00273391,0,0,0,1,1
"93724",46862000,1000,0.00263951,0,0,0,1,1
"93725",46862500,1000,0.00263195,0,0,0,1,1
"93726",46863000,1000,0.00265956,0,0,0,1,1
"93727",46863500,1000,0.00261406,0,0,0,1,1
"93728",46864000,1000,0.00266517,0,0,0,1,1
"93729",46864500,1000,0.00274272,0,0,1,0,1
"93730",46865000,1000,0.00283735,0,0,1,0,1
"93731",46865500,1000,0.00279886,0,0,0,0,0
"93732",46866000,1000,0.00269991,0,0,0,0,0
"93733",46866500,1000,0.00274314,0,0,0,0,0
"93734",46867000,1000,0.00285637,0,0,0,2,2
"93735",46867500,1000,0.00280447,0,0,0,2,2
"93736",46868000,1000,0.00272788,0,0,0,2,2
"93737",46868500,1000,0.00282169,0,0,1,3,4
"93738",46869000,1000,0.00276979,0,0,1,1,2
"93739",46869500,1000,0.0027566,0,0,1,1,2
"93740",46870000,1000,0.00281017,0,0,1,1,2
"93741",46870500,1000,0.00266204,0,0,0,0,0
"93742",46871000,1000,0.00268819,0,0,0,1,1
"93743",46871500,1000,0.00272597,0,0,0,1,1
"93744",46872000,1000,0.00262807,0,0,0,0,0
"93745",46872500,1000,0.00271846,0,0,0,0,0
"93746",46873000,1000,0.00284629,0,0,1,0,1
"93747",46873500,1000,0.00286406,0,0,1,3,4
"93748",46874000,1000,0.00290169,0,0,1,3,4
"93749",46874500,1000,0.00281773,0,0,1,2,3
"93750",46875000,1000,0.00272995,0,0,0,3,3
"93751",46875500,1000,0.00277207,0,0,0,2,2
"93752",46876000,1000,0.00282599,0,0,0,2,2
"93753",46876500,1000,0.00290565,0,0,0,2,2
"93754",46877000,1000,0.00289015,0,0,0,2,2
"93755",46877500,1000,0.00289623,0,0,0,2,2
"93756",46878000,1000,0.00292526,0,0,1,1,2
"93757",46878500,1000,0.00273391,0,0,1,0,1
"93758",46879000,1000,0.0026659,0,0,0,1,1
"93759",46879500,1000,0.00278183,0,0,1,1,2
"93760",46880000,1000,0.00275784,0,0,1,0,1
"93761",46880500,1000,0.00259512,0,0,0,0,0
"93762",46881000,1000,0.00261824,0,0,0,0,0
"93763",46881500,1000,0.0027723,0,0,0,0,0
"93764",46882000,1000,0.00270541,0,0,0,0,0
"93765",46882500,1000,0.00265015,0,0,0,0,0
"93766",46883000,1000,0.0027307,0,0,0,3,3
"93767",46883500,1000,0.00275532,0,0,0,4,4
"93768",46884000,1000,0.00278415,0,0,0,3,3
"93769",46884500,1000,0.00278495,0,0,0,3,3
"93770",46885000,1000,0.00273672,0,0,0,1,1
"93771",46885500,1000,0.0026655,0,0,0,1,1
"93772",46886000,1000,0.00262756,0,0,0,1,1
"93773",46886500,1000,0.00266846,0,0,0,1,1
"93774",46887000,1000,0.00266289,0,0,0,3,3
"93775",46887500,1000,0.00271353,0,0,0,4,4
"93776",46888000,1000,0.00275713,0,0,0,3,3
"93777",46888500,1000,0.0028068,0,0,0,2,2
"93778",46889000,1000,0.00279047,0,0,0,1,1
"93779",46889500,1000,0.00265709,0,0,0,0,0
"93780",46890000,1000,0.00258311,0,0,0,0,0
"93781",46890500,1000,0.00258861,0,0,0,0,0
"93782",46891000,1000,0.00290085,0,1,0,1,2
"93783",46891500,1000,0.00287046,0,1,0,2,3
"93784",46892000,1000,0.00269695,0,0,0,2,2
"93785",46892500,1000,0.00303808,0,1,0,1,2
"93786",46893000,1000,0.00290779,0,1,0,0,1
"93787",46893500,1000,0.0027186,0,0,0,0,0
"93788",46894000,1000,0.00277851,0,0,1,1,2
"93789",46894500,1000,0.00262385,0,0,1,1,2
"93790",46895000,1000,0.00253002,0,0,0,0,0
"93791",46895500,1000,0.0025643,0,0,0,0,0
"93792",46896000,1000,0.00268663,0,0,1,1,2
"93793",46896500,1000,0.00304127,0,1,1,2,4
"93794",46897000,1000,0.00332499,0,2,0,1,3
"93795",46897500,1000,0.00300488,0,1,0,1,2
"93796",46898000,1000,0.00263222,0,0,0,1,1
"93797",46898500,1000,0.00260948,0,0,0,1,1
"93798",46899000,1000,0.00262151,0,0,0,2,2
"93799",46899500,1000,0.00261695,0,0,0,1,1
"93800",46900000,1000,0.00276771,0,0,1,1,2
"93801",46900500,1000,0.00273483,0,0,1,1,2
"93802",46901000,1000,0.00255717,0,0,0,0,0
"93803",46901500,1000,0.00256083,0,0,0,0,0
"93804",46902000,1000,0.00270708,0,0,0,1,1
"93805",46902500,1000,0.00271726,0,0,0,1,1
"93806",46903000,1000,0.00263223,0,0,0,1,1
"93807",46903500,1000,0.00254531,0,0,0,1,1
"93808",46904000,1000,0.00236513,0,0,0,0,0
"93809",46904500,1000,0.00255199,0,0,0,0,0
"93810",46905000,1000,0.00285498,0,0,1,1,2
"93811",46905500,1000,0.00291423,0,0,2,1,3
"93812",46906000,1000,0.00281605,0,0,1,0,1
"93813",46906500,1000,0.00268067,0,0,0,0,0
"93814",46907000,1000,0.00274829,0,0,0,2,2
"93815",46907500,1000,0.00277982,0,0,0,2,2
"93816",46908000,1000,0.00264389,0,0,0,0,0
"93817",46908500,1000,0.00264231,0,0,0,0,0
"93818",46909000,1000,0.00259371,0,0,0,1,1
"93819",46909500,1000,0.00259917,0,0,0,1,1
"93820",46910000,1000,0.00275202,0,0,0,1,1
"93821",46910500,1000,0.00279496,0,0,0,3,3
"93822",46911000,1000,0.00269467,0,0,0,2,2
"93823",46911500,1000,0.00267305,0,0,0,1,1
"93824",46912000,1000,0.00270693,0,0,0,1,1
"93825",46912500,1000,0.00263701,0,0,0,0,0
"93826",46913000,1000,0.00258331,0,0,0,0,0
"93827",46913500,1000,0.00261715,0,0,0,0,0
"93828",46914000,1000,0.00270219,0,0,1,1,2
"93829",46914500,1000,0.00260457,0,0,1,1,2
"93830",46915000,1000,0.00268714,0,0,1,1,2
"93831",46915500,1000,0.00280406,0,0,1,1,2
"93832",46916000,1000,0.00272736,0,0,0,0,0
"93833",46916500,1000,0.00265634,0,0,0,0,0
"93834",46917000,1000,0.00256514,0,0,0,0,0
"93835",46917500,1000,0.00261528,0,0,0,1,1
"93836",46918000,1000,0.00267428,0,0,0,2,2
"93837",46918500,1000,0.00260284,0,0,0,1,1
"93838",46919000,1000,0.00255779,0,0,0,0,0
"93839",46919500,1000,0.00258202,0,0,0,0,0
"93840",46920000,1000,0.00259605,0,0,0,1,1
"93841",46920500,1000,0.00262204,0,0,0,1,1
"93842",46921000,1000,0.00254531,0,0,0,0,0
"93843",46921500,1000,0.00258075,0,0,0,1,1
"93844",46922000,1000,0.00262661,0,0,0,1,1
"93845",46922500,1000,0.00257787,0,0,0,0,0
"93846",46923000,1000,0.00261905,0,0,1,0,1
"93847",46923500,1000,0.00254352,0,0,1,0,1
"93848",46924000,1000,0.00255674,0,0,0,0,0
"93849",46924500,1000,0.00256311,0,0,0,0,0
"93850",46925000,1000,0.00264407,0,0,0,0,0
"93851",46925500,1000,0.00266345,0,0,0,0,0
"93852",46926000,1000,0.00257716,0,0,0,0,0
"93853",46926500,1000,0.00264653,0,0,0,0,0
"93854",46927000,1000,0.00254647,0,0,0,0,0
"93855",46927500,1000,0.00251661,0,0,0,0,0
"93856",46928000,1000,0.0027071,0,0,0,1,1
"93857",46928500,1000,0.00281661,0,0,1,1,2
"93858",46929000,1000,0.00269549,0,0,1,0,1
"93859",46929500,1000,0.00260515,0,0,0,0,0
"93860",46930000,1000,0.00267739,0,0,1,0,1
"93861",46930500,1000,0.00256124,0,0,1,0,1
"93862",46931000,1000,0.00259199,0,0,0,2,2
"93863",46931500,1000,0.00306039,0,1,0,4,5
"93864",46932000,1000,0.00308558,0,1,0,2,3
"93865",46932500,1000,0.00268966,0,0,0,0,0
"93866",46933000,1000,0.0025634,0,0,0,0,0
"93867",46933500,1000,0.00264158,0,0,0,0,0
"93868",46934000,1000,0.00274864,0,0,0,2,2
"93869",46934500,1000,0.00279482,0,0,0,2,2
"93870",46935000,1000,0.0029834,0,1,0,3,4
"93871",46935500,1000,0.00294684,0,1,0,3,4
"93872",46936000,1000,0.00273551,0,0,0,0,0
"93873",46936500,1000,0.00264605,0,0,0,0,0
"93874",46937000,1000,0.00257924,0,0,1,0,1
"93875",46937500,1000,0.00262125,0,0,1,0,1
"93876",46938000,1000,0.00264282,0,0,0,0,0
"93877",46938500,1000,0.00275604,0,0,0,1,1
"93878",46939000,1000,0.00276262,0,0,0,1,1
"93879",46939500,1000,0.00269299,0,0,0,0,0
"93880",46940000,1000,0.00265418,0,0,0,0,0
"93881",46940500,1000,0.00271408,0,0,0,0,0
"93882",46941000,1000,0.00281457,0,0,0,1,1
"93883",46941500,1000,0.00269567,0,0,0,2,2
"93884",46942000,1000,0.00278011,0,0,1,3,4
"93885",46942500,1000,0.00270648,0,0,1,2,3
"93886",46943000,1000,0.00250189,0,0,0,0,0
"93887",46943500,1000,0.00263189,0,0,0,1,1
"93888",46944000,1000,0.00270508,0,0,0,1,1
"93889",46944500,1000,0.00270746,0,0,0,1,1
"93890",46945000,1000,0.00286918,0,0,0,2,2
"93891",46945500,1000,0.00293062,0,0,0,1,1
"93892",46946000,1000,0.00280138,0,0,1,1,2
"93893",46946500,1000,0.00270966,0,0,1,2,3
"93894",46947000,1000,0.00278946,0,0,0,3,3
"93895",46947500,1000,0.00304294,0,0,1,4,5
"93896",46948000,1000,0.00294163,0,0,1,2,3
"93897",46948500,1000,0.00266031,0,0,0,0,0
"93898",46949000,1000,0.00267586,0,0,0,1,1
"93899",46949500,1000,0.00271838,0,0,0,1,1
"93900",46950000,1000,0.00272586,0,0,0,0,0
"93901",46950500,1000,0.00279858,0,0,0,0,0
"93902",46951000,1000,0.00277094,0,0,0,0,0
"93903",46951500,1000,0.00267653,0,0,0,0,0
"93904",46952000,1000,0.00270733,0,0,0,1,1
"93905",46952500,1000,0.00283322,0,0,1,2,3
"93906",46953000,1000,0.00271601,0,0,1,1,2
"93907",46953500,1000,0.00256575,0,0,0,0,0
"93908",46954000,1000,0.00253706,0,0,0,0,0
"93909",46954500,1000,0.0025834,0,0,0,0,0
"93910",46955000,1000,0.00261352,0,0,0,1,1
"93911",46955500,1000,0.00269814,0,0,0,1,1
"93912",46956000,1000,0.00268176,0,0,0,0,0
"93913",46956500,1000,0.00259831,0,0,0,1,1
"93914",46957000,1000,0.00269832,0,0,0,2,2
"93915",46957500,1000,0.00268361,0,0,0,1,1
"93916",46958000,1000,0.00267459,0,0,0,0,0
"93917",46958500,1000,0.00274705,0,0,0,1,1
"93918",46959000,1000,0.00275177,0,0,0,1,1
"93919",46959500,1000,0.00268606,0,0,0,0,0
"93920",46960000,1000,0.00270808,0,0,0,0,0
"93921",46960500,1000,0.00263401,0,0,0,0,0
"93922",46961000,1000,0.00250838,0,0,0,0,0
"93923",46961500,1000,0.00250666,0,0,0,0,0
"93924",46962000,1000,0.00252608,0,0,0,0,0
"93925",46962500,1000,0.00260986,0,0,0,0,0
"93926",46963000,1000,0.00280364,0,0,0,1,1
"93927",46963500,1000,0.00285713,0,0,0,2,2
"93928",46964000,1000,0.00282323,0,0,0,2,2
"93929",46964500,1000,0.00277828,0,0,0,1,1
"93930",46965000,1000,0.00270593,0,0,0,0,0
"93931",46965500,1000,0.00290887,0,1,0,2,3
"93932",46966000,1000,0.00303045,0,1,1,2,4
"93933",46966500,1000,0.00283697,0,0,1,1,2
"93934",46967000,1000,0.00268182,0,0,0,1,1
"93935",46967500,1000,0.00265382,0,0,0,0,0
"93936",46968000,1000,0.0026919,0,0,0,0,0
"93937",46968500,1000,0.00280358,0,0,0,1,1
"93938",46969000,1000,0.00283757,0,0,0,1,1
"93939",46969500,1000,0.00274874,0,0,0,0,0
"93940",46970000,1000,0.00280143,0,0,0,2,2
"93941",46970500,1000,0.0027563,0,0,0,2,2
"93942",46971000,1000,0.00268706,0,0,0,3,3
"93943",46971500,1000,0.00280549,0,0,0,4,4
"93944",46972000,1000,0.0027886,0,0,0,2,2
"93945",46972500,1000,0.00276756,0,0,0,1,1
"93946",46973000,1000,0.00297473,0,1,0,1,2
"93947",46973500,1000,0.00286053,0,1,0,1,2
"93948",46974000,1000,0.002773,0,0,1,1,2
"93949",46974500,1000,0.0029081,0,0,2,2,4
"93950",46975000,1000,0.00276514,0,0,1,1,2
"93951",46975500,1000,0.00264648,0,0,0,0,0
"93952",46976000,1000,0.00273409,0,0,1,2,3
"93953",46976500,1000,0.00271762,0,0,1,2,3
"93954",46977000,1000,0.00259135,0,0,0,0,0
"93955",46977500,1000,0.0025664,0,0,0,0,0
"93956",46978000,1000,0.00265302,0,0,1,0,1
"93957",46978500,1000,0.00269067,0,0,1,0,1
"93958",46979000,1000,0.00245299,0,0,0,0,0
"93959",46979500,1000,0.00240851,0,0,0,0,0
"93960",46980000,1000,0.00253921,0,0,0,0,0
"93961",46980500,1000,0.00260093,0,0,1,1,2
"93962",46981000,1000,0.00260896,0,0,1,1,2
"93963",46981500,1000,0.00253384,0,0,0,1,1
"93964",46982000,1000,0.00255871,0,0,0,1,1
"93965",46982500,1000,0.00266003,0,0,0,1,1
"93966",46983000,1000,0.00272368,0,0,0,1,1
"93967",46983500,1000,0.00282173,0,0,1,1,2
"93968",46984000,1000,0.00279237,0,0,1,2,3
"93969",46984500,1000,0.00263763,0,0,0,1,1
"93970",46985000,1000,0.00269037,0,0,1,0,1
"93971",46985500,1000,0.00282171,0,0,1,0,1
"93972",46986000,1000,0.00277594,0,1,0,0,1
"93973",46986500,1000,0.00289384,0,2,0,0,2
"93974",46987000,1000,0.00287783,0,1,0,1,2
"93975",46987500,1000,0.00266703,0,0,0,1,1
"93976",46988000,1000,0.00264589,0,0,0,0,0
"93977",46988500,1000,0.00276354,0,0,0,0,0
"93978",46989000,1000,0.00277354,0,0,0,0,0
"93979",46989500,1000,0.00276754,0,1,0,0,1
"93980",46990000,1000,0.00269037,0,1,0,0,1
"93981",46990500,1000,0.0026308,0,0,0,0,0
"93982",46991000,1000,0.0028394,0,0,1,0,1
"93983",46991500,1000,0.00281847,0,0,1,0,1
"93984",46992000,1000,0.00266396,0,0,0,0,0
"93985",46992500,1000,0.00269806,0,0,0,2,2
"93986",46993000,1000,0.00273415,0,0,0,3,3
"93987",46993500,1000,0.00280756,0,0,0,2,2
"93988",46994000,1000,0.00286965,0,0,0,3,3
"93989",46994500,1000,0.00273666,0,0,0,2,2
"93990",46995000,1000,0.00274297,0,0,1,0,1
"93991",46995500,1000,0.00270101,0,0,1,0,1
"93992",46996000,1000,0.00268039,0,0,0,2,2
"93993",46996500,1000,0.00286839,0,0,1,3,4
"93994",46997000,1000,0.00284705,0,0,1,2,3
"93995",46997500,1000,0.00265779,0,0,0,1,1
"93996",46998000,1000,0.00256333,0,0,0,0,0
"93997",46998500,1000,0.00278398,0,0,0,2,2
"93998",46999000,1000,0.00281267,0,0,0,2,2
"93999",46999500,1000,0.00264096,0,0,0,1,1
"94000",47000000,1000,0.00259641,0,0,0,2,2
"94001",47000500,1000,0.0027504,0,0,1,3,4
"94002",47001000,1000,0.00281758,0,0,1,2,3
"94003",47001500,1000,0.00258175,0,0,0,1,1
"94004",47002000,1000,0.00252057,0,0,0,1,1
"94005",47002500,1000,0.00257281,0,0,0,2,2
"94006",47003000,1000,0.00267308,0,0,0,2,2
"94007",47003500,1000,0.0026947,0,0,0,0,0
"94008",47004000,1000,0.00256947,0,0,0,0,0
"94009",47004500,1000,0.00261741,0,0,0,1,1
"94010",47005000,1000,0.0027147,0,0,0,1,1
"94011",47005500,1000,0.00260604,0,0,0,0,0
"94012",47006000,1000,0.00261859,0,0,0,1,1
"94013",47006500,1000,0.00269921,0,0,0,1,1
"94014",47007000,1000,0.0026489,0,0,0,0,0
"94015",47007500,1000,0.00253728,0,0,0,0,0
"94016",47008000,1000,0.00247266,0,0,0,1,1
"94017",47008500,1000,0.00247737,0,0,0,2,2
"94018",47009000,1000,0.00245285,0,0,0,1,1
"94019",47009500,1000,0.00256637,0,0,0,1,1
"94020",47010000,1000,0.00268996,0,0,0,1,1
"94021",47010500,1000,0.00270371,0,0,0,0,0
"94022",47011000,1000,0.00272682,0,0,0,1,1
"94023",47011500,1000,0.00262392,0,0,0,2,2
"94024",47012000,1000,0.00261781,0,0,0,2,2
"94025",47012500,1000,0.00263921,0,0,0,1,1
"94026",47013000,1000,0.00253329,0,0,0,0,0
"94027",47013500,1000,0.00263252,0,0,0,0,0
"94028",47014000,1000,0.00277171,0,0,0,2,2
"94029",47014500,1000,0.00263634,0,0,0,2,2
"94030",47015000,1000,0.00258753,0,0,0,1,1
"94031",47015500,1000,0.00254528,0,0,0,1,1
"94032",47016000,1000,0.00263332,0,0,1,0,1
"94033",47016500,1000,0.0027466,0,0,1,1,2
"94034",47017000,1000,0.00270451,0,0,1,1,2
"94035",47017500,1000,0.00282364,0,0,1,0,1
"94036",47018000,1000,0.00312897,0,1,0,1,2
"94037",47018500,1000,0.00321299,0,1,1,2,4
"94038",47019000,1000,0.00309345,0,0,1,3,4
"94039",47019500,1000,0.0031255,0,0,0,3,3
"94040",47020000,1000,0.00286309,0,0,0,2,2
"94041",47020500,1000,0.00267536,0,0,0,3,3
"94042",47021000,1000,0.00263419,0,0,0,2,2
"94043",47021500,1000,0.00250261,0,0,0,0,0
"94044",47022000,1000,0.00250326,0,0,0,1,1
"94045",47022500,1000,0.00250321,0,0,0,1,1
"94046",47023000,1000,0.00254008,0,0,0,2,2
"94047",47023500,1000,0.00261037,0,0,0,2,2
"94048",47024000,1000,0.00265631,0,0,0,1,1
"94049",47024500,1000,0.00263786,0,0,0,1,1
"94050",47025000,1000,0.00258362,0,0,1,0,1
"94051",47025500,1000,0.00256482,0,0,1,0,1
"94052",47026000,1000,0.00252883,0,0,0,0,0
"94053",47026500,1000,0.00250728,0,0,0,0,0
"94054",47027000,1000,0.0025945,0,0,1,0,1
"94055",47027500,1000,0.00256687,0,0,1,0,1
"94056",47028000,1000,0.00247806,0,0,0,0,0
"94057",47028500,1000,0.00289125,0,0,2,4,6
"94058",47029000,1000,0.00304489,0,0,3,5,8
"94059",47029500,1000,0.00283555,0,0,1,3,4
"94060",47030000,1000,0.00287622,0,0,0,2,2
"94061",47030500,1000,0.00266012,0,0,0,0,0
"94062",47031000,1000,0.0024012,0,0,0,0,0
"94063",47031500,1000,0.00248299,0,0,0,0,0
"94064",47032000,1000,0.00256698,0,0,0,0,0
"94065",47032500,1000,0.00261648,0,0,0,0,0
"94066",47033000,1000,0.00268883,0,0,0,0,0
"94067",47033500,1000,0.00265967,0,0,0,0,0
"94068",47034000,1000,0.00270854,0,0,0,0,0
"94069",47034500,1000,0.00273411,0,0,0,2,2
"94070",47035000,1000,0.00261931,0,0,0,2,2
"94071",47035500,1000,0.00261727,0,0,0,0,0
"94072",47036000,1000,0.00261781,0,0,0,0,0
"94073",47036500,1000,0.0024547,0,0,0,0,0
"94074",47037000,1000,0.00259061,0,0,0,3,3
"94075",47037500,1000,0.00271623,0,0,0,3,3
"94076",47038000,1000,0.00267711,0,0,0,1,1
"94077",47038500,1000,0.00278831,0,0,1,1,2
"94078",47039000,1000,0.00274952,0,0,1,0,1
"94079",47039500,1000,0.00270053,0,0,0,0,0
"94080",47040000,1000,0.00265945,0,0,0,1,1
"94081",47040500,1000,0.00261783,0,0,0,1,1
"94082",47041000,1000,0.00261015,0,0,0,0,0
"94083",47041500,1000,0.00275523,0,0,1,1,2
"94084",47042000,1000,0.00284929,0,0,1,2,3
"94085",47042500,1000,0.00261848,0,0,0,2,2
"94086",47043000,1000,0.00244269,0,0,0,1,1
"94087",47043500,1000,0.00258786,0,0,0,1,1
"94088",47044000,1000,0.00270423,0,0,1,1,2
"94089",47044500,1000,0.00269499,0,0,1,1,2
"94090",47045000,1000,0.00270825,0,0,0,2,2
"94091",47045500,1000,0.00263653,0,0,0,1,1
"94092",47046000,1000,0.0025633,0,0,0,1,1
"94093",47046500,1000,0.00251998,0,0,0,2,2
"94094",47047000,1000,0.0025319,0,0,0,2,2
"94095",47047500,1000,0.00265849,0,0,0,1,1
"94096",47048000,1000,0.00270305,0,0,0,1,1
"94097",47048500,1000,0.00266891,0,0,0,1,1
"94098",47049000,1000,0.00266941,0,0,0,0,0
"94099",47049500,1000,0.00276678,0,0,1,1,2
"94100",47050000,1000,0.00273999,0,0,1,1,2
"94101",47050500,1000,0.00280319,0,0,1,1,2
"94102",47051000,1000,0.00279902,0,0,1,2,3
"94103",47051500,1000,0.00262992,0,0,0,1,1
"94104",47052000,1000,0.00265224,0,0,0,0,0
"94105",47052500,1000,0.00258539,0,0,0,0,0
"94106",47053000,1000,0.00253746,0,0,0,0,0
"94107",47053500,1000,0.00262947,0,0,0,0,0
"94108",47054000,1000,0.00269696,0,0,0,0,0
"94109",47054500,1000,0.00261906,0,0,0,0,0
"94110",47055000,1000,0.00260949,0,0,0,0,0
"94111",47055500,1000,0.00274452,0,0,1,1,2
"94112",47056000,1000,0.00277915,0,0,1,1,2
"94113",47056500,1000,0.00277026,0,0,0,0,0
"94114",47057000,1000,0.00276096,0,0,0,0,0
"94115",47057500,1000,0.00265202,0,0,0,0,0
"94116",47058000,1000,0.00266953,0,0,0,0,0
"94117",47058500,1000,0.00276898,0,0,0,1,1
"94118",47059000,1000,0.00275515,0,0,0,2,2
"94119",47059500,1000,0.00258232,0,0,0,1,1
"94120",47060000,1000,0.00279557,0,1,0,0,1
"94121",47060500,1000,0.00298902,0,1,1,1,3
"94122",47061000,1000,0.00278226,0,0,1,3,4
"94123",47061500,1000,0.00263092,0,0,0,2,2
"94124",47062000,1000,0.00266503,0,0,0,2,2
"94125",47062500,1000,0.00268154,0,0,0,2,2
"94126",47063000,1000,0.00264644,0,0,0,1,1
"94127",47063500,1000,0.00273661,0,0,0,2,2
"94128",47064000,1000,0.00271782,0,0,0,1,1
"94129",47064500,1000,0.00270251,0,0,0,1,1
"94130",47065000,1000,0.00254229,0,0,0,1,1
"94131",47065500,1000,0.00238296,0,0,0,0,0
"94132",47066000,1000,0.00262759,0,0,1,1,2
"94133",47066500,1000,0.00272279,0,0,1,1,2
"94134",47067000,1000,0.00254259,0,0,0,1,1
"94135",47067500,1000,0.00237255,0,0,0,1,1
"94136",47068000,1000,0.00225176,0,0,0,1,1
"94137",47068500,1000,0.0024222,0,0,0,1,1
"94138",47069000,1000,0.0026898,0,0,0,0,0
"94139",47069500,1000,0.00265727,0,0,0,0,0
"94140",47070000,1000,0.00256461,0,0,0,0,0
"94141",47070500,1000,0.00271859,0,0,0,0,0
"94142",47071000,1000,0.0027428,0,0,0,1,1
"94143",47071500,1000,0.00265505,0,0,0,2,2
"94144",47072000,1000,0.00264443,0,0,0,1,1
"94145",47072500,1000,0.00262857,0,0,0,1,1
"94146",47073000,1000,0.00267302,0,0,0,2,2
"94147",47073500,1000,0.00265219,0,0,0,1,1
"94148",47074000,1000,0.00282058,0,0,1,2,3
"94149",47074500,1000,0.0027686,0,0,1,2,3
"94150",47075000,1000,0.00252181,0,0,0,0,0
"94151",47075500,1000,0.00266198,0,0,1,0,1
"94152",47076000,1000,0.00268212,0,0,1,0,1
"94153",47076500,1000,0.00267415,0,0,1,1,2
"94154",47077000,1000,0.00284005,0,0,1,3,4
"94155",47077500,1000,0.00264866,0,0,0,2,2
"94156",47078000,1000,0.00248641,0,0,0,0,0
"94157",47078500,1000,0.00251399,0,0,0,0,0
"94158",47079000,1000,0.00245764,0,0,0,0,0
"94159",47079500,1000,0.00249626,0,0,1,0,1
"94160",47080000,1000,0.00248562,0,0,1,0,1
"94161",47080500,1000,0.00271806,0,0,1,2,3
"94162",47081000,1000,0.00269713,0,0,1,2,3
"94163",47081500,1000,0.0025226,0,0,0,0,0
"94164",47082000,1000,0.00263801,0,0,0,0,0
"94165",47082500,1000,0.00261562,0,0,0,0,0
"94166",47083000,1000,0.00270556,0,0,0,4,4
"94167",47083500,1000,0.00274303,0,0,0,5,5
"94168",47084000,1000,0.00256571,0,0,0,1,1
"94169",47084500,1000,0.00250906,0,0,0,0,0
"94170",47085000,1000,0.00257525,0,0,0,1,1
"94171",47085500,1000,0.00258743,0,0,0,1,1
"94172",47086000,1000,0.00251169,0,0,0,0,0
"94173",47086500,1000,0.00273803,0,0,1,1,2
"94174",47087000,1000,0.00285805,0,0,2,1,3
"94175",47087500,1000,0.00259755,0,0,1,0,1
"94176",47088000,1000,0.00257088,0,0,0,2,2
"94177",47088500,1000,0.00260467,0,0,0,2,2
"94178",47089000,1000,0.00264459,0,0,0,1,1
"94179",47089500,1000,0.00271564,0,0,0,3,3
"94180",47090000,1000,0.00261522,0,0,0,2,2
"94181",47090500,1000,0.00244799,0,0,0,0,0
"94182",47091000,1000,0.00245279,0,0,0,1,1
"94183",47091500,1000,0.00253396,0,0,0,1,1
"94184",47092000,1000,0.00260297,0,0,1,0,1
"94185",47092500,1000,0.00267411,0,0,1,0,1
"94186",47093000,1000,0.00261993,0,0,0,0,0
"94187",47093500,1000,0.00262392,0,0,0,0,0
"94188",47094000,1000,0.00279388,0,0,0,3,3
"94189",47094500,1000,0.00282964,0,0,0,5,5
"94190",47095000,1000,0.00264135,0,0,0,2,2
"94191",47095500,1000,0.00263939,0,0,0,1,1
"94192",47096000,1000,0.00259499,0,0,0,1,1
"94193",47096500,1000,0.00268851,0,0,1,2,3
"94194",47097000,1000,0.00279703,0,0,1,3,4
"94195",47097500,1000,0.00271238,0,0,0,3,3
"94196",47098000,1000,0.00264996,0,0,1,2,3
"94197",47098500,1000,0.00271913,0,0,1,2,3
"94198",47099000,1000,0.00283802,0,0,1,3,4
"94199",47099500,1000,0.00276518,0,0,1,2,3
"94200",47100000,1000,0.00269688,0,0,0,2,2
"94201",47100500,1000,0.00257882,0,0,0,2,2
"94202",47101000,1000,0.00257608,0,0,0,1,1
"94203",47101500,1000,0.00268154,0,0,0,0,0
"94204",47102000,1000,0.00275141,0,0,0,0,0
"94205",47102500,1000,0.002807,0,0,0,3,3
"94206",47103000,1000,0.00282934,0,1,0,3,4
"94207",47103500,1000,0.00277909,0,2,0,0,2
"94208",47104000,1000,0.00267677,0,1,0,0,1
"94209",47104500,1000,0.00276915,0,0,1,2,3
"94210",47105000,1000,0.00294929,0,0,1,5,6
"94211",47105500,1000,0.00278954,0,0,0,3,3
"94212",47106000,1000,0.0026926,0,0,0,0,0
"94213",47106500,1000,0.00270275,0,0,0,0,0
"94214",47107000,1000,0.00248965,0,0,0,0,0
"94215",47107500,1000,0.00260669,0,0,1,1,2
"94216",47108000,1000,0.00274651,0,0,1,1,2
"94217",47108500,1000,0.00259351,0,0,0,0,0
"94218",47109000,1000,0.00268311,0,0,1,1,2
"94219",47109500,1000,0.00276515,0,0,1,2,3
"94220",47110000,1000,0.00257786,0,0,0,2,2
"94221",47110500,1000,0.00244284,0,0,0,1,1
"94222",47111000,1000,0.00272522,0,0,0,5,5
"94223",47111500,1000,0.00279328,0,0,0,5,5
"94224",47112000,1000,0.00266631,0,0,0,2,2
"94225",47112500,1000,0.00278155,0,0,0,4,4
"94226",47113000,1000,0.00267191,0,0,0,3,3
"94227",47113500,1000,0.00257807,0,0,0,2,2
"94228",47114000,1000,0.00251289,0,0,0,1,1
"94229",47114500,1000,0.00257791,0,0,0,3,3
"94230",47115000,1000,0.00292867,0,1,1,3,5
"94231",47115500,1000,0.00283134,0,1,1,0,2
"94232",47116000,1000,0.00256782,0,0,0,0,0
"94233",47116500,1000,0.00262141,0,0,0,1,1
"94234",47117000,1000,0.00255231,0,0,0,1,1
"94235",47117500,1000,0.00251573,0,1,0,0,1
"94236",47118000,1000,0.00253492,0,1,0,0,1
"94237",47118500,1000,0.00246531,0,0,0,0,0
"94238",47119000,1000,0.00245382,0,0,0,0,0
"94239",47119500,1000,0.00248243,0,0,0,0,0
"94240",47120000,1000,0.00249908,0,0,0,0,0
"94241",47120500,1000,0.00271294,0,0,1,0,1
"94242",47121000,1000,0.00266796,0,0,1,0,1
"94243",47121500,1000,0.0024922,0,0,0,0,0
"94244",47122000,1000,0.00259092,0,0,0,1,1
"94245",47122500,1000,0.00277617,0,1,0,1,2
"94246",47123000,1000,0.00272177,0,1,0,0,1
"94247",47123500,1000,0.00266136,0,0,0,1,1
"94248",47124000,1000,0.00268272,0,0,0,2,2
"94249",47124500,1000,0.00262274,0,0,0,3,3
"94250",47125000,1000,0.0029186,0,0,1,4,5
"94251",47125500,1000,0.00292254,0,0,1,4,5
"94252",47126000,1000,0.00263507,0,0,0,2,2
"94253",47126500,1000,0.00247748,0,0,0,0,0
"94254",47127000,1000,0.00251029,0,0,0,1,1
"94255",47127500,1000,0.00262955,0,0,0,2,2
"94256",47128000,1000,0.00269247,0,0,1,1,2
"94257",47128500,1000,0.0026732,0,0,1,1,2
"94258",47129000,1000,0.0025174,0,0,0,1,1
"94259",47129500,1000,0.00252326,0,0,0,0,0
"94260",47130000,1000,0.00263169,0,0,1,1,2
"94261",47130500,1000,0.00276436,0,0,2,1,3
"94262",47131000,1000,0.00277548,0,0,1,0,1
"94263",47131500,1000,0.00279697,0,0,1,1,2
"94264",47132000,1000,0.00265314,0,0,1,1,2
"94265",47132500,1000,0.00239895,0,0,0,0,0
"94266",47133000,1000,0.00258933,0,0,0,2,2
"94267",47133500,1000,0.00275702,0,0,0,3,3
"94268",47134000,1000,0.00259124,0,0,0,1,1
"94269",47134500,1000,0.00258266,0,0,0,2,2
"94270",47135000,1000,0.00268707,0,0,0,2,2
"94271",47135500,1000,0.00264987,0,0,0,2,2
"94272",47136000,1000,0.0025798,0,0,0,2,2
"94273",47136500,1000,0.00257933,0,0,1,0,1
"94274",47137000,1000,0.00262486,0,0,1,0,1
"94275",47137500,1000,0.0025849,0,0,0,0,0
"94276",47138000,1000,0.00257336,0,0,0,0,0
"94277",47138500,1000,0.00261885,0,0,0,0,0
"94278",47139000,1000,0.00291343,0,1,1,2,4
"94279",47139500,1000,0.00284669,0,1,1,2,4
"94280",47140000,1000,0.00256954,0,0,0,1,1
"94281",47140500,1000,0.00253532,0,0,0,1,1
"94282",47141000,1000,0.0023931,0,0,0,0,0
"94283",47141500,1000,0.00233087,0,0,0,0,0
"94284",47142000,1000,0.0024486,0,0,0,1,1
"94285",47142500,1000,0.00265695,0,0,1,2,3
"94286",47143000,1000,0.00269495,0,0,1,2,3
"94287",47143500,1000,0.00250585,0,0,0,1,1
"94288",47144000,1000,0.00246863,0,0,0,0,0
"94289",47144500,1000,0.00256133,0,0,0,0,0
"94290",47145000,1000,0.00252458,0,0,0,0,0
"94291",47145500,1000,0.00265742,0,0,1,0,1
"94292",47146000,1000,0.00275986,0,0,1,2,3
"94293",47146500,1000,0.00267692,0,0,0,2,2
"94294",47147000,1000,0.00267087,0,0,1,1,2
"94295",47147500,1000,0.00280415,0,1,1,1,3
"94296",47148000,1000,0.00281054,0,1,0,1,2
"94297",47148500,1000,0.00273664,0,0,1,1,2
"94298",47149000,1000,0.00280293,0,0,1,1,2
"94299",47149500,1000,0.00272866,0,0,0,2,2
"94300",47150000,1000,0.00262593,0,0,0,1,1
"94301",47150500,1000,0.00264303,0,0,0,0,0
"94302",47151000,1000,0.00267028,0,0,0,0,0
"94303",47151500,1000,0.00260777,0,0,0,0,0
"94304",47152000,1000,0.00249203,0,0,0,0,0
"94305",47152500,1000,0.00248621,0,0,0,0,0
"94306",47153000,1000,0.00252978,0,0,0,0,0
"94307",47153500,1000,0.00258717,0,0,0,1,1
"94308",47154000,1000,0.00246499,0,0,0,1,1
"94309",47154500,1000,0.00239192,0,0,0,0,0
"94310",47155000,1000,0.00255777,0,0,0,0,0
"94311",47155500,1000,0.00263044,0,0,0,0,0
"94312",47156000,1000,0.00273241,0,0,1,1,2
"94313",47156500,1000,0.00275222,0,0,1,2,3
"94314",47157000,1000,0.00265401,0,0,0,1,1
"94315",47157500,1000,0.00257984,0,0,0,0,0
"94316",47158000,1000,0.0025353,0,0,0,0,0
"94317",47158500,1000,0.00260834,0,0,0,0,0
"94318",47159000,1000,0.00272667,0,0,0,0,0
"94319",47159500,1000,0.00274991,0,0,0,0,0
"94320",47160000,1000,0.00269068,0,0,0,0,0
"94321",47160500,1000,0.0026491,0,0,0,0,0
"94322",47161000,1000,0.00250509,0,0,0,0,0
"94323",47161500,1000,0.00268524,0,0,1,2,3
"94324",47162000,1000,0.00278007,0,0,1,2,3
"94325",47162500,1000,0.00242762,0,0,0,0,0
"94326",47163000,1000,0.00247723,0,0,0,0,0
"94327",47163500,1000,0.00275662,0,0,1,0,1
"94328",47164000,1000,0.00265241,0,0,1,0,1
"94329",47164500,1000,0.00254059,0,0,0,1,1
"94330",47165000,1000,0.00261505,0,0,0,1,1
"94331",47165500,1000,0.00249366,0,0,0,0,0
"94332",47166000,1000,0.00243377,0,0,0,0,0
"94333",47166500,1000,0.00254372,0,0,0,0,0
"94334",47167000,1000,0.00253888,0,0,0,0,0
"94335",47167500,1000,0.00249152,0,0,0,0,0
"94336",47168000,1000,0.00263255,0,0,0,1,1
"94337",47168500,1000,0.00260373,0,0,0,1,1
"94338",47169000,1000,0.00265875,0,0,0,2,2
"94339",47169500,1000,0.00269992,0,0,0,3,3
"94340",47170000,1000,0.00257616,0,0,0,1,1
"94341",47170500,1000,0.00248278,0,0,0,0,0
"94342",47171000,1000,0.00242907,0,0,0,0,0
"94343",47171500,1000,0.00247352,0,0,0,0,0
"94344",47172000,1000,0.00237662,0,0,0,0,0
"94345",47172500,1000,0.0023942,0,0,0,0,0
"94346",47173000,1000,0.00249996,0,0,0,0,0
"94347",47173500,1000,0.0026114,0,0,1,1,2
"94348",47174000,1000,0.00264759,0,0,1,1,2
"94349",47174500,1000,0.00260983,0,0,0,1,1
"94350",47175000,1000,0.00258212,0,0,0,1,1
"94351",47175500,1000,0.00259263,0,0,0,0,0
"94352",47176000,1000,0.00262567,0,0,0,0,0
"94353",47176500,1000,0.00252186,0,0,0,0,0
"94354",47177000,1000,0.00252922,0,0,0,1,1
"94355",47177500,1000,0.00260476,0,0,0,1,1
"94356",47178000,1000,0.00258352,0,0,0,0,0
"94357",47178500,1000,0.00248809,0,0,0,0,0
"94358",47179000,1000,0.00255694,0,0,0,0,0
"94359",47179500,1000,0.00258843,0,0,0,0,0
"94360",47180000,1000,0.00247804,0,0,0,0,0
"94361",47180500,1000,0.00245658,0,0,0,0,0
"94362",47181000,1000,0.00247541,0,0,0,0,0
"94363",47181500,1000,0.00246751,0,0,0,0,0
"94364",47182000,1000,0.00254403,0,0,0,0,0
"94365",47182500,1000,0.00266193,0,0,0,0,0
"94366",47183000,1000,0.0025419,0,0,0,0,0
"94367",47183500,1000,0.0024462,0,0,0,0,0
"94368",47184000,1000,0.00253181,0,0,0,0,0
"94369",47184500,1000,0.00264251,0,0,0,0,0
"94370",47185000,1000,0.0026894,0,0,1,1,2
"94371",47185500,1000,0.00258029,0,0,1,2,3
"94372",47186000,1000,0.00257203,0,0,0,1,1
"94373",47186500,1000,0.00256335,0,0,0,0,0
"94374",47187000,1000,0.00246404,0,0,0,0,0
"94375",47187500,1000,0.00258378,0,0,1,1,2
"94376",47188000,1000,0.0027173,0,0,1,2,3
"94377",47188500,1000,0.00261174,0,0,0,1,1
"94378",47189000,1000,0.00247859,0,0,0,0,0
"94379",47189500,1000,0.00244019,0,0,0,0,0
"94380",47190000,1000,0.00242882,0,0,0,0,0
"94381",47190500,1000,0.00266378,0,1,0,0,1
"94382",47191000,1000,0.00274788,0,1,0,0,1
"94383",47191500,1000,0.00266889,0,0,0,1,1
"94384",47192000,1000,0.00287872,0,0,2,2,4
"94385",47192500,1000,0.00289677,0,0,2,2,4
"94386",47193000,1000,0.00286521,0,0,1,1,2
"94387",47193500,1000,0.002779,0,0,1,0,1
"94388",47194000,1000,0.00260319,0,0,0,1,1
"94389",47194500,1000,0.00265555,0,0,0,1,1
"94390",47195000,1000,0.0026618,0,0,0,0,0
"94391",47195500,1000,0.00272213,0,0,0,1,1
"94392",47196000,1000,0.00265108,0,0,0,1,1
"94393",47196500,1000,0.00247842,0,0,0,0,0
"94394",47197000,1000,0.00254482,0,0,0,1,1
"94395",47197500,1000,0.00266057,0,0,0,1,1
"94396",47198000,1000,0.00277523,0,0,0,2,2
"94397",47198500,1000,0.00273238,0,0,0,2,2
"94398",47199000,1000,0.00259209,0,0,0,1,1
"94399",47199500,1000,0.00261515,0,0,0,3,3
"94400",47200000,1000,0.00266283,0,0,0,2,2
"94401",47200500,1000,0.00273567,0,0,0,2,2
"94402",47201000,1000,0.00266999,0,0,0,2,2
"94403",47201500,1000,0.00262735,0,0,0,2,2
"94404",47202000,1000,0.00267029,0,0,0,4,4
"94405",47202500,1000,0.00249463,0,0,0,2,2
"94406",47203000,1000,0.00251097,0,0,0,3,3
"94407",47203500,1000,0.00261434,0,0,0,3,3
"94408",47204000,1000,0.00264215,0,0,0,0,0
"94409",47204500,1000,0.00265925,0,0,0,0,0
"94410",47205000,1000,0.00262584,0,0,0,0,0
"94411",47205500,1000,0.00263443,0,0,0,0,0
"94412",47206000,1000,0.00252937,0,0,0,0,0
"94413",47206500,1000,0.00279822,0,1,0,0,1
"94414",47207000,1000,0.002956,0,1,0,0,1
"94415",47207500,1000,0.00262343,0,0,0,0,0
"94416",47208000,1000,0.00263137,0,0,0,2,2
"94417",47208500,1000,0.00270322,0,0,0,2,2
"94418",47209000,1000,0.00261494,0,0,0,0,0
"94419",47209500,1000,0.00260345,0,0,0,0,0
"94420",47210000,1000,0.00262742,0,0,0,0,0
"94421",47210500,1000,0.00273862,0,0,0,2,2
"94422",47211000,1000,0.00266778,0,0,0,2,2
"94423",47211500,1000,0.00267336,0,0,0,1,1
"94424",47212000,1000,0.00277135,0,0,1,2,3
"94425",47212500,1000,0.00269695,0,0,1,1,2
"94426",47213000,1000,0.00257381,0,0,0,0,0
"94427",47213500,1000,0.00259092,0,0,0,1,1
"94428",47214000,1000,0.00266704,0,0,0,1,1
"94429",47214500,1000,0.00251426,0,0,0,0,0
"94430",47215000,1000,0.00244487,0,0,0,0,0
"94431",47215500,1000,0.00256516,0,0,0,1,1
"94432",47216000,1000,0.00262914,0,0,0,1,1
"94433",47216500,1000,0.00263066,0,0,0,0,0
"94434",47217000,1000,0.00291338,0,0,2,0,2
"94435",47217500,1000,0.00282479,0,0,2,0,2
"94436",47218000,1000,0.00245761,0,0,0,0,0
"94437",47218500,1000,0.00262231,0,0,0,2,2
"94438",47219000,1000,0.00274373,0,0,0,3,3
"94439",47219500,1000,0.00264653,0,0,0,1,1
"94440",47220000,1000,0.00266434,0,0,0,0,0
"94441",47220500,1000,0.00275834,0,0,0,1,1
"94442",47221000,1000,0.00263572,0,0,0,1,1
"94443",47221500,1000,0.00276775,0,0,1,1,2
"94444",47222000,1000,0.00284918,0,0,1,1,2
"94445",47222500,1000,0.00263273,0,0,0,0,0
"94446",47223000,1000,0.00262125,0,0,0,0,0
"94447",47223500,1000,0.00269947,0,0,0,0,0
"94448",47224000,1000,0.0027493,0,0,0,0,0
"94449",47224500,1000,0.00283953,0,0,2,0,2
"94450",47225000,1000,0.00275575,0,0,2,0,2
"94451",47225500,1000,0.00260543,0,0,0,0,0
"94452",47226000,1000,0.00266284,0,0,0,0,0
"94453",47226500,1000,0.00272558,0,0,1,0,1
"94454",47227000,1000,0.00280866,0,0,1,2,3
"94455",47227500,1000,0.00269938,0,0,0,2,2
"94456",47228000,1000,0.00274239,0,0,1,0,1
"94457",47228500,1000,0.00282786,0,0,1,2,3
"94458",47229000,1000,0.00271192,0,0,1,3,4
"94459",47229500,1000,0.0027042,0,0,1,1,2
"94460",47230000,1000,0.00263422,0,0,0,0,0
"94461",47230500,1000,0.00263471,0,0,0,0,0
"94462",47231000,1000,0.00281247,0,0,1,0,1
"94463",47231500,1000,0.00275549,0,0,1,0,1
"94464",47232000,1000,0.00263443,0,0,0,0,0
"94465",47232500,1000,0.00259309,0,0,0,0,0
"94466",47233000,1000,0.00268539,0,0,0,2,2
"94467",47233500,1000,0.00280628,0,0,0,3,3
"94468",47234000,1000,0.00282305,0,0,1,2,3
"94469",47234500,1000,0.00272448,0,0,1,2,3
"94470",47235000,1000,0.00267231,0,0,0,2,2
"94471",47235500,1000,0.00273506,0,0,0,1,1
"94472",47236000,1000,0.00261967,0,0,0,0,0
"94473",47236500,1000,0.0026009,0,0,0,0,0
"94474",47237000,1000,0.002761,0,0,0,0,0
"94475",47237500,1000,0.0027581,0,0,0,0,0
"94476",47238000,1000,0.00272168,0,0,0,1,1
"94477",47238500,1000,0.00262891,0,0,0,1,1
"94478",47239000,1000,0.0024694,0,0,0,0,0
"94479",47239500,1000,0.0026698,0,1,0,0,1
"94480",47240000,1000,0.00278693,0,1,0,0,1
"94481",47240500,1000,0.00274113,0,0,0,0,0
"94482",47241000,1000,0.00283227,0,0,1,1,2
"94483",47241500,1000,0.00281916,0,0,1,1,2
"94484",47242000,1000,0.00289538,0,1,0,0,1
"94485",47242500,1000,0.00281732,0,1,0,1,2
"94486",47243000,1000,0.00277383,0,0,1,3,4
"94487",47243500,1000,0.00271979,0,0,1,2,3
"94488",47244000,1000,0.00255424,0,0,0,1,1
"94489",47244500,1000,0.00279934,0,0,0,3,3
"94490",47245000,1000,0.00282723,0,0,0,2,2
"94491",47245500,1000,0.00264983,0,0,0,1,1
"94492",47246000,1000,0.00271682,0,0,0,2,2
"94493",47246500,1000,0.00266998,0,0,0,1,1
"94494",47247000,1000,0.0026781,0,0,1,0,1
"94495",47247500,1000,0.00270867,0,0,1,0,1
"94496",47248000,1000,0.00259796,0,0,0,1,1
"94497",47248500,1000,0.00274934,0,0,1,3,4
"94498",47249000,1000,0.00275951,0,0,1,2,3
"94499",47249500,1000,0.00257134,0,0,0,0,0
"94500",47250000,1000,0.00257292,0,0,0,0,0
"94501",47250500,1000,0.00288573,0,1,0,3,4
"94502",47251000,1000,0.00288339,0,1,0,3,4
"94503",47251500,1000,0.00262844,0,0,0,0,0
"94504",47252000,1000,0.00261842,0,0,0,0,0
"94505",47252500,1000,0.00267356,0,0,1,0,1
"94506",47253000,1000,0.00263039,0,0,1,0,1
"94507",47253500,1000,0.00249027,0,0,0,0,0
"94508",47254000,1000,0.00243695,0,0,0,0,0
"94509",47254500,1000,0.0024671,0,0,0,1,1
"94510",47255000,1000,0.00255156,0,0,0,1,1
"94511",47255500,1000,0.00263214,0,0,0,0,0
"94512",47256000,1000,0.00270345,0,0,0,1,1
"94513",47256500,1000,0.00280187,0,0,0,3,3
"94514",47257000,1000,0.00272036,0,0,0,2,2
"94515",47257500,1000,0.00262529,0,0,0,1,1
"94516",47258000,1000,0.00267601,0,0,0,2,2
"94517",47258500,1000,0.00260237,0,0,0,1,1
"94518",47259000,1000,0.00252218,0,0,0,1,1
"94519",47259500,1000,0.00266276,0,0,0,3,3
"94520",47260000,1000,0.00269371,0,0,0,2,2
"94521",47260500,1000,0.00259664,0,0,0,1,1
"94522",47261000,1000,0.00263393,0,0,0,1,1
"94523",47261500,1000,0.00256091,0,0,0,0,0
"94524",47262000,1000,0.0026443,0,0,1,0,1
"94525",47262500,1000,0.00270154,0,0,1,0,1
"94526",47263000,1000,0.00273711,0,0,0,1,1
"94527",47263500,1000,0.00282947,0,0,0,3,3
"94528",47264000,1000,0.00276262,0,0,0,3,3
"94529",47264500,1000,0.0027493,0,0,0,2,2
"94530",47265000,1000,0.00263759,0,0,0,1,1
"94531",47265500,1000,0.00260405,0,0,1,0,1
"94532",47266000,1000,0.0028322,0,0,2,2,4
"94533",47266500,1000,0.00278099,0,0,1,3,4
"94534",47267000,1000,0.00271927,0,0,0,2,2
"94535",47267500,1000,0.00268624,0,0,0,1,1
"94536",47268000,1000,0.00246828,0,0,0,0,0
"94537",47268500,1000,0.00258115,0,0,1,1,2
"94538",47269000,1000,0.00273185,0,0,2,1,3
"94539",47269500,1000,0.00270593,0,0,1,1,2
"94540",47270000,1000,0.00278219,0,0,0,2,2
"94541",47270500,1000,0.00275082,0,0,0,1,1
"94542",47271000,1000,0.00264699,0,0,0,0,0
"94543",47271500,1000,0.00270059,0,0,0,2,2
"94544",47272000,1000,0.00293001,0,1,0,3,4
"94545",47272500,1000,0.00281439,0,1,0,2,3
"94546",47273000,1000,0.00265606,0,0,0,1,1
"94547",47273500,1000,0.00289559,0,1,0,0,1
"94548",47274000,1000,0.00281336,0,1,0,0,1
"94549",47274500,1000,0.00264693,0,0,0,0,0
"94550",47275000,1000,0.00262273,0,0,0,0,0
"94551",47275500,1000,0.00262718,0,0,0,0,0
"94552",47276000,1000,0.00274657,0,0,0,1,1
"94553",47276500,1000,0.00272181,0,0,0,1,1
"94554",47277000,1000,0.00259852,0,0,0,0,0
"94555",47277500,1000,0.00256247,0,0,0,0,0
"94556",47278000,1000,0.00271375,0,0,0,1,1
"94557",47278500,1000,0.0029334,0,1,0,1,2
"94558",47279000,1000,0.00289065,0,1,0,2,3
"94559",47279500,1000,0.00290722,0,1,0,2,3
"94560",47280000,1000,0.0028565,0,1,0,1,2
"94561",47280500,1000,0.00265325,0,0,0,1,1
"94562",47281000,1000,0.00264728,0,0,0,0,0
"94563",47281500,1000,0.00263541,0,0,0,0,0
"94564",47282000,1000,0.00263453,0,0,1,0,1
"94565",47282500,1000,0.00275041,0,0,2,0,2
"94566",47283000,1000,0.00291935,0,1,1,0,2
"94567",47283500,1000,0.00290675,0,1,0,2,3
"94568",47284000,1000,0.00270134,0,0,0,2,2
"94569",47284500,1000,0.00258562,0,0,0,1,1
"94570",47285000,1000,0.0025713,0,0,0,1,1
"94571",47285500,1000,0.00253243,0,0,0,0,0
"94572",47286000,1000,0.00261792,0,0,0,0,0
"94573",47286500,1000,0.00277786,0,0,0,0,0
"94574",47287000,1000,0.00271282,0,0,0,0,0
"94575",47287500,1000,0.00260432,0,0,0,1,1
"94576",47288000,1000,0.00257191,0,0,0,2,2
"94577",47288500,1000,0.00298118,0,1,0,3,4
"94578",47289000,1000,0.00304629,0,1,0,2,3
"94579",47289500,1000,0.0027197,0,0,0,0,0
"94580",47290000,1000,0.00271907,0,0,0,0,0
"94581",47290500,1000,0.00286272,0,0,1,1,2
"94582",47291000,1000,0.0028104,0,0,1,1,2
"94583",47291500,1000,0.00265008,0,0,0,0,0
"94584",47292000,1000,0.00275644,0,0,0,1,1
"94585",47292500,1000,0.00273742,0,0,0,1,1
"94586",47293000,1000,0.00268936,0,0,0,0,0
"94587",47293500,1000,0.0027539,0,0,1,0,1
"94588",47294000,1000,0.00275665,0,0,1,0,1
"94589",47294500,1000,0.00273435,0,0,0,0,0
"94590",47295000,1000,0.00291445,0,0,1,0,1
"94591",47295500,1000,0.00301965,0,1,1,0,2
"94592",47296000,1000,0.00277162,0,1,0,0,1
"94593",47296500,1000,0.00258686,0,0,0,0,0
"94594",47297000,1000,0.0028751,0,1,0,2,3
"94595",47297500,1000,0.00280447,0,1,0,2,3
"94596",47298000,1000,0.00280973,0,1,0,1,2
"94597",47298500,1000,0.00307871,0,1,1,2,4
"94598",47299000,1000,0.00284264,0,0,1,1,2
"94599",47299500,1000,0.00272718,0,0,0,0,0
"94600",47300000,1000,0.00268796,0,0,0,0,0
"94601",47300500,1000,0.00270326,0,0,0,0,0
"94602",47301000,1000,0.00271714,0,0,0,0,0
"94603",47301500,1000,0.0027659,0,0,0,1,1
"94604",47302000,1000,0.00283024,0,0,0,1,1
"94605",47302500,1000,0.00273023,0,0,0,0,0
"94606",47303000,1000,0.00262303,0,0,0,0,0
"94607",47303500,1000,0.00262423,0,0,0,0,0
"94608",47304000,1000,0.0026713,0,0,0,0,0
"94609",47304500,1000,0.00273575,0,0,0,2,2
"94610",47305000,1000,0.00277008,0,0,0,3,3
"94611",47305500,1000,0.00261834,0,0,0,1,1
"94612",47306000,1000,0.00285942,0,1,0,1,2
"94613",47306500,1000,0.00295658,0,1,0,3,4
"94614",47307000,1000,0.00269571,0,0,0,2,2
"94615",47307500,1000,0.00266336,0,0,0,0,0
"94616",47308000,1000,0.00256858,0,0,0,0,0
"94617",47308500,1000,0.00263657,0,0,1,1,2
"94618",47309000,1000,0.00272776,0,0,1,2,3
"94619",47309500,1000,0.00271277,0,0,0,2,2
"94620",47310000,1000,0.00271751,0,0,0,1,1
"94621",47310500,1000,0.00271011,0,0,0,0,0
"94622",47311000,1000,0.00271963,0,0,0,0,0
"94623",47311500,1000,0.00262846,0,0,0,0,0
"94624",47312000,1000,0.00253316,0,0,0,0,0
"94625",47312500,1000,0.00254927,0,0,0,1,1
"94626",47313000,1000,0.00265481,0,0,1,2,3
"94627",47313500,1000,0.00280989,0,0,2,2,4
"94628",47314000,1000,0.00284084,0,0,1,3,4
"94629",47314500,1000,0.00266698,0,0,0,2,2
"94630",47315000,1000,0.0025486,0,0,0,1,1
"94631",47315500,1000,0.00253724,0,0,0,1,1
"94632",47316000,1000,0.00267796,0,1,0,0,1
"94633",47316500,1000,0.00277534,0,1,0,2,3
"94634",47317000,1000,0.00269456,0,0,0,3,3
"94635",47317500,1000,0.00261862,0,0,0,1,1
"94636",47318000,1000,0.00253821,0,0,0,0,0
"94637",47318500,1000,0.00268037,0,1,0,0,1
"94638",47319000,1000,0.00281639,0,1,1,1,3
"94639",47319500,1000,0.00262365,0,0,1,1,2
"94640",47320000,1000,0.00250922,0,0,0,0,0
"94641",47320500,1000,0.00259285,0,0,0,1,1
"94642",47321000,1000,0.00264547,0,0,0,3,3
"94643",47321500,1000,0.00258185,0,0,0,2,2
"94644",47322000,1000,0.00256549,0,0,0,1,1
"94645",47322500,1000,0.00252675,0,0,0,1,1
"94646",47323000,1000,0.00241779,0,0,0,0,0
"94647",47323500,1000,0.00247391,0,0,0,2,2
"94648",47324000,1000,0.00256793,0,0,0,3,3
"94649",47324500,1000,0.00260168,0,0,0,2,2
"94650",47325000,1000,0.00269123,0,0,0,2,2
"94651",47325500,1000,0.00259158,0,0,0,1,1
"94652",47326000,1000,0.00246547,0,0,0,0,0
"94653",47326500,1000,0.00246983,0,0,0,0,0
"94654",47327000,1000,0.00265602,0,0,0,2,2
"94655",47327500,1000,0.00296456,0,0,1,3,4
"94656",47328000,1000,0.00278989,0,0,1,1,2
"94657",47328500,1000,0.00253616,0,0,0,0,0
"94658",47329000,1000,0.00248579,0,0,0,0,0
"94659",47329500,1000,0.0024402,0,0,0,0,0
"94660",47330000,1000,0.00250554,0,0,0,0,0
"94661",47330500,1000,0.00248856,0,0,0,0,0
"94662",47331000,1000,0.00255203,0,0,0,2,2
"94663",47331500,1000,0.00261746,0,0,0,2,2
"94664",47332000,1000,0.00250589,0,0,0,0,0
"94665",47332500,1000,0.00252776,0,0,0,0,0
"94666",47333000,1000,0.00253778,0,0,0,0,0
"94667",47333500,1000,0.00245372,0,0,0,0,0
"94668",47334000,1000,0.00242325,0,0,0,0,0
"94669",47334500,1000,0.00251525,0,0,0,1,1
"94670",47335000,1000,0.00258977,0,0,0,1,1
"94671",47335500,1000,0.00257431,0,0,0,0,0
"94672",47336000,1000,0.00255659,0,0,0,0,0
"94673",47336500,1000,0.00274155,0,0,1,3,4
"94674",47337000,1000,0.00270616,0,0,1,3,4
"94675",47337500,1000,0.00248083,0,0,0,0,0
"94676",47338000,1000,0.00262963,0,0,0,2,2
"94677",47338500,1000,0.0025674,0,0,0,2,2
"94678",47339000,1000,0.0024694,0,0,0,0,0
"94679",47339500,1000,0.00261301,0,0,0,0,0
"94680",47340000,1000,0.00256562,0,0,0,0,0
"94681",47340500,1000,0.00251719,0,0,0,1,1
"94682",47341000,1000,0.00260379,0,0,0,1,1
"94683",47341500,1000,0.00264011,0,0,0,1,1
"94684",47342000,1000,0.00261815,0,0,0,1,1
"94685",47342500,1000,0.00253817,0,0,0,0,0
"94686",47343000,1000,0.00251433,0,0,0,0,0
"94687",47343500,1000,0.00250427,0,0,0,0,0
"94688",47344000,1000,0.00259197,0,0,0,1,1
"94689",47344500,1000,0.00266287,0,0,1,1,2
"94690",47345000,1000,0.00271735,0,1,1,0,2
"94691",47345500,1000,0.00280275,0,1,0,1,2
"94692",47346000,1000,0.00259583,0,0,0,1,1
"94693",47346500,1000,0.00246162,0,0,0,0,0
"94694",47347000,1000,0.00257333,0,0,0,2,2
"94695",47347500,1000,0.00259414,0,0,0,2,2
"94696",47348000,1000,0.00241818,0,0,0,0,0
"94697",47348500,1000,0.00236303,0,0,0,0,0
"94698",47349000,1000,0.00257059,0,0,0,0,0
"94699",47349500,1000,0.00264425,0,0,1,0,1
"94700",47350000,1000,0.00261314,0,0,1,1,2
"94701",47350500,1000,0.00280392,0,1,0,1,2
"94702",47351000,1000,0.00271959,0,1,0,0,1
"94703",47351500,1000,0.00252367,0,0,0,0,0
"94704",47352000,1000,0.00266991,0,0,1,1,2
"94705",47352500,1000,0.002587,0,0,1,1,2
"94706",47353000,1000,0.0024665,0,0,0,0,0
"94707",47353500,1000,0.00264871,0,0,1,0,1
"94708",47354000,1000,0.0027611,0,0,2,0,2
"94709",47354500,1000,0.00269803,0,0,1,0,1
"94710",47355000,1000,0.00261033,0,0,0,0,0
"94711",47355500,1000,0.00267209,0,1,0,0,1
"94712",47356000,1000,0.00275865,0,1,0,1,2
"94713",47356500,1000,0.00286363,0,0,0,2,2
"94714",47357000,1000,0.00284997,0,0,0,1,1
"94715",47357500,1000,0.00274508,0,0,0,2,2
"94716",47358000,1000,0.00256983,0,0,0,2,2
"94717",47358500,1000,0.00247026,0,0,0,0,0
"94718",47359000,1000,0.00260782,0,0,0,1,1
"94719",47359500,1000,0.00260851,0,0,0,1,1
"94720",47360000,1000,0.00259421,0,0,0,1,1
"94721",47360500,1000,0.00254397,0,0,0,1,1
"94722",47361000,1000,0.00252943,0,0,0,0,0
"94723",47361500,1000,0.00251913,0,0,0,0,0
"94724",47362000,1000,0.00249961,0,0,0,1,1
"94725",47362500,1000,0.00263198,0,0,0,1,1
"94726",47363000,1000,0.00276533,0,0,0,1,1
"94727",47363500,1000,0.00264539,0,0,0,1,1
"94728",47364000,1000,0.00253045,0,0,0,0,0
"94729",47364500,1000,0.00273851,0,0,1,1,2
"94730",47365000,1000,0.00286589,0,1,1,1,3
"94731",47365500,1000,0.00275868,0,1,0,0,1
"94732",47366000,1000,0.00260129,0,0,0,1,1
"94733",47366500,1000,0.00249484,0,0,0,1,1
"94734",47367000,1000,0.002421,0,0,0,0,0
"94735",47367500,1000,0.00262328,0,0,0,0,0
"94736",47368000,1000,0.00277696,0,0,0,1,1
"94737",47368500,1000,0.00262487,0,0,0,1,1
"94738",47369000,1000,0.00262103,0,0,0,1,1
"94739",47369500,1000,0.00251619,0,0,0,1,1
"94740",47370000,1000,0.00244569,0,0,0,0,0
"94741",47370500,1000,0.002617,0,0,0,2,2
"94742",47371000,1000,0.00259399,0,0,0,2,2
"94743",47371500,1000,0.00258226,0,0,0,1,1
"94744",47372000,1000,0.00250608,0,0,0,1,1
"94745",47372500,1000,0.00245228,0,0,0,0,0
"94746",47373000,1000,0.00254109,0,0,0,0,0
"94747",47373500,1000,0.00248578,0,0,0,0,0
"94748",47374000,1000,0.00240778,0,0,0,0,0
"94749",47374500,1000,0.00245748,0,0,0,0,0
"94750",47375000,1000,0.00256128,0,0,0,0,0
"94751",47375500,1000,0.00259456,0,0,0,2,2
"94752",47376000,1000,0.00260328,0,0,0,3,3
"94753",47376500,1000,0.00267128,0,0,0,2,2
"94754",47377000,1000,0.00269666,0,0,0,2,2
"94755",47377500,1000,0.00263771,0,0,0,1,1
"94756",47378000,1000,0.00256722,0,0,0,0,0
"94757",47378500,1000,0.00250345,0,0,0,0,0
"94758",47379000,1000,0.00247912,0,0,0,0,0
"94759",47379500,1000,0.00236701,0,0,0,0,0
"94760",47380000,1000,0.00253501,0,0,0,0,0
"94761",47380500,1000,0.00265244,0,0,0,0,0
"94762",47381000,1000,0.00265197,0,0,0,2,2
"94763",47381500,1000,0.00259609,0,0,0,2,2
"94764",47382000,1000,0.00258782,0,0,0,0,0
"94765",47382500,1000,0.00268236,0,0,0,0,0
"94766",47383000,1000,0.00262455,0,0,0,0,0
"94767",47383500,1000,0.00267532,0,0,0,0,0
"94768",47384000,1000,0.00254181,0,0,0,0,0
"94769",47384500,1000,0.00266811,0,0,1,2,3
"94770",47385000,1000,0.00281776,0,0,1,2,3
"94771",47385500,1000,0.00265853,0,0,0,0,0
"94772",47386000,1000,0.00277438,0,0,0,1,1
"94773",47386500,1000,0.00273817,0,0,0,1,1
"94774",47387000,1000,0.00257494,0,0,0,0,0
"94775",47387500,1000,0.00285239,0,1,1,1,3
"94776",47388000,1000,0.00286927,0,1,1,1,3
"94777",47388500,1000,0.00255383,0,0,0,0,0
"94778",47389000,1000,0.00262735,0,0,0,1,1
"94779",47389500,1000,0.00265301,0,0,0,1,1
"94780",47390000,1000,0.00252954,0,0,0,0,0
"94781",47390500,1000,0.00248841,0,0,0,0,0
"94782",47391000,1000,0.00245296,0,0,0,0,0
"94783",47391500,1000,0.00244375,0,0,0,1,1
"94784",47392000,1000,0.00250433,0,0,0,1,1
"94785",47392500,1000,0.00253307,0,0,0,0,0
"94786",47393000,1000,0.00268328,0,1,0,0,1
"94787",47393500,1000,0.0026274,0,1,0,0,1
"94788",47394000,1000,0.00246608,0,0,0,0,0
"94789",47394500,1000,0.00249941,0,0,0,1,1
"94790",47395000,1000,0.0025115,0,0,0,1,1
"94791",47395500,1000,0.00256302,0,0,1,0,1
"94792",47396000,1000,0.00247523,0,0,1,0,1
"94793",47396500,1000,0.00245794,0,0,0,0,0
"94794",47397000,1000,0.00255718,0,0,0,0,0
"94795",47397500,1000,0.0025507,0,0,0,0,0
"94796",47398000,1000,0.00247995,0,0,0,0,0
"94797",47398500,1000,0.00250673,0,0,0,0,0
"94798",47399000,1000,0.00257791,0,0,0,1,1
"94799",47399500,1000,0.00262529,0,0,0,1,1
"94800",47400000,1000,0.0026641,0,0,0,1,1
"94801",47400500,1000,0.00260158,0,0,0,1,1
"94802",47401000,1000,0.00258267,0,0,0,0,0
"94803",47401500,1000,0.0026441,0,0,0,2,2
"94804",47402000,1000,0.00257812,0,0,0,2,2
"94805",47402500,1000,0.00276422,0,0,2,1,3
"94806",47403000,1000,0.00279601,0,0,2,1,3
"94807",47403500,1000,0.00256158,0,0,0,0,0
"94808",47404000,1000,0.00251263,0,0,0,0,0
"94809",47404500,1000,0.00252676,0,0,0,0,0
"94810",47405000,1000,0.002464,0,0,0,0,0
"94811",47405500,1000,0.00232872,0,0,0,0,0
"94812",47406000,1000,0.00247952,0,0,0,1,1
"94813",47406500,1000,0.00256788,0,0,0,1,1
"94814",47407000,1000,0.00250437,0,0,0,0,0
"94815",47407500,1000,0.00258404,0,0,0,1,1
"94816",47408000,1000,0.00265332,0,0,0,3,3
"94817",47408500,1000,0.00248307,0,0,0,2,2
"94818",47409000,1000,0.00238908,0,0,0,0,0
"94819",47409500,1000,0.00243572,0,0,0,0,0
"94820",47410000,1000,0.00256804,0,0,1,0,1
"94821",47410500,1000,0.00264383,0,0,1,1,2
"94822",47411000,1000,0.00250213,0,0,0,1,1
"94823",47411500,1000,0.00260354,0,0,0,1,1
"94824",47412000,1000,0.0027364,0,0,0,1,1
"94825",47412500,1000,0.00258781,0,0,0,0,0
"94826",47413000,1000,0.002442,0,0,0,0,0
"94827",47413500,1000,0.00240171,0,0,0,0,0
"94828",47414000,1000,0.00262413,0,0,1,0,1
"94829",47414500,1000,0.00271598,0,0,1,1,2
"94830",47415000,1000,0.00258552,0,0,0,1,1
"94831",47415500,1000,0.00262592,0,0,0,0,0
"94832",47416000,1000,0.00260039,0,0,0,1,1
"94833",47416500,1000,0.00261363,0,0,0,1,1
"94834",47417000,1000,0.00269387,0,0,0,1,1
"94835",47417500,1000,0.00274511,0,0,0,2,2
"94836",47418000,1000,0.00258894,0,0,0,1,1
"94837",47418500,1000,0.00243182,0,0,0,0,0
"94838",47419000,1000,0.00250708,0,0,0,0,0
"94839",47419500,1000,0.00262767,0,0,0,1,1
"94840",47420000,1000,0.0026602,0,0,0,1,1
"94841",47420500,1000,0.00254076,0,0,0,0,0
"94842",47421000,1000,0.00253966,0,0,0,0,0
"94843",47421500,1000,0.00257272,0,0,0,0,0
"94844",47422000,1000,0.00247798,0,0,0,0,0
"94845",47422500,1000,0.00244509,0,0,0,0,0
"94846",47423000,1000,0.00235708,0,0,0,0,0
"94847",47423500,1000,0.00238158,0,0,0,0,0
"94848",47424000,1000,0.0024931,0,0,0,0,0
"94849",47424500,1000,0.00259319,0,0,0,1,1
"94850",47425000,1000,0.00299675,0,1,2,2,5
"94851",47425500,1000,0.00298404,0,1,2,2,5
"94852",47426000,1000,0.00274337,0,0,0,1,1
"94853",47426500,1000,0.00250198,0,0,0,0,0
"94854",47427000,1000,0.00230632,0,0,0,0,0
"94855",47427500,1000,0.00239225,0,0,0,0,0
"94856",47428000,1000,0.00239397,0,0,0,0,0
"94857",47428500,1000,0.00240176,0,0,0,0,0
"94858",47429000,1000,0.00237357,0,0,0,0,0
"94859",47429500,1000,0.00268434,0,1,0,1,2
"94860",47430000,1000,0.00279966,0,1,0,1,2
"94861",47430500,1000,0.00242465,0,0,0,0,0
"94862",47431000,1000,0.00231682,0,0,0,0,0
"94863",47431500,1000,0.0024485,0,0,0,0,0
"94864",47432000,1000,0.00254349,0,0,0,0,0
"94865",47432500,1000,0.00241085,0,0,0,0,0
"94866",47433000,1000,0.00240439,0,0,0,0,0
"94867",47433500,1000,0.00244893,0,0,0,0,0
"94868",47434000,1000,0.00249024,0,0,0,0,0
"94869",47434500,1000,0.00261806,0,0,0,0,0
"94870",47435000,1000,0.00254212,0,0,0,0,0
"94871",47435500,1000,0.00259948,0,0,0,0,0
"94872",47436000,1000,0.00262583,0,0,0,0,0
"94873",47436500,1000,0.00257,0,0,0,0,0
"94874",47437000,1000,0.00261092,0,0,0,0,0
"94875",47437500,1000,0.00259881,0,0,0,0,0
"94876",47438000,1000,0.00264623,0,0,0,1,1
"94877",47438500,1000,0.00270003,0,0,0,1,1
"94878",47439000,1000,0.00270077,0,0,1,0,1
"94879",47439500,1000,0.00262984,0,0,1,0,1
"94880",47440000,1000,0.00246763,0,0,0,0,0
"94881",47440500,1000,0.00239371,0,0,0,0,0
"94882",47441000,1000,0.0024783,0,0,0,0,0
"94883",47441500,1000,0.00245738,0,0,0,0,0
"94884",47442000,1000,0.00235844,0,0,0,0,0
"94885",47442500,1000,0.00251267,0,0,1,0,1
"94886",47443000,1000,0.00255684,0,0,1,0,1
"94887",47443500,1000,0.00250229,0,0,0,0,0
"94888",47444000,1000,0.00248091,0,0,0,0,0
"94889",47444500,1000,0.00257667,0,0,0,2,2
"94890",47445000,1000,0.00265404,0,0,0,3,3
"94891",47445500,1000,0.00255938,0,0,0,2,2
"94892",47446000,1000,0.00259138,0,0,0,2,2
"94893",47446500,1000,0.00262982,0,0,0,1,1
"94894",47447000,1000,0.00259624,0,0,0,0,0
"94895",47447500,1000,0.00266181,0,0,1,0,1
"94896",47448000,1000,0.00273549,0,0,2,1,3
"94897",47448500,1000,0.002629,0,0,1,1,2
"94898",47449000,1000,0.00260286,0,0,0,0,0
"94899",47449500,1000,0.00254689,0,0,0,0,0
"94900",47450000,1000,0.00256988,0,0,0,2,2
"94901",47450500,1000,0.00268784,0,0,0,2,2
"94902",47451000,1000,0.00253438,0,0,0,0,0
"94903",47451500,1000,0.00252713,0,0,0,1,1
"94904",47452000,1000,0.00268499,0,0,0,1,1
"94905",47452500,1000,0.00274953,0,0,0,2,2
"94906",47453000,1000,0.00270377,0,0,0,2,2
"94907",47453500,1000,0.00261109,0,0,0,0,0
"94908",47454000,1000,0.00271051,0,0,0,2,2
"94909",47454500,1000,0.00259814,0,0,0,2,2
"94910",47455000,1000,0.0024377,0,0,0,0,0
"94911",47455500,1000,0.00240803,0,0,0,0,0
"94912",47456000,1000,0.00244343,0,0,1,0,1
"94913",47456500,1000,0.0025464,0,0,1,0,1
"94914",47457000,1000,0.00261285,0,0,0,0,0
"94915",47457500,1000,0.00276561,0,0,1,1,2
"94916",47458000,1000,0.00278107,0,0,2,2,4
"94917",47458500,1000,0.00275484,0,0,2,2,4
"94918",47459000,1000,0.00281485,0,0,1,4,5
"94919",47459500,1000,0.002665,0,0,0,3,3
"94920",47460000,1000,0.0025881,0,0,0,1,1
"94921",47460500,1000,0.00268966,0,0,0,2,2
"94922",47461000,1000,0.00270286,0,0,0,2,2
"94923",47461500,1000,0.00269666,0,0,0,3,3
"94924",47462000,1000,0.00255826,0,0,0,3,3
"94925",47462500,1000,0.00260572,0,0,1,2,3
"94926",47463000,1000,0.00264992,0,0,1,1,2
"94927",47463500,1000,0.00254755,0,0,0,0,0
"94928",47464000,1000,0.00262743,0,0,0,0,0
"94929",47464500,1000,0.0025778,0,0,0,1,1
"94930",47465000,1000,0.00246252,0,0,0,1,1
"94931",47465500,1000,0.00247381,0,0,0,0,0
"94932",47466000,1000,0.00253486,0,0,0,1,1
"94933",47466500,1000,0.00245432,0,0,0,1,1
"94934",47467000,1000,0.00252341,0,0,0,1,1
"94935",47467500,1000,0.00261534,0,0,0,1,1
"94936",47468000,1000,0.00244565,0,0,0,0,0
"94937",47468500,1000,0.00264328,0,1,0,0,1
"94938",47469000,1000,0.00274721,0,1,0,0,1
"94939",47469500,1000,0.00249022,0,0,0,0,0
"94940",47470000,1000,0.0025091,0,0,0,1,1
"94941",47470500,1000,0.00263049,0,0,0,2,2
"94942",47471000,1000,0.0026207,0,0,0,1,1
"94943",47471500,1000,0.00269646,0,0,0,2,2
"94944",47472000,1000,0.00281139,0,0,1,3,4
"94945",47472500,1000,0.00269413,0,0,1,1,2
"94946",47473000,1000,0.00254642,0,0,0,0,0
"94947",47473500,1000,0.00254072,0,0,0,0,0
"94948",47474000,1000,0.00257251,0,0,0,2,2
"94949",47474500,1000,0.00261925,0,0,0,4,4
"94950",47475000,1000,0.00264014,0,0,0,2,2
"94951",47475500,1000,0.00268905,0,0,0,3,3
"94952",47476000,1000,0.00271268,0,0,0,6,6
"94953",47476500,1000,0.00273898,0,0,0,3,3
"94954",47477000,1000,0.00281667,0,0,1,1,2
"94955",47477500,1000,0.00283585,0,1,1,1,3
"94956",47478000,1000,0.00290792,0,1,1,0,2
"94957",47478500,1000,0.00275525,0,0,1,0,1
"94958",47479000,1000,0.00258782,0,0,0,1,1
"94959",47479500,1000,0.00259363,0,0,0,1,1
"94960",47480000,1000,0.00279189,0,0,1,2,3
"94961",47480500,1000,0.0029543,0,0,1,6,7
"94962",47481000,1000,0.0027496,0,0,0,4,4
"94963",47481500,1000,0.00256067,0,0,0,0,0
"94964",47482000,1000,0.00262465,0,0,0,1,1
"94965",47482500,1000,0.00267164,0,0,0,1,1
"94966",47483000,1000,0.00272144,0,0,2,1,3
"94967",47483500,1000,0.00278114,0,0,2,3,5
"94968",47484000,1000,0.00278484,0,0,1,3,4
"94969",47484500,1000,0.00304934,0,1,2,1,4
"94970",47485000,1000,0.00300206,0,1,1,0,2
"94971",47485500,1000,0.00264059,0,0,0,0,0
"94972",47486000,1000,0.00263855,0,0,1,1,2
"94973",47486500,1000,0.00275386,0,0,1,2,3
"94974",47487000,1000,0.00265408,0,0,0,1,1
"94975",47487500,1000,0.00274225,0,0,1,1,2
"94976",47488000,1000,0.002808,0,0,1,1,2
"94977",47488500,1000,0.00268393,0,0,0,1,1
"94978",47489000,1000,0.00276771,0,0,0,3,3
"94979",47489500,1000,0.00278111,0,0,0,5,5
"94980",47490000,1000,0.0026606,0,0,0,3,3
"94981",47490500,1000,0.00268667,0,0,0,1,1
"94982",47491000,1000,0.0025921,0,0,0,1,1
"94983",47491500,1000,0.00249972,0,0,0,0,0
"94984",47492000,1000,0.00254069,0,0,0,0,0
"94985",47492500,1000,0.0025434,0,0,0,1,1
"94986",47493000,1000,0.00254741,0,0,0,1,1
"94987",47493500,1000,0.00266689,0,0,0,0,0
"94988",47494000,1000,0.00284902,0,0,0,4,4
"94989",47494500,1000,0.00272439,0,0,0,4,4
"94990",47495000,1000,0.00265327,0,0,1,0,1
"94991",47495500,1000,0.00278265,0,0,2,0,2
"94992",47496000,1000,0.00281032,0,0,2,1,3
"94993",47496500,1000,0.0028222,0,0,2,3,5
"94994",47497000,1000,0.00275447,0,0,1,4,5
"94995",47497500,1000,0.00262548,0,0,0,2,2
"94996",47498000,1000,0.00274276,0,0,0,2,2
"94997",47498500,1000,0.00275236,0,0,0,2,2
"94998",47499000,1000,0.0025713,0,0,0,0,0
"94999",47499500,1000,0.00257146,0,0,0,2,2
"95000",47500000,1000,0.00262156,0,0,0,3,3
"95001",47500500,1000,0.00266773,0,0,0,1,1
"95002",47501000,1000,0.00271301,0,0,0,2,2
"95003",47501500,1000,0.00273166,0,0,1,3,4
"95004",47502000,1000,0.00266068,0,0,1,1,2
"95005",47502500,1000,0.00268463,0,0,0,2,2
"95006",47503000,1000,0.0027659,0,0,0,2,2
"95007",47503500,1000,0.00276271,0,0,0,0,0
"95008",47504000,1000,0.0026993,0,0,0,0,0
"95009",47504500,1000,0.00272349,0,0,0,2,2
"95010",47505000,1000,0.00269842,0,0,0,2,2
"95011",47505500,1000,0.00253981,0,0,0,1,1
"95012",47506000,1000,0.00263196,0,0,0,2,2
"95013",47506500,1000,0.0026755,0,0,0,1,1
"95014",47507000,1000,0.0025615,0,0,0,0,0
"95015",47507500,1000,0.00281242,0,0,1,3,4
"95016",47508000,1000,0.00286732,0,0,1,4,5
"95017",47508500,1000,0.00266628,0,0,0,2,2
"95018",47509000,1000,0.00285127,0,0,2,2,4
"95019",47509500,1000,0.00279994,0,0,2,1,3
"95020",47510000,1000,0.00274333,0,0,1,1,2
"95021",47510500,1000,0.00289445,0,0,1,4,5
"95022",47511000,1000,0.00289298,0,0,0,5,5
"95023",47511500,1000,0.00278293,0,0,0,2,2
"95024",47512000,1000,0.00264694,0,0,0,1,1
"95025",47512500,1000,0.00274497,0,0,0,2,2
"95026",47513000,1000,0.00286006,0,0,0,3,3
"95027",47513500,1000,0.00271152,0,0,1,2,3
"95028",47514000,1000,0.0026495,0,0,1,0,1
"95029",47514500,1000,0.0027848,0,0,0,2,2
"95030",47515000,1000,0.0028998,0,0,1,5,6
"95031",47515500,1000,0.00271036,0,0,1,3,4
"95032",47516000,1000,0.00266611,0,0,1,2,3
"95033",47516500,1000,0.0027036,0,0,1,2,3
"95034",47517000,1000,0.0026377,0,0,0,3,3
"95035",47517500,1000,0.00281342,0,0,1,4,5
"95036",47518000,1000,0.0027606,0,0,2,1,3
"95037",47518500,1000,0.00259632,0,0,1,0,1
"95038",47519000,1000,0.00266296,0,0,1,0,1
"95039",47519500,1000,0.00275106,0,0,1,1,2
"95040",47520000,1000,0.00268748,0,0,0,1,1
"95041",47520500,1000,0.00269921,0,0,0,0,0
"95042",47521000,1000,0.00262587,0,0,0,0,0
"95043",47521500,1000,0.00254419,0,0,0,0,0
"95044",47522000,1000,0.00264541,0,0,0,0,0
"95045",47522500,1000,0.00266075,0,0,0,0,0
"95046",47523000,1000,0.0026283,0,0,0,0,0
"95047",47523500,1000,0.00271995,0,0,1,1,2
"95048",47524000,1000,0.00268334,0,0,1,2,3
"95049",47524500,1000,0.00268098,0,0,1,2,3
"95050",47525000,1000,0.00272428,0,0,1,1,2
"95051",47525500,1000,0.00255452,0,0,0,0,0
"95052",47526000,1000,0.00261036,0,0,0,0,0
"95053",47526500,1000,0.00273355,0,0,0,1,1
"95054",47527000,1000,0.00273784,0,0,1,2,3
"95055",47527500,1000,0.00266729,0,0,1,3,4
"95056",47528000,1000,0.00254234,0,0,0,3,3
"95057",47528500,1000,0.00259831,0,0,0,3,3
"95058",47529000,1000,0.00254917,0,0,0,2,2
"95059",47529500,1000,0.00255676,0,0,1,1,2
"95060",47530000,1000,0.00260007,0,0,1,2,3
"95061",47530500,1000,0.00266266,0,0,1,3,4
"95062",47531000,1000,0.00263018,0,0,1,2,3
"95063",47531500,1000,0.0024376,0,0,0,0,0
"95064",47532000,1000,0.00257396,0,0,0,1,1
"95065",47532500,1000,0.00259318,0,0,0,1,1
"95066",47533000,1000,0.00246107,0,0,0,0,0
"95067",47533500,1000,0.0024266,0,0,0,0,0
"95068",47534000,1000,0.00261586,0,1,0,0,1
"95069",47534500,1000,0.00278001,0,1,1,1,3
"95070",47535000,1000,0.00288502,0,0,3,3,6
"95071",47535500,1000,0.00275893,0,0,2,2,4
"95072",47536000,1000,0.00259573,0,0,0,2,2
"95073",47536500,1000,0.0027456,0,0,0,4,4
"95074",47537000,1000,0.00275687,0,0,0,3,3
"95075",47537500,1000,0.00265656,0,0,0,1,1
"95076",47538000,1000,0.00263526,0,0,0,2,2
"95077",47538500,1000,0.00273075,0,0,1,3,4
"95078",47539000,1000,0.00261868,0,0,1,1,2
"95079",47539500,1000,0.00253838,0,0,0,1,1
"95080",47540000,1000,0.00266822,0,0,0,1,1
"95081",47540500,1000,0.00264296,0,0,0,0,0
"95082",47541000,1000,0.00257099,0,0,0,0,0
"95083",47541500,1000,0.00264357,0,0,1,0,1
"95084",47542000,1000,0.00260238,0,0,1,0,1
"95085",47542500,1000,0.00266338,0,0,0,2,2
"95086",47543000,1000,0.00267934,0,0,0,2,2
"95087",47543500,1000,0.00263939,0,0,0,2,2
"95088",47544000,1000,0.00278624,0,0,1,3,4
"95089",47544500,1000,0.00272211,0,0,1,2,3
"95090",47545000,1000,0.00277855,0,0,2,1,3
"95091",47545500,1000,0.00290218,0,0,2,1,3
"95092",47546000,1000,0.00270365,0,0,0,1,1
"95093",47546500,1000,0.00254251,0,0,0,1,1
"95094",47547000,1000,0.0025888,0,0,0,1,1
"95095",47547500,1000,0.00274885,0,0,1,2,3
"95096",47548000,1000,0.00263565,0,0,1,2,3
"95097",47548500,1000,0.00254993,0,0,0,1,1
"95098",47549000,1000,0.00265392,0,0,0,1,1
"95099",47549500,1000,0.00255704,0,0,0,0,0
"95100",47550000,1000,0.00257094,0,0,0,2,2
"95101",47550500,1000,0.00265853,0,0,0,3,3
"95102",47551000,1000,0.00256425,0,0,0,1,1
"95103",47551500,1000,0.0025157,0,0,0,0,0
"95104",47552000,1000,0.00260772,0,0,0,1,1
"95105",47552500,1000,0.00255255,0,0,0,1,1
"95106",47553000,1000,0.00251926,0,0,0,2,2
"95107",47553500,1000,0.00263672,0,0,1,2,3
"95108",47554000,1000,0.00268482,0,0,1,2,3
"95109",47554500,1000,0.00259246,0,0,0,3,3
"95110",47555000,1000,0.00257513,0,0,0,1,1
"95111",47555500,1000,0.00259204,0,0,0,0,0
"95112",47556000,1000,0.00260687,0,0,0,0,0
"95113",47556500,1000,0.00276591,0,0,1,1,2
"95114",47557000,1000,0.00278174,0,0,1,3,4
"95115",47557500,1000,0.00254771,0,0,0,2,2
"95116",47558000,1000,0.00260465,0,0,1,0,1
"95117",47558500,1000,0.00282032,0,0,2,2,4
"95118",47559000,1000,0.00267452,0,0,1,3,4
"95119",47559500,1000,0.0026268,0,0,0,1,1
"95120",47560000,1000,0.0026428,0,0,0,0,0
"95121",47560500,1000,0.00266976,0,0,1,0,1
"95122",47561000,1000,0.0026016,0,0,1,0,1
"95123",47561500,1000,0.00273742,0,1,0,0,1
"95124",47562000,1000,0.00294842,0,1,0,1,2
"95125",47562500,1000,0.00265573,0,0,0,1,1
"95126",47563000,1000,0.00272135,0,1,0,1,2
"95127",47563500,1000,0.00288428,0,1,1,1,3
"95128",47564000,1000,0.00279714,0,0,1,3,4
"95129",47564500,1000,0.00262422,0,0,0,4,4
"95130",47565000,1000,0.0025571,0,0,0,1,1
"95131",47565500,1000,0.00269212,0,0,0,0,0
"95132",47566000,1000,0.00264177,0,0,0,0,0
"95133",47566500,1000,0.00262855,0,0,0,1,1
"95134",47567000,1000,0.00259099,0,0,0,1,1
"95135",47567500,1000,0.00247007,0,0,0,0,0
"95136",47568000,1000,0.00261038,0,0,1,0,1
"95137",47568500,1000,0.00265244,0,0,1,1,2
"95138",47569000,1000,0.00256288,0,0,0,1,1
"95139",47569500,1000,0.00259121,0,0,0,1,1
"95140",47570000,1000,0.00257645,0,0,0,1,1
"95141",47570500,1000,0.00251832,0,0,0,0,0
"95142",47571000,1000,0.00242626,0,0,0,0,0
"95143",47571500,1000,0.00257982,0,0,1,1,2
"95144",47572000,1000,0.00269663,0,0,1,3,4
"95145",47572500,1000,0.00265361,0,0,0,4,4
"95146",47573000,1000,0.00263204,0,0,0,3,3
"95147",47573500,1000,0.00248901,0,0,0,1,1
"95148",47574000,1000,0.00237848,0,0,0,0,0
"95149",47574500,1000,0.00244374,0,0,0,1,1
"95150",47575000,1000,0.00245464,0,0,0,1,1
"95151",47575500,1000,0.00254163,0,0,0,2,2
"95152",47576000,1000,0.00270253,0,0,0,3,3
"95153",47576500,1000,0.00252686,0,0,0,1,1
"95154",47577000,1000,0.00232096,0,0,0,0,0
"95155",47577500,1000,0.00244524,0,0,0,1,1
"95156",47578000,1000,0.00254987,0,0,0,1,1
"95157",47578500,1000,0.00252086,0,0,0,0,0
"95158",47579000,1000,0.00258568,0,0,0,0,0
"95159",47579500,1000,0.00252747,0,0,0,0,0
"95160",47580000,1000,0.00241083,0,0,0,0,0
"95161",47580500,1000,0.00247068,0,0,0,0,0
"95162",47581000,1000,0.00253767,0,0,0,0,0
"95163",47581500,1000,0.00257484,0,0,0,2,2
"95164",47582000,1000,0.00255399,0,0,0,3,3
"95165",47582500,1000,0.00241473,0,0,0,1,1
"95166",47583000,1000,0.0026052,0,0,0,3,3
"95167",47583500,1000,0.00271386,0,0,0,4,4
"95168",47584000,1000,0.00256762,0,0,0,2,2
"95169",47584500,1000,0.00251974,0,0,0,1,1
"95170",47585000,1000,0.00253776,0,0,0,2,2
"95171",47585500,1000,0.00267521,0,0,1,2,3
"95172",47586000,1000,0.00254524,0,0,1,0,1
"95173",47586500,1000,0.00244767,0,0,0,0,0
"95174",47587000,1000,0.00250719,0,0,0,0,0
"95175",47587500,1000,0.00256739,0,0,0,1,1
"95176",47588000,1000,0.00277364,0,0,0,3,3
"95177",47588500,1000,0.00260437,0,0,0,2,2
"95178",47589000,1000,0.00258175,0,0,0,2,2
"95179",47589500,1000,0.00266289,0,0,0,2,2
"95180",47590000,1000,0.00257252,0,0,0,0,0
"95181",47590500,1000,0.00260838,0,0,1,0,1
"95182",47591000,1000,0.00258041,0,0,1,0,1
"95183",47591500,1000,0.00268431,0,0,1,0,1
"95184",47592000,1000,0.00261128,0,0,1,0,1
"95185",47592500,1000,0.00252829,0,0,0,0,0
"95186",47593000,1000,0.00259522,0,0,0,0,0
"95187",47593500,1000,0.00263194,0,0,0,1,1
"95188",47594000,1000,0.00260022,0,0,0,1,1
"95189",47594500,1000,0.00259918,0,0,1,1,2
"95190",47595000,1000,0.00275875,0,0,2,2,4
"95191",47595500,1000,0.00283608,0,0,1,3,4
"95192",47596000,1000,0.00271124,0,0,0,2,2
"95193",47596500,1000,0.00259784,0,0,0,0,0
"95194",47597000,1000,0.00254551,0,0,0,0,0
"95195",47597500,1000,0.00250408,0,0,0,0,0
"95196",47598000,1000,0.00258188,0,0,0,0,0
"95197",47598500,1000,0.00260998,0,0,0,1,1
"95198",47599000,1000,0.00252057,0,0,0,1,1
"95199",47599500,1000,0.00254703,0,0,0,0,0
"95200",47600000,1000,0.0027093,0,0,0,2,2
"95201",47600500,1000,0.00261694,0,0,0,2,2
"95202",47601000,1000,0.00259767,0,0,0,1,1
"95203",47601500,1000,0.00270424,0,0,0,1,1
"95204",47602000,1000,0.00269595,0,0,0,2,2
"95205",47602500,1000,0.0025965,0,0,0,2,2
"95206",47603000,1000,0.00252872,0,0,1,1,2
"95207",47603500,1000,0.00263467,0,0,2,1,3
"95208",47604000,1000,0.00265502,0,0,2,0,2
"95209",47604500,1000,0.00264937,0,0,1,1,2
"95210",47605000,1000,0.00260593,0,0,0,1,1
"95211",47605500,1000,0.00250373,0,0,0,0,0
"95212",47606000,1000,0.00246527,0,0,0,0,0
"95213",47606500,1000,0.00260864,0,0,0,1,1
"95214",47607000,1000,0.00269002,0,0,0,2,2
"95215",47607500,1000,0.00261554,0,0,0,1,1
"95216",47608000,1000,0.0026395,0,0,0,2,2
"95217",47608500,1000,0.00284607,0,0,0,2,2
"95218",47609000,1000,0.00284166,0,0,0,0,0
"95219",47609500,1000,0.0025518,0,0,0,0,0
"95220",47610000,1000,0.0024815,0,0,0,0,0
"95221",47610500,1000,0.00280592,0,1,0,0,1
"95222",47611000,1000,0.00306456,0,1,2,2,5
"95223",47611500,1000,0.00283379,0,0,2,3,5
"95224",47612000,1000,0.002606,0,0,0,2,2
"95225",47612500,1000,0.00278541,0,0,2,3,5
"95226",47613000,1000,0.00285293,0,0,3,2,5
"95227",47613500,1000,0.00255924,0,0,1,0,1
"95228",47614000,1000,0.0024871,0,0,0,0,0
"95229",47614500,1000,0.00253904,0,0,0,0,0
"95230",47615000,1000,0.00265697,0,0,1,0,1
"95231",47615500,1000,0.00262881,0,0,1,0,1
"95232",47616000,1000,0.00266781,0,0,0,3,3
"95233",47616500,1000,0.00280758,0,0,0,4,4
"95234",47617000,1000,0.00257255,0,0,0,1,1
"95235",47617500,1000,0.00248799,0,0,0,0,0
"95236",47618000,1000,0.0027611,0,0,2,0,2
"95237",47618500,1000,0.0028959,0,0,2,0,2
"95238",47619000,1000,0.00269523,0,0,0,0,0
"95239",47619500,1000,0.00257265,0,0,0,0,0
"95240",47620000,1000,0.00267554,0,0,0,2,2
"95241",47620500,1000,0.00272112,0,0,0,2,2
"95242",47621000,1000,0.00258783,0,0,0,0,0
"95243",47621500,1000,0.00251237,0,0,0,0,0
"95244",47622000,1000,0.00246977,0,0,0,0,0
"95245",47622500,1000,0.0024803,0,0,0,1,1
"95246",47623000,1000,0.00252807,0,0,0,2,2
"95247",47623500,1000,0.00259812,0,0,0,1,1
"95248",47624000,1000,0.00285429,0,0,1,2,3
"95249",47624500,1000,0.00282943,0,0,1,2,3
"95250",47625000,1000,0.00258709,0,0,0,0,0
"95251",47625500,1000,0.00262871,0,0,0,2,2
"95252",47626000,1000,0.00279026,0,1,0,2,3
"95253",47626500,1000,0.00272143,0,1,0,0,1
"95254",47627000,1000,0.00266249,0,0,0,3,3
"95255",47627500,1000,0.0026916,0,0,0,4,4
"95256",47628000,1000,0.00273642,0,0,1,1,2
"95257",47628500,1000,0.00275072,0,0,1,1,2
"95258",47629000,1000,0.0026247,0,0,0,1,1
"95259",47629500,1000,0.00258487,0,0,0,0,0
"95260",47630000,1000,0.00262568,0,0,0,0,0
"95261",47630500,1000,0.00260208,0,0,0,0,0
"95262",47631000,1000,0.00261471,0,0,1,1,2
"95263",47631500,1000,0.00282758,0,0,1,3,4
"95264",47632000,1000,0.00292129,0,0,1,2,3
"95265",47632500,1000,0.0027401,0,0,1,0,1
"95266",47633000,1000,0.00262817,0,0,0,0,0
"95267",47633500,1000,0.00274109,0,0,1,1,2
"95268",47634000,1000,0.00289474,0,1,1,2,4
"95269",47634500,1000,0.00292085,0,1,0,3,4
"95270",47635000,1000,0.00286391,0,0,0,3,3
"95271",47635500,1000,0.00273538,0,0,0,2,2
"95272",47636000,1000,0.00251957,0,0,0,1,1
"95273",47636500,1000,0.00256225,0,0,0,1,1
"95274",47637000,1000,0.00281005,0,1,0,2,3
"95275",47637500,1000,0.00288177,0,1,1,2,4
"95276",47638000,1000,0.00280271,0,0,1,3,4
"95277",47638500,1000,0.00289917,0,0,1,4,5
"95278",47639000,1000,0.0027716,0,0,1,2,3
"95279",47639500,1000,0.00261305,0,0,0,0,0
"95280",47640000,1000,0.00262969,0,0,0,0,0
"95281",47640500,1000,0.00254336,0,0,0,0,0
"95282",47641000,1000,0.00255594,0,0,0,0,0
"95283",47641500,1000,0.00275926,0,0,1,2,3
"95284",47642000,1000,0.0028905,0,0,2,4,6
"95285",47642500,1000,0.00274916,0,0,1,2,3
"95286",47643000,1000,0.00276465,0,1,0,0,1
"95287",47643500,1000,0.00273626,0,1,0,1,2
"95288",47644000,1000,0.00259524,0,0,0,2,2
"95289",47644500,1000,0.00255442,0,0,0,1,1
"95290",47645000,1000,0.00254705,0,0,0,0,0
"95291",47645500,1000,0.00265815,0,0,0,0,0
"95292",47646000,1000,0.00273736,0,0,0,1,1
"95293",47646500,1000,0.00262083,0,0,0,1,1
"95294",47647000,1000,0.00265128,0,0,0,0,0
"95295",47647500,1000,0.0026976,0,0,0,1,1
"95296",47648000,1000,0.00267261,0,0,0,3,3
"95297",47648500,1000,0.00267417,0,0,0,2,2
"95298",47649000,1000,0.00269326,0,0,0,3,3
"95299",47649500,1000,0.00256822,0,0,0,3,3
"95300",47650000,1000,0.00241686,0,0,0,0,0
"95301",47650500,1000,0.00237087,0,0,0,0,0
"95302",47651000,1000,0.00239248,0,0,0,1,1
"95303",47651500,1000,0.00253638,0,0,0,2,2
"95304",47652000,1000,0.00253439,0,0,0,2,2
"95305",47652500,1000,0.00262006,0,0,0,1,1
"95306",47653000,1000,0.00269691,0,0,0,2,2
"95307",47653500,1000,0.00269854,0,0,0,2,2
"95308",47654000,1000,0.00272354,0,0,1,1,2
"95309",47654500,1000,0.00269934,0,0,1,2,3
"95310",47655000,1000,0.00266574,0,0,0,2,2
"95311",47655500,1000,0.00257907,0,0,0,1,1
"95312",47656000,1000,0.0025971,0,0,0,1,1
"95313",47656500,1000,0.00270358,0,0,0,1,1
"95314",47657000,1000,0.00263296,0,0,0,0,0
"95315",47657500,1000,0.00258639,0,0,0,0,0
"95316",47658000,1000,0.00265678,0,0,0,0,0
"95317",47658500,1000,0.00262973,0,0,0,0,0
"95318",47659000,1000,0.00262515,0,0,0,2,2
"95319",47659500,1000,0.00258525,0,0,0,2,2
"95320",47660000,1000,0.00256398,0,0,0,0,0
"95321",47660500,1000,0.00257951,0,0,0,0,0
"95322",47661000,1000,0.00258799,0,0,0,0,0
"95323",47661500,1000,0.00268646,0,0,1,1,2
"95324",47662000,1000,0.00273191,0,0,1,3,4
"95325",47662500,1000,0.00271439,0,0,0,2,2
"95326",47663000,1000,0.00276556,0,0,1,1,2
"95327",47663500,1000,0.00278439,0,0,1,3,4
"95328",47664000,1000,0.00262224,0,0,0,2,2
"95329",47664500,1000,0.00251411,0,0,0,0,0
"95330",47665000,1000,0.00261973,0,0,0,0,0
"95331",47665500,1000,0.00259332,0,0,0,0,0
"95332",47666000,1000,0.00248609,0,0,0,1,1
"95333",47666500,1000,0.00262193,0,1,0,1,2
"95334",47667000,1000,0.00276543,0,1,1,1,3
"95335",47667500,1000,0.0027138,0,0,1,3,4
"95336",47668000,1000,0.00266201,0,0,0,2,2
"95337",47668500,1000,0.00262569,0,0,0,1,1
"95338",47669000,1000,0.00276449,0,0,1,3,4
"95339",47669500,1000,0.00277468,0,0,1,2,3
"95340",47670000,1000,0.00256731,0,0,0,0,0
"95341",47670500,1000,0.00266034,0,0,0,1,1
"95342",47671000,1000,0.00277468,0,0,1,1,2
"95343",47671500,1000,0.00270652,0,0,1,1,2
"95344",47672000,1000,0.00267109,0,0,0,2,2
"95345",47672500,1000,0.00266078,0,0,1,1,2
"95346",47673000,1000,0.00270816,0,0,1,2,3
"95347",47673500,1000,0.00284583,0,0,0,2,2
"95348",47674000,1000,0.0029212,0,0,0,3,3
"95349",47674500,1000,0.00280303,0,0,0,3,3
"95350",47675000,1000,0.00267131,0,0,0,2,2
"95351",47675500,1000,0.00263361,0,0,0,2,2
"95352",47676000,1000,0.00256906,0,0,0,0,0
"95353",47676500,1000,0.00253699,0,0,0,0,0
"95354",47677000,1000,0.0025573,0,0,0,1,1
"95355",47677500,1000,0.00257602,0,0,0,1,1
"95356",47678000,1000,0.00261845,0,0,0,0,0
"95357",47678500,1000,0.00265488,0,0,0,1,1
"95358",47679000,1000,0.00264046,0,0,0,2,2
"95359",47679500,1000,0.00270209,0,0,1,1,2
"95360",47680000,1000,0.00273475,0,0,1,1,2
"95361",47680500,1000,0.00263654,0,0,0,1,1
"95362",47681000,1000,0.00282992,0,0,2,0,2
"95363",47681500,1000,0.00297097,0,0,2,2,4
"95364",47682000,1000,0.00295962,0,0,1,4,5
"95365",47682500,1000,0.0028283,0,0,1,2,3
"95366",47683000,1000,0.0024919,0,0,0,0,0
"95367",47683500,1000,0.00245454,0,0,0,0,0
"95368",47684000,1000,0.00250251,0,0,0,0,0
"95369",47684500,1000,0.0025458,0,0,0,1,1
"95370",47685000,1000,0.00254787,0,0,0,1,1
"95371",47685500,1000,0.00256914,0,0,0,0,0
"95372",47686000,1000,0.00258515,0,0,0,0,0
"95373",47686500,1000,0.00269098,0,1,0,0,1
"95374",47687000,1000,0.00271886,0,1,0,0,1
"95375",47687500,1000,0.00273733,0,0,0,0,0
"95376",47688000,1000,0.00289475,0,0,0,2,2
"95377",47688500,1000,0.00288021,0,0,0,6,6
"95378",47689000,1000,0.00274687,0,0,0,4,4
"95379",47689500,1000,0.00276317,0,0,1,0,1
"95380",47690000,1000,0.00277348,0,0,1,1,2
"95381",47690500,1000,0.00276675,0,0,1,1,2
"95382",47691000,1000,0.00272279,0,0,1,0,1
"95383",47691500,1000,0.00272653,0,0,0,3,3
"95384",47692000,1000,0.00278623,0,0,0,4,4
"95385",47692500,1000,0.00283131,0,1,0,2,3
"95386",47693000,1000,0.00306229,0,1,2,2,5
"95387",47693500,1000,0.00275606,0,0,2,1,3
"95388",47694000,1000,0.00232507,0,0,0,0,0
"95389",47694500,1000,0.00228781,0,0,0,0,0
"95390",47695000,1000,0.00244698,0,0,0,0,0
"95391",47695500,1000,0.00256303,0,0,0,0,0
"95392",47696000,1000,0.00278101,0,0,1,0,1
"95393",47696500,1000,0.00295586,0,0,1,1,2
"95394",47697000,1000,0.00299314,0,0,0,2,2
"95395",47697500,1000,0.00311391,0,1,0,2,3
"95396",47698000,1000,0.00300513,0,1,1,2,4
"95397",47698500,1000,0.00284121,0,0,1,1,2
"95398",47699000,1000,0.00282225,0,0,1,0,1
"95399",47699500,1000,0.00288268,0,0,1,0,1
"95400",47700000,1000,0.00286804,0,0,1,1,2
"95401",47700500,1000,0.00267982,0,0,1,1,2
"95402",47701000,1000,0.00258074,0,0,0,0,0
"95403",47701500,1000,0.00265972,0,0,0,0,0
"95404",47702000,1000,0.00266278,0,0,0,1,1
"95405",47702500,1000,0.00263069,0,0,0,1,1
"95406",47703000,1000,0.00264109,0,0,1,0,1
"95407",47703500,1000,0.002612,0,0,1,0,1
"95408",47704000,1000,0.00249439,0,0,0,0,0
"95409",47704500,1000,0.0028769,0,2,0,2,4
"95410",47705000,1000,0.00296299,0,2,0,2,4
"95411",47705500,1000,0.00278851,0,0,0,1,1
"95412",47706000,1000,0.00285999,0,0,0,1,1
"95413",47706500,1000,0.00275439,0,0,0,0,0
"95414",47707000,1000,0.00291194,0,1,0,1,2
"95415",47707500,1000,0.0029334,0,1,0,2,3
"95416",47708000,1000,0.0027847,0,0,0,1,1
"95417",47708500,1000,0.00257278,0,0,0,0,0
"95418",47709000,1000,0.00238844,0,0,0,0,0
"95419",47709500,1000,0.00245439,0,0,0,0,0
"95420",47710000,1000,0.00256665,0,0,0,0,0
"95421",47710500,1000,0.00273233,0,0,0,1,1
"95422",47711000,1000,0.00270956,0,0,0,1,1
"95423",47711500,1000,0.00262104,0,0,0,0,0
"95424",47712000,1000,0.00267281,0,0,0,0,0
"95425",47712500,1000,0.00266757,0,0,0,0,0
"95426",47713000,1000,0.00267824,0,0,0,0,0
"95427",47713500,1000,0.00269657,0,0,0,0,0
"95428",47714000,1000,0.00273986,0,0,0,1,1
"95429",47714500,1000,0.0027323,0,0,0,1,1
"95430",47715000,1000,0.00268904,0,0,0,1,1
"95431",47715500,1000,0.00268734,0,0,0,1,1
"95432",47716000,1000,0.00280957,0,1,0,0,1
"95433",47716500,1000,0.00275706,0,1,0,1,2
"95434",47717000,1000,0.00268946,0,0,0,1,1
"95435",47717500,1000,0.00279177,0,0,0,0,0
"95436",47718000,1000,0.00282636,0,0,1,0,1
"95437",47718500,1000,0.00289745,0,0,2,0,2
"95438",47719000,1000,0.00278352,0,0,1,1,2
"95439",47719500,1000,0.0026292,0,0,0,1,1
"95440",47720000,1000,0.00265869,0,0,0,0,0
"95441",47720500,1000,0.00283316,0,0,0,4,4
"95442",47721000,1000,0.00277937,0,0,0,4,4
"95443",47721500,1000,0.00261259,0,0,0,0,0
"95444",47722000,1000,0.0026801,0,0,0,0,0
"95445",47722500,1000,0.00285432,0,0,1,0,1
"95446",47723000,1000,0.00277028,0,0,1,1,2
"95447",47723500,1000,0.0025555,0,0,0,1,1
"95448",47724000,1000,0.00273506,0,1,0,1,2
"95449",47724500,1000,0.00278623,0,1,0,2,3
"95450",47725000,1000,0.00275351,0,0,0,1,1
"95451",47725500,1000,0.00280883,0,0,1,0,1
"95452",47726000,1000,0.00269338,0,0,1,0,1
"95453",47726500,1000,0.0027045,0,0,0,0,0
"95454",47727000,1000,0.00266259,0,0,0,0,0
"95455",47727500,1000,0.00275806,0,1,0,0,1
"95456",47728000,1000,0.00283231,0,1,0,1,2
"95457",47728500,1000,0.002634,0,0,0,1,1
"95458",47729000,1000,0.00267095,0,0,1,1,2
"95459",47729500,1000,0.00284492,0,0,2,1,3
"95460",47730000,1000,0.00280959,0,0,1,0,1
"95461",47730500,1000,0.0026367,0,0,0,0,0
"95462",47731000,1000,0.00290411,0,1,0,2,3
"95463",47731500,1000,0.00294406,0,1,0,2,3
"95464",47732000,1000,0.00259033,0,0,0,0,0
"95465",47732500,1000,0.00275656,0,0,1,0,1
"95466",47733000,1000,0.00271975,0,0,1,0,1
"95467",47733500,1000,0.002477,0,0,0,0,0
"95468",47734000,1000,0.0026863,0,0,0,1,1
"95469",47734500,1000,0.0027709,0,0,0,1,1
"95470",47735000,1000,0.00261784,0,0,0,0,0
"95471",47735500,1000,0.00271682,0,0,1,1,2
"95472",47736000,1000,0.00267541,0,0,1,1,2
"95473",47736500,1000,0.00256807,0,0,0,0,0
"95474",47737000,1000,0.00263308,0,0,0,0,0
"95475",47737500,1000,0.00259984,0,0,0,0,0
"95476",47738000,1000,0.00258651,0,0,0,0,0
"95477",47738500,1000,0.00266876,0,0,0,2,2
"95478",47739000,1000,0.00270235,0,0,0,3,3
"95479",47739500,1000,0.00278214,0,0,1,2,3
"95480",47740000,1000,0.00278868,0,0,1,2,3
"95481",47740500,1000,0.00277422,0,0,1,2,3
"95482",47741000,1000,0.0029138,0,0,1,1,2
"95483",47741500,1000,0.00283896,0,0,0,0,0
"95484",47742000,1000,0.00279149,0,0,1,1,2
"95485",47742500,1000,0.00271901,0,0,1,1,2
"95486",47743000,1000,0.00260808,0,0,0,0,0
"95487",47743500,1000,0.00274373,0,0,0,2,2
"95488",47744000,1000,0.00293709,0,1,0,2,3
"95489",47744500,1000,0.00274141,0,1,0,0,1
"95490",47745000,1000,0.00258264,0,0,0,1,1
"95491",47745500,1000,0.002632,0,0,0,1,1
"95492",47746000,1000,0.00259333,0,0,0,1,1
"95493",47746500,1000,0.00264535,0,0,0,2,2
"95494",47747000,1000,0.00262401,0,0,0,1,1
"95495",47747500,1000,0.00268651,0,0,1,0,1
"95496",47748000,1000,0.00269421,0,0,1,0,1
"95497",47748500,1000,0.00253566,0,0,0,0,0
"95498",47749000,1000,0.00248161,0,0,0,0,0
"95499",47749500,1000,0.00265617,0,0,0,2,2
"95500",47750000,1000,0.00265829,0,0,0,3,3
"95501",47750500,1000,0.00249664,0,0,0,1,1
"95502",47751000,1000,0.00247486,0,0,0,0,0
"95503",47751500,1000,0.00257666,0,0,0,0,0
"95504",47752000,1000,0.00264707,0,0,0,0,0
"95505",47752500,1000,0.00258795,0,0,0,0,0
"95506",47753000,1000,0.00261556,0,0,0,1,1
"95507",47753500,1000,0.0027119,0,0,0,4,4
"95508",47754000,1000,0.00266044,0,0,0,3,3
"95509",47754500,1000,0.00270584,0,0,1,1,2
"95510",47755000,1000,0.00282326,0,0,2,2,4
"95511",47755500,1000,0.00268722,0,0,1,1,2
"95512",47756000,1000,0.00261826,0,0,0,1,1
"95513",47756500,1000,0.00253127,0,0,0,1,1
"95514",47757000,1000,0.0026494,0,0,0,0,0
"95515",47757500,1000,0.0028785,0,0,0,1,1
"95516",47758000,1000,0.00272838,0,0,0,2,2
"95517",47758500,1000,0.0025863,0,0,0,1,1
"95518",47759000,1000,0.0027075,0,0,0,0,0
"95519",47759500,1000,0.0027258,0,0,0,0,0
"95520",47760000,1000,0.00256173,0,0,0,0,0
"95521",47760500,1000,0.00250697,0,0,0,0,0
"95522",47761000,1000,0.00249935,0,0,0,0,0
"95523",47761500,1000,0.00266199,0,0,0,2,2
"95524",47762000,1000,0.0027021,0,0,0,2,2
"95525",47762500,1000,0.00259436,0,0,0,2,2
"95526",47763000,1000,0.00266255,0,0,0,2,2
"95527",47763500,1000,0.00264968,0,0,0,1,1
"95528",47764000,1000,0.00255751,0,0,0,1,1
"95529",47764500,1000,0.00257981,0,0,0,1,1
"95530",47765000,1000,0.00256632,0,0,0,1,1
"95531",47765500,1000,0.00259864,0,0,0,1,1
"95532",47766000,1000,0.00280295,0,0,0,2,2
"95533",47766500,1000,0.00269739,0,0,0,1,1
"95534",47767000,1000,0.00253648,0,0,0,0,0
"95535",47767500,1000,0.00271536,0,0,0,1,1
"95536",47768000,1000,0.00286949,0,0,0,2,2
"95537",47768500,1000,0.00268963,0,0,0,1,1
"95538",47769000,1000,0.00255104,0,0,0,1,1
"95539",47769500,1000,0.00255469,0,0,0,1,1
"95540",47770000,1000,0.00261271,0,0,0,1,1
"95541",47770500,1000,0.00267734,0,0,0,1,1
"95542",47771000,1000,0.0025744,0,0,0,0,0
"95543",47771500,1000,0.00266321,0,0,1,1,2
"95544",47772000,1000,0.00275303,0,0,1,1,2
"95545",47772500,1000,0.00275333,0,0,0,1,1
"95546",47773000,1000,0.00282935,0,0,0,1,1
"95547",47773500,1000,0.00271076,0,0,0,0,0
"95548",47774000,1000,0.00274131,0,0,1,0,1
"95549",47774500,1000,0.00278233,0,0,1,0,1
"95550",47775000,1000,0.00268333,0,0,0,0,0
"95551",47775500,1000,0.00277822,0,0,0,0,0
"95552",47776000,1000,0.00274013,0,0,0,1,1
"95553",47776500,1000,0.00258653,0,0,0,2,2
"95554",47777000,1000,0.00278329,0,0,1,3,4
"95555",47777500,1000,0.00285597,0,0,1,2,3
"95556",47778000,1000,0.00265842,0,0,0,0,0
"95557",47778500,1000,0.00263781,0,0,0,0,0
"95558",47779000,1000,0.0026292,0,0,0,0,0
"95559",47779500,1000,0.00251462,0,0,0,0,0
"95560",47780000,1000,0.00269943,0,0,0,3,3
"95561",47780500,1000,0.00278766,0,0,0,3,3
"95562",47781000,1000,0.00264861,0,0,0,0,0
"95563",47781500,1000,0.00266566,0,0,0,0,0
"95564",47782000,1000,0.00266152,0,0,0,0,0
"95565",47782500,1000,0.00287755,0,0,0,3,3
"95566",47783000,1000,0.00281128,0,0,0,3,3
"95567",47783500,1000,0.00274301,0,0,0,1,1
"95568",47784000,1000,0.00281254,0,0,0,2,2
"95569",47784500,1000,0.002705,0,0,1,2,3
"95570",47785000,1000,0.00266156,0,0,1,1,2
"95571",47785500,1000,0.00275574,0,0,0,1,1
"95572",47786000,1000,0.00278041,0,0,0,2,2
"95573",47786500,1000,0.00254264,0,0,0,1,1
"95574",47787000,1000,0.00265606,0,0,1,1,2
"95575",47787500,1000,0.00270641,0,0,1,1,2
"95576",47788000,1000,0.0025076,0,0,0,0,0
"95577",47788500,1000,0.0024356,0,0,0,0,0
"95578",47789000,1000,0.0024311,0,0,0,0,0
"95579",47789500,1000,0.00268152,0,0,1,1,2
"95580",47790000,1000,0.0027477,0,0,1,1,2
"95581",47790500,1000,0.00258379,0,0,1,0,1
"95582",47791000,1000,0.00262072,0,0,1,0,1
"95583",47791500,1000,0.00270124,0,0,0,2,2
"95584",47792000,1000,0.00257852,0,0,0,2,2
"95585",47792500,1000,0.00252185,0,0,0,0,0
"95586",47793000,1000,0.00260844,0,0,0,0,0
"95587",47793500,1000,0.00259905,0,0,0,1,1
"95588",47794000,1000,0.0026072,0,0,0,1,1
"95589",47794500,1000,0.00263437,0,0,0,1,1
"95590",47795000,1000,0.00266713,0,0,0,2,2
"95591",47795500,1000,0.00260976,0,0,0,1,1
"95592",47796000,1000,0.0025985,0,0,0,0,0
"95593",47796500,1000,0.00267654,0,0,0,2,2
"95594",47797000,1000,0.00263454,0,0,0,2,2
"95595",47797500,1000,0.00267002,0,0,0,0,0
"95596",47798000,1000,0.00269071,0,0,0,1,1
"95597",47798500,1000,0.00264522,0,0,0,1,1
"95598",47799000,1000,0.00258445,0,0,0,1,1
"95599",47799500,1000,0.00269231,0,0,1,2,3
"95600",47800000,1000,0.00270711,0,0,1,2,3
"95601",47800500,1000,0.0025472,0,0,0,1,1
"95602",47801000,1000,0.00284141,0,0,1,1,2
"95603",47801500,1000,0.00298646,0,1,1,1,3
"95604",47802000,1000,0.00285335,0,1,0,1,2
"95605",47802500,1000,0.00278925,0,0,0,2,2
"95606",47803000,1000,0.00279034,0,0,0,2,2
"95607",47803500,1000,0.00285565,0,0,0,1,1
"95608",47804000,1000,0.00281055,0,0,0,2,2
"95609",47804500,1000,0.00273071,0,0,0,2,2
"95610",47805000,1000,0.00276557,0,0,0,2,2
"95611",47805500,1000,0.00279636,0,0,0,2,2
"95612",47806000,1000,0.00266852,0,0,0,0,0
"95613",47806500,1000,0.00265545,0,0,0,1,1
"95614",47807000,1000,0.00278695,0,0,1,2,3
"95615",47807500,1000,0.0027877,0,0,1,1,2
"95616",47808000,1000,0.00268178,0,0,0,1,1
"95617",47808500,1000,0.0027078,0,0,0,2,2
"95618",47809000,1000,0.00294826,0,0,1,2,3
"95619",47809500,1000,0.00299851,0,0,2,1,3
"95620",47810000,1000,0.00282656,0,0,1,0,1
"95621",47810500,1000,0.00275479,0,0,0,0,0
"95622",47811000,1000,0.0027107,0,0,0,0,0
"95623",47811500,1000,0.00264953,0,0,0,0,0
"95624",47812000,1000,0.00284063,0,1,0,1,2
"95625",47812500,1000,0.00296187,0,1,0,2,3
"95626",47813000,1000,0.00271035,0,0,0,1,1
"95627",47813500,1000,0.00264261,0,0,0,1,1
"95628",47814000,1000,0.00291769,0,1,1,1,3
"95629",47814500,1000,0.00289647,0,1,1,0,2
"95630",47815000,1000,0.00277619,0,0,0,0,0
"95631",47815500,1000,0.00279864,0,0,0,1,1
"95632",47816000,1000,0.00276159,0,0,0,2,2
"95633",47816500,1000,0.0026842,0,0,0,1,1
"95634",47817000,1000,0.0026792,0,0,0,0,0
"95635",47817500,1000,0.00289029,0,0,1,0,1
"95636",47818000,1000,0.00286956,0,0,1,0,1
"95637",47818500,1000,0.00276883,0,0,0,0,0
"95638",47819000,1000,0.0027908,0,0,0,1,1
"95639",47819500,1000,0.00279411,0,0,0,2,2
"95640",47820000,1000,0.00299593,0,1,1,1,3
"95641",47820500,1000,0.00296952,0,1,1,0,2
"95642",47821000,1000,0.00279788,0,0,1,0,1
"95643",47821500,1000,0.00268088,0,0,1,0,1
"95644",47822000,1000,0.00260092,0,0,0,0,0
"95645",47822500,1000,0.00269751,0,0,0,1,1
"95646",47823000,1000,0.00263911,0,0,0,1,1
"95647",47823500,1000,0.00272056,0,0,0,1,1
"95648",47824000,1000,0.00283731,0,0,0,2,2
"95649",47824500,1000,0.00279685,0,0,0,3,3
"95650",47825000,1000,0.00273363,0,0,0,3,3
"95651",47825500,1000,0.00269769,0,0,0,3,3
"95652",47826000,1000,0.00269993,0,0,0,2,2
"95653",47826500,1000,0.00277743,0,0,1,2,3
"95654",47827000,1000,0.00282175,0,0,1,2,3
"95655",47827500,1000,0.00290995,0,0,1,3,4
"95656",47828000,1000,0.00287604,0,0,1,3,4
"95657",47828500,1000,0.00279673,0,0,1,0,1
"95658",47829000,1000,0.00278152,0,0,1,2,3
"95659",47829500,1000,0.00275971,0,0,1,2,3
"95660",47830000,1000,0.00283582,0,0,1,1,2
"95661",47830500,1000,0.00282573,0,0,1,2,3
"95662",47831000,1000,0.00279877,0,0,1,1,2
"95663",47831500,1000,0.00265108,0,0,0,0,0
"95664",47832000,1000,0.00264899,0,0,0,1,1
"95665",47832500,1000,0.00273638,0,0,0,2,2
"95666",47833000,1000,0.00263491,0,0,0,1,1
"95667",47833500,1000,0.00272997,0,0,0,2,2
"95668",47834000,1000,0.00283929,0,0,0,2,2
"95669",47834500,1000,0.00317787,0,2,0,0,2
"95670",47835000,1000,0.00323409,0,3,0,0,3
"95671",47835500,1000,0.00280581,0,1,0,0,1
"95672",47836000,1000,0.00280355,0,0,0,0,0
"95673",47836500,1000,0.0028405,0,0,0,0,0
"95674",47837000,1000,0.00274123,0,0,0,0,0
"95675",47837500,1000,0.0027404,0,0,0,0,0
"95676",47838000,1000,0.0026739,0,0,0,0,0
"95677",47838500,1000,0.00260217,0,0,0,0,0
"95678",47839000,1000,0.00264106,0,0,0,0,0
"95679",47839500,1000,0.00261243,0,0,0,1,1
"95680",47840000,1000,0.00270659,0,0,0,1,1
"95681",47840500,1000,0.00285181,0,0,0,0,0
"95682",47841000,1000,0.00273936,0,0,0,0,0
"95683",47841500,1000,0.00261729,0,0,0,1,1
"95684",47842000,1000,0.00262261,0,0,0,1,1
"95685",47842500,1000,0.00260902,0,0,0,0,0
"95686",47843000,1000,0.00255401,0,0,0,0,0
"95687",47843500,1000,0.00264162,0,1,0,0,1
"95688",47844000,1000,0.00263621,0,1,0,0,1
"95689",47844500,1000,0.00255551,0,0,0,0,0
"95690",47845000,1000,0.00273618,0,1,0,0,1
"95691",47845500,1000,0.00274798,0,1,0,0,1
"95692",47846000,1000,0.00266747,0,0,0,0,0
"95693",47846500,1000,0.00257951,0,0,0,0,0
"95694",47847000,1000,0.00247656,0,0,0,0,0
"95695",47847500,1000,0.00252894,0,0,0,0,0
"95696",47848000,1000,0.00263496,0,0,1,0,1
"95697",47848500,1000,0.00308254,0,1,2,0,3
"95698",47849000,1000,0.00307938,0,1,1,1,3
"95699",47849500,1000,0.0027423,0,0,0,1,1
"95700",47850000,1000,0.0027345,0,0,0,0,0
"95701",47850500,1000,0.00261501,0,0,0,0,0
"95702",47851000,1000,0.00243908,0,0,0,0,0
"95703",47851500,1000,0.00257403,0,0,1,0,1
"95704",47852000,1000,0.00262769,0,0,1,0,1
"95705",47852500,1000,0.00249504,0,0,0,0,0
"95706",47853000,1000,0.002676,0,0,0,1,1
"95707",47853500,1000,0.0027796,0,0,0,1,1
"95708",47854000,1000,0.00268359,0,0,0,0,0
"95709",47854500,1000,0.00263405,0,0,0,0,0
"95710",47855000,1000,0.0025508,0,0,0,0,0
"95711",47855500,1000,0.00254444,0,0,0,0,0
"95712",47856000,1000,0.00273613,0,0,0,0,0
"95713",47856500,1000,0.0027462,0,0,0,1,1
"95714",47857000,1000,0.0026206,0,0,0,1,1
"95715",47857500,1000,0.00254353,0,0,0,0,0
"95716",47858000,1000,0.00250648,0,0,0,0,0
"95717",47858500,1000,0.00257632,0,0,0,1,1
"95718",47859000,1000,0.0026752,0,0,0,1,1
"95719",47859500,1000,0.00262706,0,0,0,0,0
"95720",47860000,1000,0.00262904,0,0,0,0,0
"95721",47860500,1000,0.00281185,0,0,1,1,2
"95722",47861000,1000,0.00278016,0,0,1,1,2
"95723",47861500,1000,0.00276554,0,0,1,1,2
"95724",47862000,1000,0.00282218,0,0,2,2,4
"95725",47862500,1000,0.00268772,0,0,1,1,2
"95726",47863000,1000,0.00260069,0,0,0,0,0
"95727",47863500,1000,0.00253068,0,0,0,0,0
"95728",47864000,1000,0.00269015,0,0,1,1,2
"95729",47864500,1000,0.0027982,0,0,1,1,2
"95730",47865000,1000,0.00273234,0,0,0,0,0
"95731",47865500,1000,0.00268219,0,0,0,0,0
"95732",47866000,1000,0.00272191,0,0,0,1,1
"95733",47866500,1000,0.00270039,0,0,0,1,1
"95734",47867000,1000,0.00263394,0,0,0,1,1
"95735",47867500,1000,0.00277248,0,0,0,1,1
"95736",47868000,1000,0.00279741,0,0,0,1,1
"95737",47868500,1000,0.00280489,0,0,1,1,2
"95738",47869000,1000,0.0027801,0,0,1,0,1
"95739",47869500,1000,0.00277368,0,1,0,0,1
"95740",47870000,1000,0.00275513,0,1,0,0,1
"95741",47870500,1000,0.00268744,0,0,0,1,1
"95742",47871000,1000,0.00261896,0,0,0,1,1
"95743",47871500,1000,0.00254829,0,0,0,0,0
"95744",47872000,1000,0.00251177,0,0,0,0,0
"95745",47872500,1000,0.00250984,0,0,0,0,0
"95746",47873000,1000,0.0026226,0,0,0,0,0
"95747",47873500,1000,0.00271872,0,0,0,0,0
"95748",47874000,1000,0.00282592,0,0,0,0,0
"95749",47874500,1000,0.00287804,0,0,0,1,1
"95750",47875000,1000,0.0027386,0,0,0,1,1
"95751",47875500,1000,0.00272185,0,0,0,0,0
"95752",47876000,1000,0.00281207,0,0,0,1,1
"95753",47876500,1000,0.00273822,0,0,0,3,3
"95754",47877000,1000,0.00262782,0,0,0,2,2
"95755",47877500,1000,0.00265314,0,0,0,0,0
"95756",47878000,1000,0.00266796,0,0,0,0,0
"95757",47878500,1000,0.0026435,0,0,0,1,1
"95758",47879000,1000,0.00268797,0,0,0,2,2
"95759",47879500,1000,0.00264159,0,0,0,2,2
"95760",47880000,1000,0.00263651,0,0,0,1,1
"95761",47880500,1000,0.0027777,0,0,1,1,2
"95762",47881000,1000,0.00283925,0,0,1,3,4
"95763",47881500,1000,0.002711,0,0,0,2,2
"95764",47882000,1000,0.00259513,0,0,0,0,0
"95765",47882500,1000,0.00260621,0,0,0,0,0
"95766",47883000,1000,0.00278092,0,0,0,1,1
"95767",47883500,1000,0.00280603,0,0,0,1,1
"95768",47884000,1000,0.0029275,0,1,0,0,1
"95769",47884500,1000,0.00282435,0,1,0,0,1
"95770",47885000,1000,0.00261158,0,0,0,0,0
"95771",47885500,1000,0.00271504,0,0,0,1,1
"95772",47886000,1000,0.00272453,0,0,0,3,3
"95773",47886500,1000,0.00293759,0,1,1,3,5
"95774",47887000,1000,0.00284702,0,1,1,2,4
"95775",47887500,1000,0.00262058,0,0,0,2,2
"95776",47888000,1000,0.00273361,0,0,0,4,4
"95777",47888500,1000,0.00280248,0,0,0,5,5
"95778",47889000,1000,0.00267653,0,0,0,2,2
"95779",47889500,1000,0.00269811,0,0,1,0,1
"95780",47890000,1000,0.00273713,0,0,1,0,1
"95781",47890500,1000,0.002713,0,0,1,0,1
"95782",47891000,1000,0.00275176,0,0,1,0,1
"95783",47891500,1000,0.00275549,0,0,0,0,0
"95784",47892000,1000,0.0028397,0,0,0,2,2
"95785",47892500,1000,0.0028996,0,0,1,4,5
"95786",47893000,1000,0.0029867,0,1,1,5,7
"95787",47893500,1000,0.00288991,0,1,0,3,4
"95788",47894000,1000,0.00267893,0,0,0,1,1
"95789",47894500,1000,0.00267094,0,0,0,1,1
"95790",47895000,1000,0.00269647,0,0,0,0,0
"95791",47895500,1000,0.0026743,0,0,0,1,1
"95792",47896000,1000,0.00252344,0,0,0,1,1
"95793",47896500,1000,0.00247907,0,0,0,0,0
"95794",47897000,1000,0.00254768,0,0,0,0,0
"95795",47897500,1000,0.00248512,0,0,0,0,0
"95796",47898000,1000,0.00254035,0,0,0,0,0
"95797",47898500,1000,0.00255336,0,0,0,0,0
"95798",47899000,1000,0.00255264,0,0,0,0,0
"95799",47899500,1000,0.00275285,0,0,0,1,1
"95800",47900000,1000,0.00272269,0,0,0,1,1
"95801",47900500,1000,0.00271804,0,0,1,1,2
"95802",47901000,1000,0.00282752,0,0,2,1,3
"95803",47901500,1000,0.00282071,0,0,2,0,2
"95804",47902000,1000,0.00290072,0,0,2,1,3
"95805",47902500,1000,0.00292138,0,0,2,2,4
"95806",47903000,1000,0.00273312,0,0,1,2,3
"95807",47903500,1000,0.00266083,0,0,0,2,2
"95808",47904000,1000,0.00279876,0,0,1,2,3
"95809",47904500,1000,0.00273039,0,0,1,1,2
"95810",47905000,1000,0.00259565,0,0,0,0,0
"95811",47905500,1000,0.00269566,0,0,1,0,1
"95812",47906000,1000,0.00277983,0,0,1,0,1
"95813",47906500,1000,0.00280061,0,0,0,0,0
"95814",47907000,1000,0.00275118,0,0,0,0,0
"95815",47907500,1000,0.00253666,0,0,0,0,0
"95816",47908000,1000,0.00255536,0,0,0,1,1
"95817",47908500,1000,0.0027073,0,0,0,1,1
"95818",47909000,1000,0.00270578,0,0,0,0,0
"95819",47909500,1000,0.00266247,0,0,0,0,0
"95820",47910000,1000,0.00262976,0,0,0,0,0
"95821",47910500,1000,0.0026908,0,0,0,0,0
"95822",47911000,1000,0.00272916,0,0,0,2,2
"95823",47911500,1000,0.00279921,0,1,0,2,3
"95824",47912000,1000,0.00290736,0,2,0,0,2
"95825",47912500,1000,0.00274154,0,1,0,0,1
"95826",47913000,1000,0.0026087,0,0,0,1,1
"95827",47913500,1000,0.00259611,0,0,0,2,2
"95828",47914000,1000,0.00262378,0,0,0,2,2
"95829",47914500,1000,0.00273627,0,0,0,1,1
"95830",47915000,1000,0.00269629,0,0,0,0,0
"95831",47915500,1000,0.00256789,0,0,0,0,0
"95832",47916000,1000,0.0026629,0,0,0,1,1
"95833",47916500,1000,0.00288502,0,0,0,2,2
"95834",47917000,1000,0.00284523,0,0,1,1,2
"95835",47917500,1000,0.00268972,0,0,1,1,2
"95836",47918000,1000,0.00276581,0,1,0,1,2
"95837",47918500,1000,0.00272136,0,1,0,1,2
"95838",47919000,1000,0.00253562,0,0,0,1,1
"95839",47919500,1000,0.00250218,0,0,0,0,0
"95840",47920000,1000,0.00266548,0,0,1,1,2
"95841",47920500,1000,0.00278776,0,0,2,1,3
"95842",47921000,1000,0.00263613,0,0,1,0,1
"95843",47921500,1000,0.00261561,0,0,1,0,1
"95844",47922000,1000,0.00261191,0,0,1,0,1
"95845",47922500,1000,0.00257196,0,0,0,0,0
"95846",47923000,1000,0.00270321,0,0,0,0,0
"95847",47923500,1000,0.00273189,0,0,0,2,2
"95848",47924000,1000,0.00269843,0,0,0,4,4
"95849",47924500,1000,0.00268623,0,0,0,2,2
"95850",47925000,1000,0.00276934,0,0,1,0,1
"95851",47925500,1000,0.00273804,0,0,1,1,2
"95852",47926000,1000,0.00273207,0,0,1,1,2
"95853",47926500,1000,0.00286891,0,0,1,3,4
"95854",47927000,1000,0.00302461,0,0,2,6,8
"95855",47927500,1000,0.00305201,0,0,2,3,5
"95856",47928000,1000,0.00285971,0,0,0,0,0
"95857",47928500,1000,0.00264081,0,0,0,0,0
"95858",47929000,1000,0.00253743,0,0,0,0,0
"95859",47929500,1000,0.00264508,0,0,0,1,1
"95860",47930000,1000,0.00290833,0,1,1,1,3
"95861",47930500,1000,0.00290064,0,1,1,0,2
"95862",47931000,1000,0.00264106,0,0,0,1,1
"95863",47931500,1000,0.00270842,0,0,0,1,1
"95864",47932000,1000,0.00277365,0,0,0,1,1
"95865",47932500,1000,0.00274406,0,0,1,1,2
"95866",47933000,1000,0.00296297,0,0,2,1,3
"95867",47933500,1000,0.00291053,0,0,1,1,2
"95868",47934000,1000,0.0027669,0,0,1,1,2
"95869",47934500,1000,0.00277361,0,0,1,1,2
"95870",47935000,1000,0.00265366,0,0,0,0,0
"95871",47935500,1000,0.0026572,0,0,0,0,0
"95872",47936000,1000,0.00274652,0,0,0,2,2
"95873",47936500,1000,0.00268046,0,0,0,2,2
"95874",47937000,1000,0.00258331,0,0,0,0,0
"95875",47937500,1000,0.00267713,0,0,0,2,2
"95876",47938000,1000,0.00262056,0,0,0,2,2
"95877",47938500,1000,0.0026161,0,0,0,0,0
"95878",47939000,1000,0.00282836,0,0,1,0,1
"95879",47939500,1000,0.00291746,0,0,2,1,3
"95880",47940000,1000,0.00285168,0,0,2,1,3
"95881",47940500,1000,0.00275679,0,0,1,0,1
"95882",47941000,1000,0.00271221,0,0,1,0,1
"95883",47941500,1000,0.00261095,0,0,1,0,1
"95884",47942000,1000,0.0025584,0,0,0,0,0
"95885",47942500,1000,0.00259891,0,0,0,0,0
"95886",47943000,1000,0.00282825,0,1,0,1,2
"95887",47943500,1000,0.00284075,0,1,0,1,2
"95888",47944000,1000,0.00270203,0,0,0,1,1
"95889",47944500,1000,0.00281584,0,0,0,3,3
"95890",47945000,1000,0.00275656,0,0,0,2,2
"95891",47945500,1000,0.00273647,0,0,0,1,1
"95892",47946000,1000,0.00282639,0,0,0,1,1
"95893",47946500,1000,0.00288045,0,0,0,3,3
"95894",47947000,1000,0.00274042,0,0,0,4,4
"95895",47947500,1000,0.00277996,0,0,2,2,4
"95896",47948000,1000,0.00274108,0,0,2,1,3
"95897",47948500,1000,0.00267909,0,0,0,0,0
"95898",47949000,1000,0.00269117,0,0,0,0,0
"95899",47949500,1000,0.00261989,0,0,0,1,1
"95900",47950000,1000,0.00266365,0,0,0,1,1
"95901",47950500,1000,0.00276634,0,0,1,0,1
"95902",47951000,1000,0.00281593,0,0,1,2,3
"95903",47951500,1000,0.00265975,0,0,0,2,2
"95904",47952000,1000,0.00258187,0,0,0,0,0
"95905",47952500,1000,0.00262262,0,0,0,0,0
"95906",47953000,1000,0.00268289,0,0,0,1,1
"95907",47953500,1000,0.00278017,0,0,0,3,3
"95908",47954000,1000,0.0027023,0,0,0,3,3
"95909",47954500,1000,0.00261976,0,0,0,1,1
"95910",47955000,1000,0.00282021,0,0,1,1,2
"95911",47955500,1000,0.00283718,0,0,1,1,2
"95912",47956000,1000,0.00271883,0,0,0,1,1
"95913",47956500,1000,0.00258469,0,0,0,1,1
"95914",47957000,1000,0.00255013,0,0,0,0,0
"95915",47957500,1000,0.00272499,0,0,0,0,0
"95916",47958000,1000,0.00279105,0,0,0,1,1
"95917",47958500,1000,0.00269082,0,0,0,1,1
"95918",47959000,1000,0.00263342,0,0,0,0,0
"95919",47959500,1000,0.00265678,0,0,0,0,0
"95920",47960000,1000,0.00264932,0,0,0,0,0
"95921",47960500,1000,0.00259448,0,0,0,0,0
"95922",47961000,1000,0.00264783,0,0,0,0,0
"95923",47961500,1000,0.00269872,0,0,0,0,0
"95924",47962000,1000,0.00276202,0,0,0,1,1
"95925",47962500,1000,0.00307688,0,1,1,1,3
"95926",47963000,1000,0.00304717,0,1,2,1,4
"95927",47963500,1000,0.00269126,0,0,1,1,2
"95928",47964000,1000,0.00254783,0,0,0,0,0
"95929",47964500,1000,0.00269118,0,0,0,2,2
"95930",47965000,1000,0.00281562,0,0,0,3,3
"95931",47965500,1000,0.00283838,0,0,0,3,3
"95932",47966000,1000,0.00275728,0,0,0,2,2
"95933",47966500,1000,0.00266386,0,0,0,1,1
"95934",47967000,1000,0.00281186,0,0,1,1,2
"95935",47967500,1000,0.00286647,0,0,1,1,2
"95936",47968000,1000,0.00268423,0,0,0,1,1
"95937",47968500,1000,0.00282566,0,1,0,2,3
"95938",47969000,1000,0.00304062,0,2,0,2,4
"95939",47969500,1000,0.00281537,0,1,0,0,1
"95940",47970000,1000,0.00267813,0,0,0,0,0
"95941",47970500,1000,0.00263554,0,0,0,0,0
"95942",47971000,1000,0.00260703,0,0,0,1,1
"95943",47971500,1000,0.00283772,0,0,2,3,5
"95944",47972000,1000,0.00286352,0,0,2,2,4
"95945",47972500,1000,0.00273288,0,0,0,1,1
"95946",47973000,1000,0.0026367,0,0,0,1,1
"95947",47973500,1000,0.00260593,0,0,0,0,0
"95948",47974000,1000,0.00271199,0,0,0,0,0
"95949",47974500,1000,0.0026853,0,0,0,0,0
"95950",47975000,1000,0.00279133,0,0,0,0,0
"95951",47975500,1000,0.00293914,0,0,0,0,0
"95952",47976000,1000,0.00280016,0,0,0,1,1
"95953",47976500,1000,0.00272853,0,0,0,2,2
"95954",47977000,1000,0.00283508,0,0,1,2,3
"95955",47977500,1000,0.00283725,0,1,1,1,3
"95956",47978000,1000,0.00287943,0,1,1,0,2
"95957",47978500,1000,0.0029354,0,0,1,0,1
"95958",47979000,1000,0.00307217,0,1,0,2,3
"95959",47979500,1000,0.00298493,0,1,0,2,3
"95960",47980000,1000,0.00270297,0,0,0,1,1
"95961",47980500,1000,0.00273766,0,0,0,1,1
"95962",47981000,1000,0.00289045,0,0,0,0,0
"95963",47981500,1000,0.00302237,0,0,0,3,3
"95964",47982000,1000,0.00277761,0,0,0,3,3
"95965",47982500,1000,0.0025678,0,0,0,0,0
"95966",47983000,1000,0.00295197,0,1,1,0,2
"95967",47983500,1000,0.00296176,0,1,1,0,2
"95968",47984000,1000,0.00267423,0,0,0,0,0
"95969",47984500,1000,0.0027469,0,0,0,2,2
"95970",47985000,1000,0.00283507,0,0,0,4,4
"95971",47985500,1000,0.00285715,0,0,1,3,4
"95972",47986000,1000,0.0028768,0,0,2,1,3
"95973",47986500,1000,0.00281371,0,0,2,0,2
"95974",47987000,1000,0.00272361,0,0,1,1,2
"95975",47987500,1000,0.0026195,0,0,0,1,1
"95976",47988000,1000,0.00265873,0,0,0,1,1
"95977",47988500,1000,0.00285108,0,0,0,2,2
"95978",47989000,1000,0.00274495,0,0,0,1,1
"95979",47989500,1000,0.00263349,0,0,0,0,0
"95980",47990000,1000,0.00274803,0,0,1,2,3
"95981",47990500,1000,0.00266631,0,0,1,2,3
"95982",47991000,1000,0.00263279,0,0,0,0,0
"95983",47991500,1000,0.00270488,0,0,0,0,0
"95984",47992000,1000,0.00270489,0,0,0,1,1
"95985",47992500,1000,0.00256589,0,0,0,1,1
"95986",47993000,1000,0.00243749,0,0,0,0,0
"95987",47993500,1000,0.00258443,0,0,0,1,1
"95988",47994000,1000,0.00270162,0,0,0,2,2
"95989",47994500,1000,0.00271803,0,0,0,1,1
"95990",47995000,1000,0.00269605,0,0,0,1,1
"95991",47995500,1000,0.00274402,0,0,0,2,2
"95992",47996000,1000,0.00270999,0,0,0,1,1
"95993",47996500,1000,0.00260455,0,0,0,0,0
"95994",47997000,1000,0.00276086,0,0,1,3,4
"95995",47997500,1000,0.00281477,0,0,1,3,4
"95996",47998000,1000,0.00266181,0,0,0,0,0
"95997",47998500,1000,0.00271204,0,0,0,2,2
"95998",47999000,1000,0.00285571,0,1,0,2,3
"95999",47999500,1000,0.00273698,0,1,0,0,1
"96000",48000000,1000,0.00267041,0,0,0,2,2
"96001",48000500,1000,0.0027715,0,0,0,5,5
"96002",48001000,1000,0.00271178,0,0,0,4,4
"96003",48001500,1000,0.00267094,0,0,0,2,2
"96004",48002000,1000,0.00255965,0,0,0,1,1
"96005",48002500,1000,0.00246148,0,0,0,0,0
"96006",48003000,1000,0.0027611,0,1,0,2,3
"96007",48003500,1000,0.00279439,0,1,0,2,3
"96008",48004000,1000,0.00260273,0,0,0,0,0
"96009",48004500,1000,0.00268542,0,0,0,1,1
"96010",48005000,1000,0.00272182,0,0,0,2,2
"96011",48005500,1000,0.00303726,0,1,1,2,4
"96012",48006000,1000,0.00295145,0,1,1,1,3
"96013",48006500,1000,0.00257144,0,0,0,2,2
"96014",48007000,1000,0.00260383,0,0,0,2,2
"96015",48007500,1000,0.00256324,0,0,0,0,0
"96016",48008000,1000,0.00258657,0,0,0,1,1
"96017",48008500,1000,0.00251814,0,0,0,1,1
"96018",48009000,1000,0.00255001,0,0,1,1,2
"96019",48009500,1000,0.00265034,0,0,1,2,3
"96020",48010000,1000,0.00252903,0,0,0,1,1
"96021",48010500,1000,0.00262643,0,0,0,2,2
"96022",48011000,1000,0.00270343,0,0,0,2,2
"96023",48011500,1000,0.00255663,0,0,0,0,0
"96024",48012000,1000,0.00246834,0,0,0,0,0
"96025",48012500,1000,0.00262598,0,0,0,1,1
"96026",48013000,1000,0.00266691,0,0,0,1,1
"96027",48013500,1000,0.00257344,0,0,0,0,0
"96028",48014000,1000,0.002771,0,0,0,2,2
"96029",48014500,1000,0.00274663,0,0,0,2,2
"96030",48015000,1000,0.00256931,0,0,0,0,0
"96031",48015500,1000,0.00259684,0,0,0,0,0
"96032",48016000,1000,0.00259372,0,0,0,0,0
"96033",48016500,1000,0.00258332,0,0,0,1,1
"96034",48017000,1000,0.00266239,0,0,0,3,3
"96035",48017500,1000,0.00267021,0,0,0,2,2
"96036",48018000,1000,0.00279401,0,0,1,1,2
"96037",48018500,1000,0.00285657,0,0,1,2,3
"96038",48019000,1000,0.00265561,0,0,0,2,2
"96039",48019500,1000,0.002595,0,0,0,1,1
"96040",48020000,1000,0.00268198,0,0,0,2,2
"96041",48020500,1000,0.0026912,0,0,0,2,2
"96042",48021000,1000,0.00265273,0,0,0,1,1
"96043",48021500,1000,0.00258847,0,0,0,2,2
"96044",48022000,1000,0.00252836,0,0,0,1,1
"96045",48022500,1000,0.0026063,0,0,1,1,2
"96046",48023000,1000,0.00251487,0,0,1,1,2
"96047",48023500,1000,0.00239601,0,0,0,0,0
"96048",48024000,1000,0.00239795,0,0,0,1,1
"96049",48024500,1000,0.00247067,0,0,0,1,1
"96050",48025000,1000,0.00256363,0,0,0,0,0
"96051",48025500,1000,0.00253105,0,0,0,0,0
"96052",48026000,1000,0.00256722,0,0,0,0,0
"96053",48026500,1000,0.00263433,0,0,0,0,0
"96054",48027000,1000,0.00270927,0,0,0,1,1
"96055",48027500,1000,0.00289323,0,1,0,1,2
"96056",48028000,1000,0.00283037,0,1,1,0,2
"96057",48028500,1000,0.00268435,0,0,1,1,2
"96058",48029000,1000,0.0027882,0,0,0,1,1
"96059",48029500,1000,0.0028046,0,0,1,1,2
"96060",48030000,1000,0.0027407,0,0,1,1,2
"96061",48030500,1000,0.00263275,0,0,0,0,0
"96062",48031000,1000,0.00268994,0,0,1,1,2
"96063",48031500,1000,0.00276099,0,0,1,1,2
"96064",48032000,1000,0.00271515,0,0,0,0,0
"96065",48032500,1000,0.00288741,0,0,1,0,1
"96066",48033000,1000,0.002873,0,0,1,0,1
"96067",48033500,1000,0.00284849,0,0,0,0,0
"96068",48034000,1000,0.00286686,0,0,0,0,0
"96069",48034500,1000,0.00278896,0,0,1,0,1
"96070",48035000,1000,0.00269471,0,0,1,0,1
"96071",48035500,1000,0.00271043,0,0,1,1,2
"96072",48036000,1000,0.00270333,0,0,1,1,2
"96073",48036500,1000,0.00268304,0,0,0,0,0
"96074",48037000,1000,0.00271973,0,0,0,0,0
"96075",48037500,1000,0.00247146,0,0,0,0,0
"96076",48038000,1000,0.00266205,0,0,1,0,1
"96077",48038500,1000,0.00280854,0,0,1,0,1
"96078",48039000,1000,0.00266119,0,0,0,2,2
"96079",48039500,1000,0.00273361,0,0,0,4,4
"96080",48040000,1000,0.00270933,0,0,0,3,3
"96081",48040500,1000,0.0028639,0,0,1,3,4
"96082",48041000,1000,0.00278397,0,0,1,2,3
"96083",48041500,1000,0.00254708,0,0,0,0,0
"96084",48042000,1000,0.00270806,0,0,0,2,2
"96085",48042500,1000,0.00292965,0,0,1,2,3
"96086",48043000,1000,0.00289034,0,0,1,0,1
"96087",48043500,1000,0.00271678,0,0,0,0,0
"96088",48044000,1000,0.00280001,0,0,0,2,2
"96089",48044500,1000,0.00275827,0,0,0,2,2
"96090",48045000,1000,0.00265319,0,0,0,1,1
"96091",48045500,1000,0.00265046,0,0,0,1,1
"96092",48046000,1000,0.00259254,0,0,0,0,0
"96093",48046500,1000,0.00261557,0,0,0,1,1
"96094",48047000,1000,0.0026063,0,0,0,1,1
"96095",48047500,1000,0.00254105,0,0,0,1,1
"96096",48048000,1000,0.00243675,0,0,0,1,1
"96097",48048500,1000,0.00237752,0,0,0,0,0
"96098",48049000,1000,0.00254382,0,0,0,1,1
"96099",48049500,1000,0.00269384,0,0,0,2,2
"96100",48050000,1000,0.00272617,0,0,1,1,2
"96101",48050500,1000,0.00276623,0,0,1,1,2
"96102",48051000,1000,0.00284982,0,0,0,2,2
"96103",48051500,1000,0.00284331,0,0,0,2,2
"96104",48052000,1000,0.00270393,0,0,0,1,1
"96105",48052500,1000,0.00264532,0,0,0,0,0
"96106",48053000,1000,0.00265854,0,0,0,0,0
"96107",48053500,1000,0.00273724,0,0,1,1,2
"96108",48054000,1000,0.00272061,0,0,1,1,2
"96109",48054500,1000,0.00270812,0,0,1,0,1
"96110",48055000,1000,0.00272621,0,0,1,1,2
"96111",48055500,1000,0.00267386,0,0,0,1,1
"96112",48056000,1000,0.00269361,0,0,0,0,0
"96113",48056500,1000,0.00280037,0,1,0,0,1
"96114",48057000,1000,0.00286115,0,1,0,1,2
"96115",48057500,1000,0.00274216,0,0,0,1,1
"96116",48058000,1000,0.00271392,0,0,0,0,0
"96117",48058500,1000,0.00278892,0,0,0,0,0
"96118",48059000,1000,0.00282474,0,0,0,0,0
"96119",48059500,1000,0.00279965,0,0,0,0,0
"96120",48060000,1000,0.0026452,0,0,0,0,0
"96121",48060500,1000,0.00259606,0,0,0,0,0
"96122",48061000,1000,0.00272144,0,0,1,0,1
"96123",48061500,1000,0.0027191,0,0,1,0,1
"96124",48062000,1000,0.00263746,0,0,0,1,1
"96125",48062500,1000,0.00263924,0,0,0,2,2
"96126",48063000,1000,0.00262617,0,0,0,2,2
"96127",48063500,1000,0.0026942,0,0,0,4,4
"96128",48064000,1000,0.00277987,0,0,0,4,4
"96129",48064500,1000,0.00274933,0,0,0,1,1
"96130",48065000,1000,0.00269887,0,0,0,0,0
"96131",48065500,1000,0.00268876,0,0,0,3,3
"96132",48066000,1000,0.00273127,0,0,0,4,4
"96133",48066500,1000,0.00277768,0,0,0,2,2
"96134",48067000,1000,0.00273942,0,0,0,2,2
"96135",48067500,1000,0.00261969,0,0,0,2,2
"96136",48068000,1000,0.00275717,0,1,0,1,2
"96137",48068500,1000,0.0029067,0,1,0,0,1
"96138",48069000,1000,0.0027768,0,0,0,1,1
"96139",48069500,1000,0.00278339,0,0,2,1,3
"96140",48070000,1000,0.00270574,0,0,2,0,2
"96141",48070500,1000,0.0025532,0,0,0,0,0
"96142",48071000,1000,0.00267732,0,0,0,0,0
"96143",48071500,1000,0.00281623,0,1,0,0,1
"96144",48072000,1000,0.00274522,0,1,0,0,1
"96145",48072500,1000,0.00270081,0,0,0,2,2
"96146",48073000,1000,0.002632,0,0,0,2,2
"96147",48073500,1000,0.00263045,0,0,0,2,2
"96148",48074000,1000,0.00270961,0,0,0,2,2
"96149",48074500,1000,0.00263744,0,0,0,0,0
"96150",48075000,1000,0.00275498,0,0,0,2,2
"96151",48075500,1000,0.00273457,0,0,0,2,2
"96152",48076000,1000,0.00265057,0,0,0,1,1
"96153",48076500,1000,0.00273464,0,0,0,2,2
"96154",48077000,1000,0.00259277,0,0,0,1,1
"96155",48077500,1000,0.00266709,0,0,1,2,3
"96156",48078000,1000,0.00284983,0,0,2,3,5
"96157",48078500,1000,0.00279843,0,0,1,3,4
"96158",48079000,1000,0.00292721,0,0,1,5,6
"96159",48079500,1000,0.00277931,0,0,1,3,4
"96160",48080000,1000,0.00260627,0,0,1,1,2
"96161",48080500,1000,0.00275532,0,0,2,3,5
"96162",48081000,1000,0.00265905,0,0,1,2,3
"96163",48081500,1000,0.00273928,0,0,1,1,2
"96164",48082000,1000,0.0030001,0,0,2,2,4
"96165",48082500,1000,0.00288065,0,0,1,2,3
"96166",48083000,1000,0.00273178,0,0,0,1,1
"96167",48083500,1000,0.00279208,0,0,1,1,2
"96168",48084000,1000,0.00289006,0,0,2,2,4
"96169",48084500,1000,0.00283135,0,0,2,2,4
"96170",48085000,1000,0.00271026,0,0,1,2,3
"96171",48085500,1000,0.00268562,0,0,0,2,2
"96172",48086000,1000,0.00258042,0,0,0,1,1
"96173",48086500,1000,0.0026619,0,0,0,3,3
"96174",48087000,1000,0.00278909,0,0,0,3,3
"96175",48087500,1000,0.00284757,0,0,1,1,2
"96176",48088000,1000,0.00295329,0,0,2,4,6
"96177",48088500,1000,0.0026904,0,0,1,3,4
"96178",48089000,1000,0.00256851,0,0,0,2,2
"96179",48089500,1000,0.00271835,0,0,0,4,4
"96180",48090000,1000,0.00275133,0,0,0,3,3
"96181",48090500,1000,0.00271817,0,0,0,1,1
"96182",48091000,1000,0.00263694,0,0,0,1,1
"96183",48091500,1000,0.00281224,0,0,1,4,5
"96184",48092000,1000,0.00296006,0,0,2,4,6
"96185",48092500,1000,0.00294129,0,0,2,2,4
"96186",48093000,1000,0.00268733,0,0,1,1,2
"96187",48093500,1000,0.00269559,0,0,1,1,2
"96188",48094000,1000,0.00291235,0,0,1,3,4
"96189",48094500,1000,0.00278695,0,0,0,4,4
"96190",48095000,1000,0.00268907,0,0,0,2,2
"96191",48095500,1000,0.00266357,0,0,0,0,0
"96192",48096000,1000,0.002693,0,0,0,0,0
"96193",48096500,1000,0.00282593,0,0,1,0,1
"96194",48097000,1000,0.00288993,0,0,1,4,5
"96195",48097500,1000,0.00266187,0,0,0,4,4
"96196",48098000,1000,0.00256607,0,0,0,0,0
"96197",48098500,1000,0.00264463,0,0,0,0,0
"96198",48099000,1000,0.00274334,0,0,1,0,1
"96199",48099500,1000,0.00280923,0,0,2,1,3
"96200",48100000,1000,0.00269965,0,0,1,1,2
"96201",48100500,1000,0.00253611,0,0,0,0,0
"96202",48101000,1000,0.00240594,0,0,0,0,0
"96203",48101500,1000,0.00252682,0,0,1,0,1
"96204",48102000,1000,0.00273673,0,0,2,0,2
"96205",48102500,1000,0.00262049,0,0,1,0,1
"96206",48103000,1000,0.00249671,0,0,0,0,0
"96207",48103500,1000,0.00265203,0,0,0,1,1
"96208",48104000,1000,0.00272273,0,0,0,3,3
"96209",48104500,1000,0.00281023,0,1,0,3,4
"96210",48105000,1000,0.00276958,0,1,0,1,2
"96211",48105500,1000,0.00260729,0,0,0,2,2
"96212",48106000,1000,0.00252161,0,0,0,2,2
"96213",48106500,1000,0.00264709,0,0,1,1,2
"96214",48107000,1000,0.00270177,0,0,1,1,2
"96215",48107500,1000,0.00252137,0,0,0,0,0
"96216",48108000,1000,0.00252387,0,0,0,0,0
"96217",48108500,1000,0.00259864,0,0,0,1,1
"96218",48109000,1000,0.00273828,0,0,0,2,2
"96219",48109500,1000,0.00265758,0,0,0,1,1
"96220",48110000,1000,0.0025541,0,0,0,0,0
"96221",48110500,1000,0.00261342,0,0,0,0,0
"96222",48111000,1000,0.00277179,0,0,1,1,2
"96223",48111500,1000,0.00278108,0,0,1,1,2
"96224",48112000,1000,0.00261274,0,0,0,0,0
"96225",48112500,1000,0.00269273,0,0,0,1,1
"96226",48113000,1000,0.00289638,0,0,0,2,2
"96227",48113500,1000,0.00281642,0,0,0,2,2
"96228",48114000,1000,0.00267567,0,0,0,2,2
"96229",48114500,1000,0.00277273,0,0,0,3,3
"96230",48115000,1000,0.00266104,0,0,0,2,2
"96231",48115500,1000,0.00261506,0,0,0,0,0
"96232",48116000,1000,0.00282746,0,0,0,2,2
"96233",48116500,1000,0.0029366,0,0,1,3,4
"96234",48117000,1000,0.00291197,0,1,1,1,3
"96235",48117500,1000,0.0027867,0,1,0,2,3
"96236",48118000,1000,0.00266677,0,0,0,2,2
"96237",48118500,1000,0.00271376,0,0,0,1,1
"96238",48119000,1000,0.00267353,0,0,0,1,1
"96239",48119500,1000,0.00263218,0,0,0,2,2
"96240",48120000,1000,0.00269907,0,0,1,3,4
"96241",48120500,1000,0.00274143,0,0,2,1,3
"96242",48121000,1000,0.00279783,0,0,1,0,1
"96243",48121500,1000,0.00286699,0,0,1,1,2
"96244",48122000,1000,0.00292761,0,0,1,1,2
"96245",48122500,1000,0.00286777,0,0,0,1,1
"96246",48123000,1000,0.00277393,0,0,0,1,1
"96247",48123500,1000,0.00266318,0,0,0,0,0
"96248",48124000,1000,0.00256198,0,0,0,0,0
"96249",48124500,1000,0.00269691,0,0,0,3,3
"96250",48125000,1000,0.00290406,0,0,0,5,5
"96251",48125500,1000,0.00283291,0,0,0,3,3
"96252",48126000,1000,0.00269672,0,0,0,1,1
"96253",48126500,1000,0.0027041,0,0,0,0,0
"96254",48127000,1000,0.00269388,0,0,0,0,0
"96255",48127500,1000,0.00275476,0,0,0,1,1
"96256",48128000,1000,0.00274823,0,0,0,3,3
"96257",48128500,1000,0.00262392,0,0,0,3,3
"96258",48129000,1000,0.00272659,0,0,0,3,3
"96259",48129500,1000,0.00269287,0,0,0,2,2
"96260",48130000,1000,0.00260272,0,0,0,1,1
"96261",48130500,1000,0.00274528,0,0,1,1,2
"96262",48131000,1000,0.00278378,0,0,1,1,2
"96263",48131500,1000,0.00262556,0,0,0,1,1
"96264",48132000,1000,0.0026791,0,0,0,2,2
"96265",48132500,1000,0.00290517,0,0,0,5,5
"96266",48133000,1000,0.00281395,0,0,0,3,3
"96267",48133500,1000,0.00266546,0,0,0,0,0
"96268",48134000,1000,0.00266434,0,0,1,0,1
"96269",48134500,1000,0.00283864,0,0,2,2,4
"96270",48135000,1000,0.00281341,0,0,1,2,3
"96271",48135500,1000,0.00264087,0,0,0,1,1
"96272",48136000,1000,0.00274519,0,0,0,4,4
"96273",48136500,1000,0.00279626,0,0,1,4,5
"96274",48137000,1000,0.00273001,0,0,1,2,3
"96275",48137500,1000,0.00265985,0,0,0,1,1
"96276",48138000,1000,0.00262445,0,0,0,0,0
"96277",48138500,1000,0.00266642,0,0,0,2,2
"96278",48139000,1000,0.00280386,0,0,1,2,3
"96279",48139500,1000,0.00276664,0,0,1,0,1
"96280",48140000,1000,0.00268054,0,0,0,0,0
"96281",48140500,1000,0.00267179,0,0,0,0,0
"96282",48141000,1000,0.00269668,0,0,1,0,1
"96283",48141500,1000,0.00272539,0,0,1,2,3
"96284",48142000,1000,0.00280167,0,0,1,3,4
"96285",48142500,1000,0.00284771,0,0,1,2,3
"96286",48143000,1000,0.00267465,0,0,0,1,1
"96287",48143500,1000,0.00265688,0,0,0,0,0
"96288",48144000,1000,0.00262942,0,0,0,0,0
"96289",48144500,1000,0.00255144,0,0,0,0,0
"96290",48145000,1000,0.00254346,0,0,0,0,0
"96291",48145500,1000,0.00259825,0,0,0,0,0
"96292",48146000,1000,0.00276538,0,0,1,1,2
"96293",48146500,1000,0.00294689,0,0,2,2,4
"96294",48147000,1000,0.00285593,0,0,1,2,3
"96295",48147500,1000,0.00257221,0,0,0,1,1
"96296",48148000,1000,0.00261493,0,0,0,0,0
"96297",48148500,1000,0.00264885,0,0,0,0,0
"96298",48149000,1000,0.00260072,0,0,0,0,0
"96299",48149500,1000,0.00262302,0,0,0,0,0
"96300",48150000,1000,0.00256402,0,0,0,0,0
"96301",48150500,1000,0.00267377,0,0,0,2,2
"96302",48151000,1000,0.00266577,0,0,0,2,2
"96303",48151500,1000,0.00250425,0,0,0,0,0
"96304",48152000,1000,0.00246586,0,0,0,0,0
"96305",48152500,1000,0.00241038,0,0,0,0,0
"96306",48153000,1000,0.00251866,0,0,0,0,0
"96307",48153500,1000,0.00271726,0,0,0,0,0
"96308",48154000,1000,0.00273973,0,0,0,0,0
"96309",48154500,1000,0.00273488,0,0,0,1,1
"96310",48155000,1000,0.00283054,0,0,1,2,3
"96311",48155500,1000,0.00275959,0,0,1,2,3
"96312",48156000,1000,0.00260697,0,0,0,1,1
"96313",48156500,1000,0.00267927,0,0,0,1,1
"96314",48157000,1000,0.00275035,0,0,0,3,3
"96315",48157500,1000,0.00289353,0,0,2,3,5
"96316",48158000,1000,0.00292705,0,0,3,2,5
"96317",48158500,1000,0.00272254,0,0,1,3,4
"96318",48159000,1000,0.00267807,0,0,0,2,2
"96319",48159500,1000,0.00259656,0,0,0,0,0
"96320",48160000,1000,0.00251181,0,0,0,0,0
"96321",48160500,1000,0.00256147,0,0,0,0,0
"96322",48161000,1000,0.00258106,0,0,0,1,1
"96323",48161500,1000,0.00257527,0,0,0,2,2
"96324",48162000,1000,0.00266328,0,0,0,3,3
"96325",48162500,1000,0.00267027,0,0,0,2,2
"96326",48163000,1000,0.00262377,0,0,0,0,0
"96327",48163500,1000,0.00257678,0,0,0,0,0
"96328",48164000,1000,0.00245148,0,0,0,0,0
"96329",48164500,1000,0.0025169,0,0,0,0,0
"96330",48165000,1000,0.00271461,0,0,0,1,1
"96331",48165500,1000,0.0026577,0,0,0,1,1
"96332",48166000,1000,0.00255822,0,0,0,0,0
"96333",48166500,1000,0.00268136,0,0,1,0,1
"96334",48167000,1000,0.00268015,0,0,1,0,1
"96335",48167500,1000,0.00255464,0,0,0,1,1
"96336",48168000,1000,0.00263583,0,0,1,3,4
"96337",48168500,1000,0.0026951,0,0,1,2,3
"96338",48169000,1000,0.00264445,0,0,0,0,0
"96339",48169500,1000,0.00266879,0,0,1,0,1
"96340",48170000,1000,0.00256466,0,0,1,0,1
"96341",48170500,1000,0.00265792,0,0,0,1,1
"96342",48171000,1000,0.00282899,0,0,0,3,3
"96343",48171500,1000,0.00284473,0,0,1,3,4
"96344",48172000,1000,0.00267792,0,0,1,1,2
"96345",48172500,1000,0.00248524,0,0,0,0,0
"96346",48173000,1000,0.00261975,0,0,0,0,0
"96347",48173500,1000,0.002622,0,0,0,0,0
"96348",48174000,1000,0.00253093,0,0,0,0,0
"96349",48174500,1000,0.00251421,0,0,0,0,0
"96350",48175000,1000,0.002646,0,0,0,1,1
"96351",48175500,1000,0.00274447,0,0,0,2,2
"96352",48176000,1000,0.00261079,0,0,0,1,1
"96353",48176500,1000,0.00246854,0,0,0,0,0
"96354",48177000,1000,0.00261324,0,0,0,1,1
"96355",48177500,1000,0.0027401,0,0,0,2,2
"96356",48178000,1000,0.00265052,0,0,0,2,2
"96357",48178500,1000,0.00259555,0,0,0,1,1
"96358",48179000,1000,0.00254689,0,0,0,0,0
"96359",48179500,1000,0.00262004,0,0,1,0,1
"96360",48180000,1000,0.00269556,0,0,1,1,2
"96361",48180500,1000,0.00277668,0,0,1,1,2
"96362",48181000,1000,0.00265017,0,0,1,0,1
"96363",48181500,1000,0.00250516,0,0,0,0,0
"96364",48182000,1000,0.00267496,0,0,0,0,0
"96365",48182500,1000,0.00281838,0,0,1,0,1
"96366",48183000,1000,0.00276788,0,0,1,0,1
"96367",48183500,1000,0.00251521,0,0,0,0,0
"96368",48184000,1000,0.00247689,0,0,0,0,0
"96369",48184500,1000,0.00263067,0,0,0,1,1
"96370",48185000,1000,0.002711,0,0,1,1,2
"96371",48185500,1000,0.00280859,0,0,1,0,1
"96372",48186000,1000,0.00269423,0,0,0,1,1
"96373",48186500,1000,0.00266161,0,0,0,3,3
"96374",48187000,1000,0.00264065,0,0,0,2,2
"96375",48187500,1000,0.00252471,0,0,0,0,0
"96376",48188000,1000,0.00269134,0,0,0,2,2
"96377",48188500,1000,0.00278909,0,0,0,2,2
"96378",48189000,1000,0.00281053,0,0,0,1,1
"96379",48189500,1000,0.00279531,0,0,1,2,3
"96380",48190000,1000,0.00274217,0,0,2,2,4
"96381",48190500,1000,0.00272733,0,0,1,3,4
"96382",48191000,1000,0.00250163,0,0,0,2,2
"96383",48191500,1000,0.00247469,0,0,0,0,0
"96384",48192000,1000,0.00257223,0,0,0,0,0
"96385",48192500,1000,0.00259725,0,0,0,0,0
"96386",48193000,1000,0.00266274,0,0,0,1,1
"96387",48193500,1000,0.00268165,0,0,0,2,2
"96388",48194000,1000,0.00261993,0,0,0,1,1
"96389",48194500,1000,0.00252569,0,0,0,0,0
"96390",48195000,1000,0.00255141,0,0,0,0,0
"96391",48195500,1000,0.00265204,0,0,0,1,1
"96392",48196000,1000,0.00258796,0,0,0,1,1
"96393",48196500,1000,0.00253853,0,0,0,0,0
"96394",48197000,1000,0.00269664,0,0,0,1,1
"96395",48197500,1000,0.00266615,0,0,0,1,1
"96396",48198000,1000,0.00269101,0,0,1,1,2
"96397",48198500,1000,0.00262684,0,0,1,1,2
"96398",48199000,1000,0.00256493,0,0,0,0,0
"96399",48199500,1000,0.00254533,0,0,0,0,0
"96400",48200000,1000,0.00265332,0,0,0,2,2
"96401",48200500,1000,0.00278912,0,0,0,3,3
"96402",48201000,1000,0.00258817,0,0,0,1,1
"96403",48201500,1000,0.00262982,0,0,0,1,1
"96404",48202000,1000,0.00277214,0,0,1,1,2
"96405",48202500,1000,0.00263881,0,0,1,0,1
"96406",48203000,1000,0.00258841,0,0,0,0,0
"96407",48203500,1000,0.00263413,0,0,0,1,1
"96408",48204000,1000,0.00266517,0,0,1,2,3
"96409",48204500,1000,0.00270272,0,0,1,2,3
"96410",48205000,1000,0.00269251,0,0,0,2,2
"96411",48205500,1000,0.00282065,0,1,0,2,3
"96412",48206000,1000,0.00270293,0,1,0,1,2
"96413",48206500,1000,0.00241347,0,0,0,0,0
"96414",48207000,1000,0.00254523,0,0,0,2,2
"96415",48207500,1000,0.00267102,0,0,0,2,2
"96416",48208000,1000,0.00269966,0,0,1,0,1
"96417",48208500,1000,0.00271929,0,0,1,0,1
"96418",48209000,1000,0.00257976,0,0,0,0,0
"96419",48209500,1000,0.00265344,0,0,0,0,0
"96420",48210000,1000,0.00285376,0,0,0,0,0
"96421",48210500,1000,0.00280923,0,0,0,2,2
"96422",48211000,1000,0.00267451,0,0,0,3,3
"96423",48211500,1000,0.00262776,0,0,0,1,1
"96424",48212000,1000,0.00265017,0,0,0,1,1
"96425",48212500,1000,0.00275982,0,0,1,1,2
"96426",48213000,1000,0.0028885,0,1,1,0,2
"96427",48213500,1000,0.00317156,0,2,0,0,2
"96428",48214000,1000,0.00298013,0,1,0,0,1
"96429",48214500,1000,0.00268938,0,0,1,2,3
"96430",48215000,1000,0.00268714,0,0,1,2,3
"96431",48215500,1000,0.00267977,0,0,0,0,0
"96432",48216000,1000,0.00275788,0,0,0,2,2
"96433",48216500,1000,0.00273988,0,0,0,2,2
"96434",48217000,1000,0.00274725,0,0,0,1,1
"96435",48217500,1000,0.00277444,0,0,0,2,2
"96436",48218000,1000,0.00281234,0,0,1,2,3
"96437",48218500,1000,0.00269524,0,0,1,1,2
"96438",48219000,1000,0.00249697,0,0,0,0,0
"96439",48219500,1000,0.00253617,0,0,0,0,0
"96440",48220000,1000,0.00262678,0,0,0,0,0
"96441",48220500,1000,0.00269147,0,0,0,2,2
"96442",48221000,1000,0.00280416,0,0,1,3,4
"96443",48221500,1000,0.00269292,0,0,1,1,2
"96444",48222000,1000,0.00248356,0,0,0,0,0
"96445",48222500,1000,0.00278599,0,0,1,3,4
"96446",48223000,1000,0.00286683,0,0,1,3,4
"96447",48223500,1000,0.00268014,0,0,0,0,0
"96448",48224000,1000,0.00291421,0,1,0,0,1
"96449",48224500,1000,0.00279005,0,1,0,0,1
"96450",48225000,1000,0.00245738,0,0,0,0,0
"96451",48225500,1000,0.00251663,0,0,0,0,0
"96452",48226000,1000,0.00258079,0,0,0,0,0
"96453",48226500,1000,0.00260327,0,0,0,0,0
"96454",48227000,1000,0.00265688,0,0,0,0,0
"96455",48227500,1000,0.00262065,0,0,0,0,0
"96456",48228000,1000,0.002561,0,0,0,0,0
"96457",48228500,1000,0.00261216,0,0,0,1,1
"96458",48229000,1000,0.00273454,0,0,0,2,2
"96459",48229500,1000,0.00272243,0,0,0,2,2
"96460",48230000,1000,0.00276908,0,0,1,2,3
"96461",48230500,1000,0.00271613,0,0,1,2,3
"96462",48231000,1000,0.00257037,0,0,0,1,1
"96463",48231500,1000,0.00254873,0,0,0,0,0
"96464",48232000,1000,0.00255637,0,0,0,0,0
"96465",48232500,1000,0.00250576,0,0,0,0,0
"96466",48233000,1000,0.00256416,0,0,0,0,0
"96467",48233500,1000,0.00275091,0,0,1,1,2
"96468",48234000,1000,0.00264681,0,0,1,1,2
"96469",48234500,1000,0.00243175,0,0,0,0,0
"96470",48235000,1000,0.00256146,0,0,0,1,1
"96471",48235500,1000,0.00274565,0,0,0,1,1
"96472",48236000,1000,0.00262145,0,0,0,0,0
"96473",48236500,1000,0.00271053,0,1,0,1,2
"96474",48237000,1000,0.00285001,0,1,1,1,3
"96475",48237500,1000,0.00269101,0,0,1,0,1
"96476",48238000,1000,0.00267678,0,0,0,1,1
"96477",48238500,1000,0.00269057,0,0,0,2,2
"96478",48239000,1000,0.00272088,0,0,0,1,1
"96479",48239500,1000,0.00268661,0,0,0,0,0
"96480",48240000,1000,0.00259588,0,0,0,0,0
"96481",48240500,1000,0.00281408,0,1,0,0,1
"96482",48241000,1000,0.00286548,0,1,0,0,1
"96483",48241500,1000,0.00260327,0,0,0,0,0
"96484",48242000,1000,0.00262539,0,0,0,1,1
"96485",48242500,1000,0.00264875,0,0,0,1,1
"96486",48243000,1000,0.00254045,0,0,0,0,0
"96487",48243500,1000,0.00251668,0,0,0,0,0
"96488",48244000,1000,0.00256817,0,0,0,0,0
"96489",48244500,1000,0.00269404,0,1,0,0,1
"96490",48245000,1000,0.00272468,0,1,0,0,1
"96491",48245500,1000,0.00283569,0,0,1,2,3
"96492",48246000,1000,0.00268708,0,0,1,2,3
"96493",48246500,1000,0.00253533,0,0,0,1,1
"96494",48247000,1000,0.00273446,0,0,0,1,1
"96495",48247500,1000,0.00265107,0,0,0,0,0
"96496",48248000,1000,0.00261216,0,0,0,1,1
"96497",48248500,1000,0.00271849,0,0,1,2,3
"96498",48249000,1000,0.00265698,0,0,1,2,3
"96499",48249500,1000,0.00258753,0,0,0,1,1
"96500",48250000,1000,0.0025484,0,0,0,1,1
"96501",48250500,1000,0.00252287,0,0,0,2,2
"96502",48251000,1000,0.00251501,0,0,0,1,1
"96503",48251500,1000,0.00257996,0,0,1,0,1
"96504",48252000,1000,0.00265421,0,0,1,0,1
"96505",48252500,1000,0.0026004,0,0,0,0,0
"96506",48253000,1000,0.00254847,0,0,0,0,0
"96507",48253500,1000,0.00266763,0,0,1,0,1
"96508",48254000,1000,0.0026477,0,0,1,0,1
"96509",48254500,1000,0.00245807,0,0,0,0,0
"96510",48255000,1000,0.00259534,0,0,0,0,0
"96511",48255500,1000,0.00265205,0,0,0,1,1
"96512",48256000,1000,0.00246284,0,0,0,1,1
"96513",48256500,1000,0.00255274,0,0,0,0,0
"96514",48257000,1000,0.00261987,0,0,0,0,0
"96515",48257500,1000,0.00259264,0,0,0,0,0
"96516",48258000,1000,0.00263729,0,0,0,0,0
"96517",48258500,1000,0.00255992,0,0,0,0,0
"96518",48259000,1000,0.00243854,0,0,0,0,0
"96519",48259500,1000,0.00242667,0,0,0,1,1
"96520",48260000,1000,0.00247223,0,0,0,1,1
"96521",48260500,1000,0.00254423,0,0,0,0,0
"96522",48261000,1000,0.00259164,0,0,0,0,0
"96523",48261500,1000,0.00265439,0,0,1,0,1
"96524",48262000,1000,0.00263666,0,0,1,0,1
"96525",48262500,1000,0.00254171,0,0,0,0,0
"96526",48263000,1000,0.00247295,0,0,0,0,0
"96527",48263500,1000,0.00266731,0,0,1,0,1
"96528",48264000,1000,0.0026874,0,0,1,0,1
"96529",48264500,1000,0.00255555,0,0,0,1,1
"96530",48265000,1000,0.00266115,0,0,0,3,3
"96531",48265500,1000,0.00261425,0,0,0,2,2
"96532",48266000,1000,0.0025785,0,0,0,1,1
"96533",48266500,1000,0.00267828,0,0,1,1,2
"96534",48267000,1000,0.0026182,0,0,1,0,1
"96535",48267500,1000,0.00248113,0,0,0,0,0
"96536",48268000,1000,0.00268095,0,1,0,0,1
"96537",48268500,1000,0.00274035,0,1,0,1,2
"96538",48269000,1000,0.00269272,0,0,0,1,1
"96539",48269500,1000,0.00281285,0,1,0,0,1
"96540",48270000,1000,0.00265347,0,1,0,0,1
"96541",48270500,1000,0.00266486,0,0,1,2,3
"96542",48271000,1000,0.00269975,0,0,1,3,4
"96543",48271500,1000,0.00263602,0,0,0,1,1
"96544",48272000,1000,0.00275572,0,0,1,1,2
"96545",48272500,1000,0.00274344,0,0,1,2,3
"96546",48273000,1000,0.00268913,0,0,0,1,1
"96547",48273500,1000,0.00266777,0,0,1,0,1
"96548",48274000,1000,0.00272658,0,0,1,2,3
"96549",48274500,1000,0.00270404,0,0,0,2,2
"96550",48275000,1000,0.00275549,0,0,1,1,2
"96551",48275500,1000,0.00275142,0,0,1,1,2
"96552",48276000,1000,0.00252849,0,0,0,0,0
"96553",48276500,1000,0.00278333,0,1,0,2,3
"96554",48277000,1000,0.00275421,0,1,0,2,3
"96555",48277500,1000,0.00241734,0,0,0,0,0
"96556",48278000,1000,0.00251797,0,0,0,1,1
"96557",48278500,1000,0.00261023,0,0,0,1,1
"96558",48279000,1000,0.00270733,0,0,0,1,1
"96559",48279500,1000,0.00273484,0,0,1,1,2
"96560",48280000,1000,0.00268589,0,0,1,2,3
"96561",48280500,1000,0.00258176,0,0,0,2,2
"96562",48281000,1000,0.00274141,0,0,0,3,3
"96563",48281500,1000,0.00274774,0,0,0,3,3
"96564",48282000,1000,0.00243503,0,0,0,0,0
"96565",48282500,1000,0.00252758,0,0,0,0,0
"96566",48283000,1000,0.00266811,0,0,0,0,0
"96567",48283500,1000,0.00260935,0,0,0,0,0
"96568",48284000,1000,0.0026074,0,0,1,0,1
"96569",48284500,1000,0.00257776,0,0,1,0,1
"96570",48285000,1000,0.00272441,0,0,1,1,2
"96571",48285500,1000,0.00271548,0,0,1,1,2
"96572",48286000,1000,0.00254849,0,0,0,1,1
"96573",48286500,1000,0.00281985,0,1,0,1,2
"96574",48287000,1000,0.00275358,0,1,0,0,1
"96575",48287500,1000,0.00250373,0,0,0,0,0
"96576",48288000,1000,0.0025211,0,0,0,0,0
"96577",48288500,1000,0.00251826,0,0,0,0,0
"96578",48289000,1000,0.00242751,0,0,0,0,0
"96579",48289500,1000,0.00238796,0,0,0,0,0
"96580",48290000,1000,0.00250112,0,0,0,0,0
"96581",48290500,1000,0.00257569,0,0,0,2,2
"96582",48291000,1000,0.00263497,0,0,0,2,2
"96583",48291500,1000,0.00265458,0,0,0,0,0
"96584",48292000,1000,0.00248276,0,0,0,0,0
"96585",48292500,1000,0.00246802,0,0,0,0,0
"96586",48293000,1000,0.00252613,0,0,0,0,0
"96587",48293500,1000,0.00249514,0,0,0,0,0
"96588",48294000,1000,0.00262988,0,0,0,0,0
"96589",48294500,1000,0.0026285,0,0,0,1,1
"96590",48295000,1000,0.00266676,0,0,1,2,3
"96591",48295500,1000,0.00277685,0,1,1,1,3
"96592",48296000,1000,0.0025852,0,1,0,0,1
"96593",48296500,1000,0.00277431,0,1,0,0,1
"96594",48297000,1000,0.00297146,0,1,1,0,2
"96595",48297500,1000,0.0026046,0,0,1,0,1
"96596",48298000,1000,0.00257339,0,0,0,0,0
"96597",48298500,1000,0.00263436,0,0,0,0,0
"96598",48299000,1000,0.00259758,0,0,0,0,0
"96599",48299500,1000,0.00268489,0,0,1,0,1
"96600",48300000,1000,0.00287298,0,0,1,1,2
"96601",48300500,1000,0.00279321,0,0,0,1,1
"96602",48301000,1000,0.00251412,0,0,0,0,0
"96603",48301500,1000,0.00260527,0,0,0,2,2
"96604",48302000,1000,0.00260464,0,0,0,2,2
"96605",48302500,1000,0.00263683,0,0,0,1,1
"96606",48303000,1000,0.00270698,0,0,0,1,1
"96607",48303500,1000,0.00252982,0,0,0,0,0
"96608",48304000,1000,0.00253016,0,0,0,0,0
"96609",48304500,1000,0.00262661,0,0,0,0,0
"96610",48305000,1000,0.00266921,0,0,0,0,0
"96611",48305500,1000,0.00266221,0,0,0,0,0
"96612",48306000,1000,0.00263519,0,0,0,0,0
"96613",48306500,1000,0.00256911,0,0,0,1,1
"96614",48307000,1000,0.0025759,0,0,1,1,2
"96615",48307500,1000,0.00254052,0,0,1,0,1
"96616",48308000,1000,0.00251011,0,0,0,0,0
"96617",48308500,1000,0.00255613,0,0,0,0,0
"96618",48309000,1000,0.00246755,0,0,0,0,0
"96619",48309500,1000,0.00246611,0,0,0,0,0
"96620",48310000,1000,0.00261091,0,0,0,0,0
"96621",48310500,1000,0.00271643,0,1,0,0,1
"96622",48311000,1000,0.00265899,0,1,0,1,2
"96623",48311500,1000,0.00260646,0,0,1,1,2
"96624",48312000,1000,0.00254506,0,0,1,0,1
"96625",48312500,1000,0.0025417,0,0,0,0,0
"96626",48313000,1000,0.00262014,0,0,0,2,2
"96627",48313500,1000,0.00257462,0,0,0,2,2
"96628",48314000,1000,0.00247997,0,0,0,0,0
"96629",48314500,1000,0.00240567,0,0,0,0,0
"96630",48315000,1000,0.0024482,0,0,0,0,0
"96631",48315500,1000,0.00242601,0,0,0,0,0
"96632",48316000,1000,0.00250792,0,0,0,0,0
"96633",48316500,1000,0.00268802,0,0,0,0,0
"96634",48317000,1000,0.00267084,0,0,0,1,1
"96635",48317500,1000,0.00268564,0,1,0,1,2
"96636",48318000,1000,0.00271995,0,1,1,0,2
"96637",48318500,1000,0.00268571,0,0,1,1,2
"96638",48319000,1000,0.00268323,0,0,0,1,1
"96639",48319500,1000,0.00263051,0,0,0,0,0
"96640",48320000,1000,0.00251036,0,0,0,0,0
"96641",48320500,1000,0.00257105,0,0,0,2,2
"96642",48321000,1000,0.00256951,0,0,0,2,2
"96643",48321500,1000,0.00266293,0,0,1,2,3
"96644",48322000,1000,0.00265311,0,0,1,2,3
"96645",48322500,1000,0.00254638,0,0,0,2,2
"96646",48323000,1000,0.0026065,0,0,0,2,2
"96647",48323500,1000,0.00278841,0,1,0,1,2
"96648",48324000,1000,0.00269284,0,1,0,2,3
"96649",48324500,1000,0.00245361,0,0,0,2,2
"96650",48325000,1000,0.00261057,0,0,1,2,3
"96651",48325500,1000,0.00283756,0,1,1,1,3
"96652",48326000,1000,0.00280189,0,1,0,2,3
"96653",48326500,1000,0.00257994,0,0,0,2,2
"96654",48327000,1000,0.00255224,0,0,0,1,1
"96655",48327500,1000,0.00259848,0,0,0,2,2
"96656",48328000,1000,0.00261816,0,0,0,1,1
"96657",48328500,1000,0.00267253,0,0,0,1,1
"96658",48329000,1000,0.00270344,0,0,0,1,1
"96659",48329500,1000,0.00254747,0,0,0,0,0
"96660",48330000,1000,0.00248116,0,0,0,0,0
"96661",48330500,1000,0.00250193,0,0,0,0,0
"96662",48331000,1000,0.00255322,0,0,0,0,0
"96663",48331500,1000,0.00250151,0,0,0,0,0
"96664",48332000,1000,0.00230751,0,0,0,0,0
"96665",48332500,1000,0.00232031,0,0,0,0,0
"96666",48333000,1000,0.00248229,0,0,0,0,0
"96667",48333500,1000,0.00254761,0,0,0,2,2
"96668",48334000,1000,0.00248412,0,0,0,2,2
"96669",48334500,1000,0.00238561,0,0,0,0,0
"96670",48335000,1000,0.00240945,0,0,0,0,0
"96671",48335500,1000,0.00248382,0,0,0,0,0
"96672",48336000,1000,0.00251664,0,0,0,1,1
"96673",48336500,1000,0.00246503,0,0,0,1,1
"96674",48337000,1000,0.00243712,0,0,0,0,0
"96675",48337500,1000,0.00260825,0,0,1,0,1
"96676",48338000,1000,0.00271779,0,0,2,1,3
"96677",48338500,1000,0.00269591,0,0,1,1,2
"96678",48339000,1000,0.00251602,0,0,0,0,0
"96679",48339500,1000,0.00256461,0,0,1,0,1
"96680",48340000,1000,0.00264264,0,0,1,0,1
"96681",48340500,1000,0.0024938,0,0,0,0,0
"96682",48341000,1000,0.00243299,0,0,0,0,0
"96683",48341500,1000,0.00238977,0,0,0,0,0
"96684",48342000,1000,0.0025697,0,0,0,1,1
"96685",48342500,1000,0.00268074,0,0,0,3,3
"96686",48343000,1000,0.00259122,0,0,0,2,2
"96687",48343500,1000,0.00244083,0,0,0,0,0
"96688",48344000,1000,0.00239038,0,0,0,1,1
"96689",48344500,1000,0.00245796,0,0,0,1,1
"96690",48345000,1000,0.00245349,0,0,0,0,0
"96691",48345500,1000,0.00246093,0,0,0,0,0
"96692",48346000,1000,0.0024841,0,0,0,0,0
"96693",48346500,1000,0.00244235,0,0,0,0,0
"96694",48347000,1000,0.0023981,0,0,0,1,1
"96695",48347500,1000,0.00252905,0,0,0,2,2
"96696",48348000,1000,0.00263416,0,0,0,2,2
"96697",48348500,1000,0.00265267,0,0,0,2,2
"96698",48349000,1000,0.00265348,0,0,0,1,1
"96699",48349500,1000,0.00267478,0,0,0,0,0
"96700",48350000,1000,0.00261766,0,0,0,0,0
"96701",48350500,1000,0.00255389,0,0,0,0,0
"96702",48351000,1000,0.00252871,0,0,0,0,0
"96703",48351500,1000,0.00256406,0,0,1,0,1
"96704",48352000,1000,0.00254523,0,0,1,0,1
"96705",48352500,1000,0.0025413,0,0,0,0,0
"96706",48353000,1000,0.00254637,0,0,0,0,0
"96707",48353500,1000,0.00265064,0,0,0,1,1
"96708",48354000,1000,0.00265828,0,0,0,1,1
"96709",48354500,1000,0.00254479,0,0,0,0,0
"96710",48355000,1000,0.00261867,0,0,0,0,0
"96711",48355500,1000,0.00255043,0,0,0,1,1
"96712",48356000,1000,0.00246914,0,0,0,1,1
"96713",48356500,1000,0.00243296,0,0,0,0,0
"96714",48357000,1000,0.00251904,0,0,1,1,2
"96715",48357500,1000,0.00259292,0,0,1,1,2
"96716",48358000,1000,0.00260255,0,0,0,0,0
"96717",48358500,1000,0.00248969,0,0,0,0,0
"96718",48359000,1000,0.00239624,0,0,0,1,1
"96719",48359500,1000,0.00248906,0,0,0,1,1
"96720",48360000,1000,0.00245383,0,0,0,0,0
"96721",48360500,1000,0.0023862,0,0,0,0,0
"96722",48361000,1000,0.00259503,0,0,1,1,2
"96723",48361500,1000,0.00275823,0,0,1,2,3
"96724",48362000,1000,0.00261155,0,0,0,1,1
"96725",48362500,1000,0.00249299,0,0,0,0,0
"96726",48363000,1000,0.00252997,0,0,0,0,0
"96727",48363500,1000,0.00255391,0,0,0,0,0
"96728",48364000,1000,0.00276314,0,0,1,1,2
"96729",48364500,1000,0.00284959,0,0,1,2,3
"96730",48365000,1000,0.00260011,0,0,0,1,1
"96731",48365500,1000,0.0028065,0,1,0,0,1
"96732",48366000,1000,0.00286835,0,1,0,0,1
"96733",48366500,1000,0.00264536,0,0,0,0,0
"96734",48367000,1000,0.00259225,0,0,0,0,0
"96735",48367500,1000,0.00258485,0,0,0,1,1
"96736",48368000,1000,0.00262976,0,0,0,1,1
"96737",48368500,1000,0.00262185,0,0,0,1,1
"96738",48369000,1000,0.00274621,0,0,0,3,3
"96739",48369500,1000,0.0026573,0,0,0,2,2
"96740",48370000,1000,0.00247735,0,0,0,0,0
"96741",48370500,1000,0.00258952,0,0,0,2,2
"96742",48371000,1000,0.00267684,0,0,1,2,3
"96743",48371500,1000,0.00256536,0,0,1,0,1
"96744",48372000,1000,0.00256895,0,0,0,0,0
"96745",48372500,1000,0.00283637,0,0,1,2,3
"96746",48373000,1000,0.00279136,0,0,1,2,3
"96747",48373500,1000,0.00261063,0,0,0,0,0
"96748",48374000,1000,0.00272866,0,0,0,1,1
"96749",48374500,1000,0.0027836,0,0,0,1,1
"96750",48375000,1000,0.00261047,0,0,0,0,0
"96751",48375500,1000,0.00256263,0,0,0,0,0
"96752",48376000,1000,0.00261866,0,0,0,0,0
"96753",48376500,1000,0.00281109,0,1,0,0,1
"96754",48377000,1000,0.00282266,0,1,0,0,1
"96755",48377500,1000,0.00266927,0,0,0,1,1
"96756",48378000,1000,0.00297929,0,1,1,2,4
"96757",48378500,1000,0.0029165,0,1,1,1,3
"96758",48379000,1000,0.00254264,0,0,0,1,1
"96759",48379500,1000,0.0026284,0,0,1,2,3
"96760",48380000,1000,0.00270874,0,0,1,1,2
"96761",48380500,1000,0.00255443,0,0,0,0,0
"96762",48381000,1000,0.00251169,0,0,0,0,0
"96763",48381500,1000,0.00249942,0,0,0,0,0
"96764",48382000,1000,0.00257179,0,0,0,0,0
"96765",48382500,1000,0.00274956,0,0,0,0,0
"96766",48383000,1000,0.00269189,0,0,0,0,0
"96767",48383500,1000,0.0026461,0,0,0,2,2
"96768",48384000,1000,0.00271276,0,0,0,2,2
"96769",48384500,1000,0.0027408,0,0,0,0,0
"96770",48385000,1000,0.00267668,0,0,0,0,0
"96771",48385500,1000,0.0026129,0,0,0,0,0
"96772",48386000,1000,0.00259978,0,0,0,0,0
"96773",48386500,1000,0.00255075,0,0,0,0,0
"96774",48387000,1000,0.0025591,0,0,0,0,0
"96775",48387500,1000,0.00256552,0,0,0,0,0
"96776",48388000,1000,0.00258539,0,0,0,2,2
"96777",48388500,1000,0.00252838,0,0,0,2,2
"96778",48389000,1000,0.0026349,0,0,1,0,1
"96779",48389500,1000,0.00272611,0,0,1,0,1
"96780",48390000,1000,0.00261997,0,0,0,0,0
"96781",48390500,1000,0.00274526,0,0,0,1,1
"96782",48391000,1000,0.00267646,0,0,0,1,1
"96783",48391500,1000,0.00249463,0,0,0,0,0
"96784",48392000,1000,0.0024949,0,0,0,0,0
"96785",48392500,1000,0.00250049,0,0,0,0,0
"96786",48393000,1000,0.00256318,0,0,0,0,0
"96787",48393500,1000,0.00253933,0,0,0,0,0
"96788",48394000,1000,0.00259498,0,0,0,0,0
"96789",48394500,1000,0.00262747,0,0,0,1,1
"96790",48395000,1000,0.0025932,0,0,0,1,1
"96791",48395500,1000,0.00254537,0,0,0,0,0
"96792",48396000,1000,0.00241147,0,0,0,0,0
"96793",48396500,1000,0.00243355,0,0,0,0,0
"96794",48397000,1000,0.00250516,0,0,0,0,0
"96795",48397500,1000,0.00249456,0,0,0,0,0
"96796",48398000,1000,0.00264974,0,0,0,0,0
"96797",48398500,1000,0.00274355,0,0,0,2,2
"96798",48399000,1000,0.00250309,0,0,0,2,2
"96799",48399500,1000,0.00248574,0,0,0,0,0
"96800",48400000,1000,0.00264842,0,0,0,2,2
"96801",48400500,1000,0.00259693,0,0,0,2,2
"96802",48401000,1000,0.0025798,0,0,0,2,2
"96803",48401500,1000,0.00258023,0,0,0,2,2
"96804",48402000,1000,0.00254455,0,0,0,0,0
"96805",48402500,1000,0.00259433,0,0,0,1,1
"96806",48403000,1000,0.00256234,0,0,0,1,1
"96807",48403500,1000,0.00268632,0,0,0,2,2
"96808",48404000,1000,0.00271602,0,0,0,2,2
"96809",48404500,1000,0.00241471,0,0,0,0,0
"96810",48405000,1000,0.00223157,0,0,0,0,0
"96811",48405500,1000,0.00236146,0,0,0,1,1
"96812",48406000,1000,0.00253909,0,0,0,1,1
"96813",48406500,1000,0.00265945,0,0,0,2,2
"96814",48407000,1000,0.00260001,0,0,0,2,2
"96815",48407500,1000,0.00251517,0,0,0,0,0
"96816",48408000,1000,0.00246556,0,0,0,0,0
"96817",48408500,1000,0.00247998,0,0,0,1,1
"96818",48409000,1000,0.00260912,0,0,0,2,2
"96819",48409500,1000,0.00258102,0,0,0,2,2
"96820",48410000,1000,0.00254303,0,0,0,1,1
"96821",48410500,1000,0.00254498,0,0,0,0,0
"96822",48411000,1000,0.00265133,0,0,0,2,2
"96823",48411500,1000,0.00271644,0,0,0,2,2
"96824",48412000,1000,0.00261849,0,0,0,0,0
"96825",48412500,1000,0.00253922,0,0,0,0,0
"96826",48413000,1000,0.00262243,0,0,0,2,2
"96827",48413500,1000,0.00264732,0,0,0,3,3
"96828",48414000,1000,0.00260411,0,0,0,2,2
"96829",48414500,1000,0.00260541,0,0,0,1,1
"96830",48415000,1000,0.00250404,0,0,0,0,0
"96831",48415500,1000,0.00257839,0,0,0,1,1
"96832",48416000,1000,0.0026634,0,0,0,1,1
"96833",48416500,1000,0.002571,0,0,0,0,0
"96834",48417000,1000,0.00259703,0,0,0,0,0
"96835",48417500,1000,0.00272555,0,0,0,2,2
"96836",48418000,1000,0.00273975,0,0,0,3,3
"96837",48418500,1000,0.00264689,0,0,1,1,2
"96838",48419000,1000,0.00258149,0,0,1,1,2
"96839",48419500,1000,0.00251622,0,0,1,1,2
"96840",48420000,1000,0.00257769,0,0,2,0,2
"96841",48420500,1000,0.00264459,0,0,1,0,1
"96842",48421000,1000,0.00267791,0,0,1,0,1
"96843",48421500,1000,0.00270243,0,0,1,1,2
"96844",48422000,1000,0.00271031,0,0,0,2,2
"96845",48422500,1000,0.00264379,0,0,0,1,1
"96846",48423000,1000,0.00254277,0,0,0,0,0
"96847",48423500,1000,0.00247273,0,0,0,0,0
"96848",48424000,1000,0.00261388,0,0,0,3,3
"96849",48424500,1000,0.00274376,0,0,0,5,5
"96850",48425000,1000,0.00272254,0,0,1,3,4
"96851",48425500,1000,0.00269482,0,0,1,1,2
"96852",48426000,1000,0.00257645,0,0,0,0,0
"96853",48426500,1000,0.00261441,0,0,0,1,1
"96854",48427000,1000,0.00273186,0,1,0,1,2
"96855",48427500,1000,0.00263907,0,1,0,0,1
"96856",48428000,1000,0.00257356,0,0,0,0,0
"96857",48428500,1000,0.00255017,0,0,0,0,0
"96858",48429000,1000,0.00255672,0,0,0,1,1
"96859",48429500,1000,0.00270245,0,0,0,2,2
"96860",48430000,1000,0.00258479,0,0,0,2,2
"96861",48430500,1000,0.00260877,0,0,0,3,3
"96862",48431000,1000,0.00273095,0,0,0,2,2
"96863",48431500,1000,0.00266026,0,0,0,0,0
"96864",48432000,1000,0.00291111,0,1,0,1,2
"96865",48432500,1000,0.00287993,0,1,0,1,2
"96866",48433000,1000,0.00265604,0,0,0,2,2
"96867",48433500,1000,0.00270063,0,0,0,2,2
"96868",48434000,1000,0.0026739,0,0,0,0,0
"96869",48434500,1000,0.0026859,0,0,0,0,0
"96870",48435000,1000,0.00267781,0,0,0,0,0
"96871",48435500,1000,0.00262168,0,0,0,0,0
"96872",48436000,1000,0.00265082,0,0,0,1,1
"96873",48436500,1000,0.00277098,0,0,0,2,2
"96874",48437000,1000,0.00269649,0,0,0,1,1
"96875",48437500,1000,0.00257946,0,0,0,1,1
"96876",48438000,1000,0.00257032,0,0,0,2,2
"96877",48438500,1000,0.00260327,0,0,0,1,1
"96878",48439000,1000,0.00264092,0,0,0,0,0
"96879",48439500,1000,0.00265094,0,0,0,0,0
"96880",48440000,1000,0.0030327,0,1,1,1,3
"96881",48440500,1000,0.00307813,0,1,1,2,4
"96882",48441000,1000,0.00269852,0,0,0,1,1
"96883",48441500,1000,0.00264931,0,0,0,0,0
"96884",48442000,1000,0.00261997,0,0,0,0,0
"96885",48442500,1000,0.00260542,0,0,0,1,1
"96886",48443000,1000,0.00260626,0,0,0,1,1
"96887",48443500,1000,0.00256271,0,0,1,0,1
"96888",48444000,1000,0.00260757,0,0,2,0,2
"96889",48444500,1000,0.00276177,0,0,1,1,2
"96890",48445000,1000,0.00278362,0,0,0,1,1
"96891",48445500,1000,0.00271619,0,0,0,1,1
"96892",48446000,1000,0.00264746,0,0,0,1,1
"96893",48446500,1000,0.00256646,0,0,0,0,0
"96894",48447000,1000,0.00246436,0,0,0,0,0
"96895",48447500,1000,0.00250815,0,0,0,1,1
"96896",48448000,1000,0.00270472,0,0,0,1,1
"96897",48448500,1000,0.00260394,0,0,0,0,0
"96898",48449000,1000,0.00254396,0,0,0,1,1
"96899",48449500,1000,0.00264626,0,0,0,1,1
"96900",48450000,1000,0.00273119,0,0,0,1,1
"96901",48450500,1000,0.00278482,0,0,1,1,2
"96902",48451000,1000,0.00274927,0,0,2,0,2
"96903",48451500,1000,0.00274798,0,0,1,1,2
"96904",48452000,1000,0.00271683,0,0,0,2,2
"96905",48452500,1000,0.00263063,0,0,0,2,2
"96906",48453000,1000,0.00249245,0,0,0,2,2
"96907",48453500,1000,0.00262426,0,0,0,1,1
"96908",48454000,1000,0.00276841,0,0,0,0,0
"96909",48454500,1000,0.00274131,0,0,1,0,1
"96910",48455000,1000,0.00273367,0,0,1,0,1
"96911",48455500,1000,0.0026155,0,0,0,0,0
"96912",48456000,1000,0.00253074,0,0,0,0,0
"96913",48456500,1000,0.00257237,0,0,0,1,1
"96914",48457000,1000,0.00264158,0,0,0,1,1
"96915",48457500,1000,0.00268782,0,0,0,0,0
"96916",48458000,1000,0.00264529,0,0,0,0,0
"96917",48458500,1000,0.00256994,0,0,0,1,1
"96918",48459000,1000,0.00279296,0,0,0,2,2
"96919",48459500,1000,0.00284781,0,0,0,1,1
"96920",48460000,1000,0.00272717,0,0,0,0,0
"96921",48460500,1000,0.00282733,0,0,0,2,2
"96922",48461000,1000,0.00276386,0,0,0,3,3
"96923",48461500,1000,0.00263556,0,0,0,1,1
"96924",48462000,1000,0.00259031,0,0,0,0,0
"96925",48462500,1000,0.00261785,0,0,0,1,1
"96926",48463000,1000,0.00268926,0,0,0,1,1
"96927",48463500,1000,0.00267815,0,0,0,0,0
"96928",48464000,1000,0.00273787,0,0,0,1,1
"96929",48464500,1000,0.00270338,0,0,0,2,2
"96930",48465000,1000,0.00257462,0,0,0,1,1
"96931",48465500,1000,0.00264905,0,0,0,1,1
"96932",48466000,1000,0.00265842,0,0,0,1,1
"96933",48466500,1000,0.00274916,0,1,0,0,1
"96934",48467000,1000,0.00284261,0,1,1,0,2
"96935",48467500,1000,0.0027725,0,0,1,2,3
"96936",48468000,1000,0.00282911,0,0,1,3,4
"96937",48468500,1000,0.00282831,0,0,2,2,4
"96938",48469000,1000,0.00272209,0,0,1,3,4
"96939",48469500,1000,0.00259572,0,0,0,2,2
"96940",48470000,1000,0.00266179,0,0,0,1,1
"96941",48470500,1000,0.00269746,0,0,0,1,1
"96942",48471000,1000,0.00269099,0,0,0,2,2
"96943",48471500,1000,0.00270448,0,0,0,3,3
"96944",48472000,1000,0.00269502,0,0,0,2,2
"96945",48472500,1000,0.00274119,0,0,0,1,1
"96946",48473000,1000,0.00275967,0,0,0,0,0
"96947",48473500,1000,0.00275363,0,0,0,2,2
"96948",48474000,1000,0.0026657,0,0,0,2,2
"96949",48474500,1000,0.00260011,0,0,0,1,1
"96950",48475000,1000,0.00259584,0,0,0,1,1
"96951",48475500,1000,0.00264242,0,0,0,1,1
"96952",48476000,1000,0.00261394,0,0,0,1,1
"96953",48476500,1000,0.0026477,0,0,0,2,2
"96954",48477000,1000,0.00273825,0,0,0,2,2
"96955",48477500,1000,0.00270234,0,0,0,0,0
"96956",48478000,1000,0.00268734,0,0,0,1,1
"96957",48478500,1000,0.00269139,0,0,0,1,1
"96958",48479000,1000,0.00265223,0,0,0,1,1
"96959",48479500,1000,0.00267063,0,0,0,2,2
"96960",48480000,1000,0.00263768,0,0,0,1,1
"96961",48480500,1000,0.00253332,0,0,0,0,0
"96962",48481000,1000,0.00257201,0,0,0,0,0
"96963",48481500,1000,0.00265933,0,0,0,0,0
"96964",48482000,1000,0.00281447,0,0,1,1,2
"96965",48482500,1000,0.00281253,0,0,1,1,2
"96966",48483000,1000,0.0028728,0,1,0,0,1
"96967",48483500,1000,0.00294451,0,1,0,1,2
"96968",48484000,1000,0.00280194,0,0,0,2,2
"96969",48484500,1000,0.00270292,0,0,0,1,1
"96970",48485000,1000,0.00273332,0,0,1,1,2
"96971",48485500,1000,0.00271323,0,0,1,1,2
"96972",48486000,1000,0.00283764,0,1,1,0,2
"96973",48486500,1000,0.00288897,0,1,1,0,2
"96974",48487000,1000,0.00267216,0,0,0,0,0
"96975",48487500,1000,0.00269641,0,0,0,2,2
"96976",48488000,1000,0.00277224,0,0,1,3,4
"96977",48488500,1000,0.00283231,0,0,2,1,3
"96978",48489000,1000,0.00272259,0,0,1,0,1
"96979",48489500,1000,0.00257408,0,0,0,0,0
"96980",48490000,1000,0.00258474,0,0,0,0,0
"96981",48490500,1000,0.00260931,0,0,0,0,0
"96982",48491000,1000,0.00265929,0,0,0,1,1
"96983",48491500,1000,0.00271987,0,0,0,1,1
"96984",48492000,1000,0.00276008,0,0,1,0,1
"96985",48492500,1000,0.00260092,0,0,1,0,1
"96986",48493000,1000,0.00244175,0,0,0,1,1
"96987",48493500,1000,0.00265845,0,0,0,3,3
"96988",48494000,1000,0.00269668,0,0,0,3,3
"96989",48494500,1000,0.00261269,0,0,0,1,1
"96990",48495000,1000,0.00269263,0,0,0,1,1
"96991",48495500,1000,0.00260811,0,0,0,1,1
"96992",48496000,1000,0.00259359,0,0,0,1,1
"96993",48496500,1000,0.00264084,0,0,0,2,2
"96994",48497000,1000,0.00255202,0,0,0,2,2
"96995",48497500,1000,0.00253276,0,0,0,1,1
"96996",48498000,1000,0.00262635,0,0,0,0,0
"96997",48498500,1000,0.0027018,0,0,0,0,0
"96998",48499000,1000,0.00269044,0,0,0,0,0
"96999",48499500,1000,0.00262488,0,0,0,0,0
"97000",48500000,1000,0.00267636,0,0,1,1,2
"97001",48500500,1000,0.00263662,0,0,1,1,2
"97002",48501000,1000,0.00270786,0,0,0,2,2
"97003",48501500,1000,0.00295705,0,0,1,2,3
"97004",48502000,1000,0.002913,0,0,1,0,1
"97005",48502500,1000,0.00279467,0,0,0,1,1
"97006",48503000,1000,0.00262949,0,0,0,1,1
"97007",48503500,1000,0.00258012,0,0,0,0,0
"97008",48504000,1000,0.0027432,0,0,1,0,1
"97009",48504500,1000,0.00274006,0,0,1,0,1
"97010",48505000,1000,0.00257346,0,0,0,0,0
"97011",48505500,1000,0.00269401,0,0,1,1,2
"97012",48506000,1000,0.00280264,0,0,1,1,2
"97013",48506500,1000,0.00279125,0,0,0,1,1
"97014",48507000,1000,0.00275822,0,0,0,2,2
"97015",48507500,1000,0.00260956,0,0,0,1,1
"97016",48508000,1000,0.00271207,0,0,1,0,1
"97017",48508500,1000,0.00286321,0,1,1,1,3
"97018",48509000,1000,0.00282959,0,1,0,2,3
"97019",48509500,1000,0.00292973,0,0,1,3,4
"97020",48510000,1000,0.00294017,0,0,1,4,5
"97021",48510500,1000,0.00266327,0,0,0,3,3
"97022",48511000,1000,0.00250968,0,0,0,1,1
"97023",48511500,1000,0.00250635,0,0,0,0,0
"97024",48512000,1000,0.00259361,0,0,0,0,0
"97025",48512500,1000,0.00275034,0,0,0,2,2
"97026",48513000,1000,0.00268483,0,0,0,2,2
"97027",48513500,1000,0.00270051,0,0,0,1,1
"97028",48514000,1000,0.00277699,0,0,0,1,1
"97029",48514500,1000,0.00270381,0,0,0,1,1
"97030",48515000,1000,0.00287367,0,1,0,1,2
"97031",48515500,1000,0.0028185,0,1,0,2,3
"97032",48516000,1000,0.00273476,0,0,1,2,3
"97033",48516500,1000,0.00278875,0,0,2,1,3
"97034",48517000,1000,0.00269493,0,0,1,1,2
"97035",48517500,1000,0.00272056,0,0,0,1,1
"97036",48518000,1000,0.00283446,0,0,1,2,3
"97037",48518500,1000,0.00280915,0,0,1,2,3
"97038",48519000,1000,0.00272355,0,0,0,2,2
"97039",48519500,1000,0.0027827,0,0,0,2,2
"97040",48520000,1000,0.00278553,0,0,0,1,1
"97041",48520500,1000,0.00264668,0,0,0,0,0
"97042",48521000,1000,0.00262985,0,0,1,1,2
"97043",48521500,1000,0.00261296,0,0,1,1,2
"97044",48522000,1000,0.00258751,0,0,0,0,0
"97045",48522500,1000,0.00261321,0,0,0,0,0
"97046",48523000,1000,0.0026266,0,0,0,1,1
"97047",48523500,1000,0.00268076,0,0,0,2,2
"97048",48524000,1000,0.00275321,0,0,1,2,3
"97049",48524500,1000,0.00270286,0,0,1,1,2
"97050",48525000,1000,0.00266646,0,0,0,1,1
"97051",48525500,1000,0.00267918,0,0,0,2,2
"97052",48526000,1000,0.00255051,0,0,0,1,1
"97053",48526500,1000,0.00260436,0,0,1,0,1
"97054",48527000,1000,0.00259095,0,0,1,1,2
"97055",48527500,1000,0.0026225,0,0,0,1,1
"97056",48528000,1000,0.002651,0,0,0,0,0
"97057",48528500,1000,0.00250829,0,0,0,0,0
"97058",48529000,1000,0.00256025,0,0,0,0,0
"97059",48529500,1000,0.00285244,0,1,0,0,1
"97060",48530000,1000,0.00294257,0,1,0,0,1
"97061",48530500,1000,0.00265174,0,0,0,0,0
"97062",48531000,1000,0.00251087,0,0,0,0,0
"97063",48531500,1000,0.00258357,0,0,0,0,0
"97064",48532000,1000,0.00266159,0,0,0,0,0
"97065",48532500,1000,0.00264257,0,0,0,0,0
"97066",48533000,1000,0.00273121,0,0,1,0,1
"97067",48533500,1000,0.00280946,0,0,1,1,2
"97068",48534000,1000,0.00263199,0,0,0,1,1
"97069",48534500,1000,0.00256876,0,0,0,1,1
"97070",48535000,1000,0.00252266,0,0,0,1,1
"97071",48535500,1000,0.00244432,0,0,0,0,0
"97072",48536000,1000,0.00258308,0,0,1,0,1
"97073",48536500,1000,0.00266988,0,0,2,0,2
"97074",48537000,1000,0.00272672,0,0,2,1,3
"97075",48537500,1000,0.00271049,0,0,1,1,2
"97076",48538000,1000,0.00272719,0,0,1,1,2
"97077",48538500,1000,0.00274716,0,0,1,2,3
"97078",48539000,1000,0.00266717,0,0,0,2,2
"97079",48539500,1000,0.00259155,0,0,0,1,1
"97080",48540000,1000,0.00264852,0,0,0,0,0
"97081",48540500,1000,0.00265581,0,0,0,0,0
"97082",48541000,1000,0.0025988,0,0,0,0,0
"97083",48541500,1000,0.00257029,0,0,0,0,0
"97084",48542000,1000,0.00249064,0,0,0,0,0
"97085",48542500,1000,0.00247399,0,0,0,0,0
"97086",48543000,1000,0.00243871,0,0,0,0,0
"97087",48543500,1000,0.00274836,0,1,0,0,1
"97088",48544000,1000,0.00285523,0,1,0,0,1
"97089",48544500,1000,0.00256364,0,0,0,0,0
"97090",48545000,1000,0.00261857,0,0,0,0,0
"97091",48545500,1000,0.00276688,0,0,0,1,1
"97092",48546000,1000,0.00260075,0,0,0,1,1
"97093",48546500,1000,0.00255024,0,0,0,1,1
"97094",48547000,1000,0.00259907,0,0,0,1,1
"97095",48547500,1000,0.00247512,0,0,0,0,0
"97096",48548000,1000,0.00245598,0,0,0,1,1
"97097",48548500,1000,0.00265172,0,0,1,1,2
"97098",48549000,1000,0.00268277,0,0,1,0,1
"97099",48549500,1000,0.0024761,0,0,0,0,0
"97100",48550000,1000,0.00247253,0,0,0,0,0
"97101",48550500,1000,0.00262807,0,0,0,0,0
"97102",48551000,1000,0.00254799,0,0,0,0,0
"97103",48551500,1000,0.00253901,0,0,0,1,1
"97104",48552000,1000,0.00268347,0,0,0,1,1
"97105",48552500,1000,0.00277094,0,0,1,1,2
"97106",48553000,1000,0.00291892,0,1,1,1,3
"97107",48553500,1000,0.00273444,0,1,0,1,2
"97108",48554000,1000,0.00243685,0,0,0,1,1
"97109",48554500,1000,0.00245285,0,0,0,0,0
"97110",48555000,1000,0.0025516,0,0,0,0,0
"97111",48555500,1000,0.0025337,0,0,0,0,0
"97112",48556000,1000,0.00252019,0,0,0,0,0
"97113",48556500,1000,0.00258427,0,0,0,0,0
"97114",48557000,1000,0.00264572,0,0,0,0,0
"97115",48557500,1000,0.00266801,0,0,0,0,0
"97116",48558000,1000,0.00267954,0,0,0,0,0
"97117",48558500,1000,0.00269073,0,0,0,0,0
"97118",48559000,1000,0.00264819,0,0,0,0,0
"97119",48559500,1000,0.00272543,0,0,1,1,2
"97120",48560000,1000,0.00279773,0,0,1,3,4
"97121",48560500,1000,0.0026782,0,0,0,2,2
"97122",48561000,1000,0.0026745,0,0,0,0,0
"97123",48561500,1000,0.00277466,0,0,0,0,0
"97124",48562000,1000,0.00268219,0,0,0,0,0
"97125",48562500,1000,0.00260386,0,0,0,0,0
"97126",48563000,1000,0.00273037,0,0,0,0,0
"97127",48563500,1000,0.00269279,0,0,0,0,0
"97128",48564000,1000,0.00244734,0,0,0,0,0
"97129",48564500,1000,0.00234178,0,0,0,0,0
"97130",48565000,1000,0.0025217,0,0,0,0,0
"97131",48565500,1000,0.00265989,0,0,0,0,0
"97132",48566000,1000,0.00267646,0,0,0,1,1
"97133",48566500,1000,0.00278678,0,0,0,2,2
"97134",48567000,1000,0.00291016,0,1,0,1,2
"97135",48567500,1000,0.0028969,0,1,0,2,3
"97136",48568000,1000,0.002827,0,0,0,2,2
"97137",48568500,1000,0.0026814,0,0,0,0,0
"97138",48569000,1000,0.00267314,0,0,0,1,1
"97139",48569500,1000,0.00269345,0,0,0,1,1
"97140",48570000,1000,0.00251892,0,0,0,0,0
"97141",48570500,1000,0.00254202,0,0,0,0,0
"97142",48571000,1000,0.00263778,0,0,0,0,0
"97143",48571500,1000,0.00266396,0,0,0,0,0
"97144",48572000,1000,0.00269902,0,0,0,0,0
"97145",48572500,1000,0.0029994,0,1,0,0,1
"97146",48573000,1000,0.00303799,0,1,0,1,2
"97147",48573500,1000,0.00262867,0,0,0,1,1
"97148",48574000,1000,0.00246052,0,0,0,0,0
"97149",48574500,1000,0.00249105,0,0,0,0,0
"97150",48575000,1000,0.00251334,0,0,0,0,0
"97151",48575500,1000,0.00250994,0,0,0,0,0
"97152",48576000,1000,0.00256012,0,0,0,0,0
"97153",48576500,1000,0.00262779,0,0,0,0,0
"97154",48577000,1000,0.0025734,0,0,0,1,1
"97155",48577500,1000,0.00256218,0,0,0,1,1
"97156",48578000,1000,0.00247532,0,0,0,0,0
"97157",48578500,1000,0.00249532,0,0,0,0,0
"97158",48579000,1000,0.00272668,0,1,0,0,1
"97159",48579500,1000,0.00271583,0,1,0,0,1
"97160",48580000,1000,0.00257677,0,0,0,0,0
"97161",48580500,1000,0.0024962,0,0,0,0,0
"97162",48581000,1000,0.00253648,0,0,0,0,0
"97163",48581500,1000,0.00260328,0,0,0,0,0
"97164",48582000,1000,0.00253808,0,0,0,1,1
"97165",48582500,1000,0.002651,0,0,1,3,4
"97166",48583000,1000,0.00275382,0,0,1,2,3
"97167",48583500,1000,0.00263226,0,0,0,0,0
"97168",48584000,1000,0.0026539,0,0,0,0,0
"97169",48584500,1000,0.00261358,0,0,0,0,0
"97170",48585000,1000,0.00255189,0,0,0,1,1
"97171",48585500,1000,0.00259273,0,0,0,1,1
"97172",48586000,1000,0.00257373,0,0,0,0,0
"97173",48586500,1000,0.00252486,0,0,0,0,0
"97174",48587000,1000,0.00250413,0,0,0,0,0
"97175",48587500,1000,0.00248614,0,0,0,0,0
"97176",48588000,1000,0.00257511,0,0,0,0,0
"97177",48588500,1000,0.00290615,0,1,0,1,2
"97178",48589000,1000,0.00289433,0,1,0,1,2
"97179",48589500,1000,0.00257861,0,0,0,0,0
"97180",48590000,1000,0.0025834,0,0,0,1,1
"97181",48590500,1000,0.0026612,0,0,0,1,1
"97182",48591000,1000,0.00269158,0,0,0,0,0
"97183",48591500,1000,0.00263353,0,0,0,0,0
"97184",48592000,1000,0.00259846,0,0,0,0,0
"97185",48592500,1000,0.00253948,0,0,0,0,0
"97186",48593000,1000,0.00249234,0,0,0,0,0
"97187",48593500,1000,0.00265519,0,0,0,1,1
"97188",48594000,1000,0.00256348,0,0,0,1,1
"97189",48594500,1000,0.00249651,0,0,0,0,0
"97190",48595000,1000,0.00265118,0,0,0,0,0
"97191",48595500,1000,0.00266921,0,0,0,0,0
"97192",48596000,1000,0.00256246,0,0,0,0,0
"97193",48596500,1000,0.00259997,0,0,0,0,0
"97194",48597000,1000,0.00265313,0,0,0,0,0
"97195",48597500,1000,0.00253112,0,0,0,0,0
"97196",48598000,1000,0.00247875,0,0,0,0,0
"97197",48598500,1000,0.00249854,0,0,0,0,0
"97198",48599000,1000,0.00251555,0,0,0,0,0
"97199",48599500,1000,0.00252428,0,0,0,0,0
"97200",48600000,1000,0.0025854,0,0,0,0,0
"97201",48600500,1000,0.00261222,0,0,0,1,1
"97202",48601000,1000,0.0026449,0,0,0,1,1
"97203",48601500,1000,0.00276212,0,0,0,1,1
"97204",48602000,1000,0.00267172,0,0,0,2,2
"97205",48602500,1000,0.00252135,0,0,0,2,2
"97206",48603000,1000,0.00254108,0,0,0,1,1
"97207",48603500,1000,0.00254569,0,0,0,0,0
"97208",48604000,1000,0.00253107,0,0,0,0,0
"97209",48604500,1000,0.00258978,0,0,0,0,0
"97210",48605000,1000,0.00265458,0,0,0,0,0
"97211",48605500,1000,0.00254916,0,0,0,0,0
"97212",48606000,1000,0.0024921,0,0,1,0,1
"97213",48606500,1000,0.00254469,0,0,1,0,1
"97214",48607000,1000,0.00250462,0,0,0,1,1
"97215",48607500,1000,0.00257207,0,0,0,1,1
"97216",48608000,1000,0.00271111,0,0,1,1,2
"97217",48608500,1000,0.00260758,0,0,1,1,2
"97218",48609000,1000,0.00258063,0,0,0,1,1
"97219",48609500,1000,0.00270452,0,0,0,2,2
"97220",48610000,1000,0.00255784,0,0,0,1,1
"97221",48610500,1000,0.00246213,0,0,0,1,1
"97222",48611000,1000,0.00249479,0,0,0,1,1
"97223",48611500,1000,0.00246078,0,0,0,0,0
"97224",48612000,1000,0.00247008,0,0,0,0,0
"97225",48612500,1000,0.00245254,0,0,0,0,0
"97226",48613000,1000,0.0027832,0,1,0,0,1
"97227",48613500,1000,0.0027763,0,1,0,0,1
"97228",48614000,1000,0.00253739,0,0,0,0,0
"97229",48614500,1000,0.00256578,0,0,0,0,0
"97230",48615000,1000,0.00254324,0,0,0,1,1
"97231",48615500,1000,0.00251274,0,0,0,1,1
"97232",48616000,1000,0.00248567,0,0,0,0,0
"97233",48616500,1000,0.00262161,0,0,0,0,0
"97234",48617000,1000,0.00274243,0,0,1,0,1
"97235",48617500,1000,0.00268653,0,0,1,0,1
"97236",48618000,1000,0.00252561,0,0,0,0,0
"97237",48618500,1000,0.00252139,0,0,0,0,0
"97238",48619000,1000,0.00254253,0,0,0,0,0
"97239",48619500,1000,0.00252071,0,0,0,0,0
"97240",48620000,1000,0.00261414,0,0,1,0,1
"97241",48620500,1000,0.00265714,0,0,1,0,1
"97242",48621000,1000,0.00262511,0,0,0,1,1
"97243",48621500,1000,0.00262825,0,0,0,2,2
"97244",48622000,1000,0.00282906,0,1,0,2,3
"97245",48622500,1000,0.00289357,0,1,0,1,2
"97246",48623000,1000,0.00272644,0,0,0,1,1
"97247",48623500,1000,0.00264405,0,0,0,1,1
"97248",48624000,1000,0.00244034,0,0,0,0,0
"97249",48624500,1000,0.0024415,0,0,0,0,0
"97250",48625000,1000,0.00246909,0,0,0,0,0
"97251",48625500,1000,0.00242929,0,0,0,0,0
"97252",48626000,1000,0.00252562,0,0,0,0,0
"97253",48626500,1000,0.00253684,0,0,0,0,0
"97254",48627000,1000,0.00264631,0,0,0,2,2
"97255",48627500,1000,0.00275944,0,0,0,3,3
"97256",48628000,1000,0.00260205,0,0,0,1,1
"97257",48628500,1000,0.0025133,0,0,0,0,0
"97258",48629000,1000,0.00264881,0,0,0,1,1
"97259",48629500,1000,0.00264193,0,0,0,1,1
"97260",48630000,1000,0.00256249,0,0,0,0,0
"97261",48630500,1000,0.00269679,0,0,0,2,2
"97262",48631000,1000,0.00273497,0,0,0,2,2
"97263",48631500,1000,0.00274447,0,0,1,0,1
"97264",48632000,1000,0.00280662,0,0,1,0,1
"97265",48632500,1000,0.00282149,0,0,0,2,2
"97266",48633000,1000,0.00289836,0,0,0,4,4
"97267",48633500,1000,0.00271215,0,0,0,2,2
"97268",48634000,1000,0.00255576,0,0,0,1,1
"97269",48634500,1000,0.00252337,0,0,0,1,1
"97270",48635000,1000,0.0025534,0,0,0,1,1
"97271",48635500,1000,0.00257947,0,0,0,1,1
"97272",48636000,1000,0.00261195,0,0,0,1,1
"97273",48636500,1000,0.00261338,0,0,0,1,1
"97274",48637000,1000,0.002602,0,0,0,0,0
"97275",48637500,1000,0.00275446,0,0,0,1,1
"97276",48638000,1000,0.00264842,0,0,0,1,1
"97277",48638500,1000,0.00250704,0,0,0,0,0
"97278",48639000,1000,0.00268613,0,0,0,0,0
"97279",48639500,1000,0.0027442,0,0,0,1,1
"97280",48640000,1000,0.00258403,0,0,0,1,1
"97281",48640500,1000,0.00256841,0,0,0,0,0
"97282",48641000,1000,0.0025752,0,0,0,0,0
"97283",48641500,1000,0.00259595,0,0,0,1,1
"97284",48642000,1000,0.00255822,0,0,0,1,1
"97285",48642500,1000,0.00261577,0,0,0,0,0
"97286",48643000,1000,0.00272236,0,0,0,2,2
"97287",48643500,1000,0.00271126,0,0,0,2,2
"97288",48644000,1000,0.00269666,0,0,1,0,1
"97289",48644500,1000,0.0027454,0,0,2,0,2
"97290",48645000,1000,0.00274026,0,0,1,0,1
"97291",48645500,1000,0.00261665,0,0,0,1,1
"97292",48646000,1000,0.00260377,0,0,0,2,2
"97293",48646500,1000,0.00256851,0,0,0,1,1
"97294",48647000,1000,0.00259693,0,0,0,0,0
"97295",48647500,1000,0.00271793,0,0,1,1,2
"97296",48648000,1000,0.00266858,0,0,1,1,2
"97297",48648500,1000,0.00263022,0,0,0,0,0
"97298",48649000,1000,0.00268366,0,0,0,1,1
"97299",48649500,1000,0.00268385,0,0,0,1,1
"97300",48650000,1000,0.00251277,0,0,0,0,0
"97301",48650500,1000,0.00252225,0,0,0,1,1
"97302",48651000,1000,0.00273666,0,0,1,2,3
"97303",48651500,1000,0.00278134,0,0,1,2,3
"97304",48652000,1000,0.00262845,0,0,0,1,1
"97305",48652500,1000,0.00251216,0,0,0,0,0
"97306",48653000,1000,0.00256033,0,0,0,2,2
"97307",48653500,1000,0.00258147,0,0,0,2,2
"97308",48654000,1000,0.00260408,0,0,0,0,0
"97309",48654500,1000,0.00274511,0,0,1,1,2
"97310",48655000,1000,0.00267435,0,0,1,1,2
"97311",48655500,1000,0.00241637,0,0,0,0,0
"97312",48656000,1000,0.00247159,0,0,0,0,0
"97313",48656500,1000,0.00268683,0,0,1,1,2
"97314",48657000,1000,0.00271814,0,0,1,1,2
"97315",48657500,1000,0.00277532,0,0,1,1,2
"97316",48658000,1000,0.00278472,0,0,1,1,2
"97317",48658500,1000,0.00270442,0,0,1,0,1
"97318",48659000,1000,0.0026856,0,0,1,0,1
"97319",48659500,1000,0.00257439,0,0,0,0,0
"97320",48660000,1000,0.00259949,0,0,0,1,1
"97321",48660500,1000,0.00259027,0,0,0,1,1
"97322",48661000,1000,0.00277198,0,0,2,2,4
"97323",48661500,1000,0.00281583,0,0,2,3,5
"97324",48662000,1000,0.0027099,0,0,0,3,3
"97325",48662500,1000,0.00281707,0,0,0,3,3
"97326",48663000,1000,0.00269331,0,0,0,1,1
"97327",48663500,1000,0.00276554,0,1,0,0,1
"97328",48664000,1000,0.00276877,0,1,0,1,2
"97329",48664500,1000,0.00256963,0,0,0,1,1
"97330",48665000,1000,0.00274982,0,0,1,3,4
"97331",48665500,1000,0.00283394,0,0,1,4,5
"97332",48666000,1000,0.00261412,0,0,0,1,1
"97333",48666500,1000,0.00255702,0,0,0,0,0
"97334",48667000,1000,0.00276883,0,0,0,1,1
"97335",48667500,1000,0.0027423,0,0,0,2,2
"97336",48668000,1000,0.00272678,0,1,0,1,2
"97337",48668500,1000,0.0029004,0,1,1,1,3
"97338",48669000,1000,0.00292447,0,0,1,3,4
"97339",48669500,1000,0.00290881,0,0,0,5,5
"97340",48670000,1000,0.00272983,0,0,0,3,3
"97341",48670500,1000,0.00261853,0,0,0,0,0
"97342",48671000,1000,0.00255484,0,0,0,0,0
"97343",48671500,1000,0.00263493,0,0,1,1,2
"97344",48672000,1000,0.00270837,0,0,1,2,3
"97345",48672500,1000,0.00259432,0,0,0,1,1
"97346",48673000,1000,0.00260476,0,0,0,0,0
"97347",48673500,1000,0.00269909,0,0,0,1,1
"97348",48674000,1000,0.00275509,0,0,0,2,2
"97349",48674500,1000,0.00272156,0,0,0,1,1
"97350",48675000,1000,0.00272154,0,0,0,2,2
"97351",48675500,1000,0.00270912,0,0,0,2,2
"97352",48676000,1000,0.00258129,0,0,0,0,0
"97353",48676500,1000,0.00251564,0,0,0,0,0
"97354",48677000,1000,0.00255332,0,0,0,0,0
"97355",48677500,1000,0.00259838,0,0,0,0,0
"97356",48678000,1000,0.00262469,0,0,0,0,0
"97357",48678500,1000,0.00257377,0,0,0,0,0
"97358",48679000,1000,0.00246328,0,0,0,0,0
"97359",48679500,1000,0.00246665,0,0,0,0,0
"97360",48680000,1000,0.00259063,0,0,0,0,0
"97361",48680500,1000,0.00266973,0,0,0,1,1
"97362",48681000,1000,0.00282568,0,0,1,2,3
"97363",48681500,1000,0.00280446,0,0,1,2,3
"97364",48682000,1000,0.00267688,0,0,0,1,1
"97365",48682500,1000,0.00270094,0,0,0,0,0
"97366",48683000,1000,0.00281709,0,0,1,1,2
"97367",48683500,1000,0.00279525,0,0,1,1,2
"97368",48684000,1000,0.00263286,0,0,0,0,0
"97369",48684500,1000,0.00259091,0,0,0,0,0
"97370",48685000,1000,0.00257673,0,0,0,0,0
"97371",48685500,1000,0.00276473,0,0,1,1,2
"97372",48686000,1000,0.00275903,0,0,1,1,2
"97373",48686500,1000,0.00253488,0,0,0,1,1
"97374",48687000,1000,0.00244902,0,0,0,1,1
"97375",48687500,1000,0.00251418,0,0,0,0,0
"97376",48688000,1000,0.00259614,0,0,0,0,0
"97377",48688500,1000,0.00277242,0,0,1,2,3
"97378",48689000,1000,0.00274604,0,0,1,2,3
"97379",48689500,1000,0.00256365,0,0,0,1,1
"97380",48690000,1000,0.00255493,0,0,0,1,1
"97381",48690500,1000,0.00271679,0,0,1,1,2
"97382",48691000,1000,0.00283725,0,0,1,1,2
"97383",48691500,1000,0.00267568,0,0,0,0,0
"97384",48692000,1000,0.00259157,0,0,0,1,1
"97385",48692500,1000,0.00254961,0,0,0,2,2
"97386",48693000,1000,0.00258389,0,0,0,1,1
"97387",48693500,1000,0.00275015,0,0,1,1,2
"97388",48694000,1000,0.00265856,0,0,1,1,2
"97389",48694500,1000,0.00248739,0,0,0,0,0
"97390",48695000,1000,0.00255399,0,0,0,2,2
"97391",48695500,1000,0.00259785,0,0,0,3,3
"97392",48696000,1000,0.002639,0,0,0,2,2
"97393",48696500,1000,0.0025857,0,0,0,2,2
"97394",48697000,1000,0.00249258,0,0,0,1,1
"97395",48697500,1000,0.00249261,0,0,0,1,1
"97396",48698000,1000,0.00254067,0,0,0,1,1
"97397",48698500,1000,0.00261165,0,0,0,0,0
"97398",48699000,1000,0.00269805,0,0,1,1,2
"97399",48699500,1000,0.00285261,0,0,2,2,4
"97400",48700000,1000,0.00287907,0,0,1,1,2
"97401",48700500,1000,0.00257332,0,0,0,1,1
"97402",48701000,1000,0.00257643,0,0,0,3,3
"97403",48701500,1000,0.00269626,0,0,0,2,2
"97404",48702000,1000,0.00270451,0,0,0,1,1
"97405",48702500,1000,0.00268595,0,0,0,1,1
"97406",48703000,1000,0.00257218,0,0,0,0,0
"97407",48703500,1000,0.00251578,0,0,0,0,0
"97408",48704000,1000,0.00264995,0,0,0,1,1
"97409",48704500,1000,0.00280786,0,0,0,1,1
"97410",48705000,1000,0.0027539,0,0,0,0,0
"97411",48705500,1000,0.00272595,0,0,0,0,0
"97412",48706000,1000,0.00275821,0,0,0,1,1
"97413",48706500,1000,0.00283027,0,0,0,2,2
"97414",48707000,1000,0.00275671,0,0,0,1,1
"97415",48707500,1000,0.00279682,0,0,0,2,2
"97416",48708000,1000,0.00284028,0,0,0,3,3
"97417",48708500,1000,0.00269776,0,0,0,1,1
"97418",48709000,1000,0.00266025,0,0,0,0,0
"97419",48709500,1000,0.00270405,0,0,0,1,1
"97420",48710000,1000,0.00271477,0,0,0,2,2
"97421",48710500,1000,0.00273881,0,0,0,1,1
"97422",48711000,1000,0.00274958,0,0,1,0,1
"97423",48711500,1000,0.00275975,0,0,2,1,3
"97424",48712000,1000,0.00283144,0,1,1,1,3
"97425",48712500,1000,0.00286759,0,1,0,2,3
"97426",48713000,1000,0.00281519,0,0,1,2,3
"97427",48713500,1000,0.00275451,0,0,1,0,1
"97428",48714000,1000,0.0026861,0,0,0,1,1
"97429",48714500,1000,0.00265263,0,0,0,2,2
"97430",48715000,1000,0.00257186,0,0,0,1,1
"97431",48715500,1000,0.00254921,0,0,0,0,0
"97432",48716000,1000,0.00258408,0,0,0,1,1
"97433",48716500,1000,0.00257748,0,0,0,2,2
"97434",48717000,1000,0.00250249,0,0,0,1,1
"97435",48717500,1000,0.00249512,0,0,0,0,0
"97436",48718000,1000,0.00246078,0,0,0,0,0
"97437",48718500,1000,0.00256328,0,0,1,1,2
"97438",48719000,1000,0.00263268,0,0,1,1,2
"97439",48719500,1000,0.00239975,0,0,0,0,0
"97440",48720000,1000,0.00252535,0,0,0,0,0
"97441",48720500,1000,0.00271647,0,0,0,2,2
"97442",48721000,1000,0.00272375,0,0,0,2,2
"97443",48721500,1000,0.00264336,0,0,0,1,1
"97444",48722000,1000,0.00250709,0,0,0,1,1
"97445",48722500,1000,0.00245125,0,0,0,0,0
"97446",48723000,1000,0.00248002,0,0,0,0,0
"97447",48723500,1000,0.00249187,0,0,0,0,0
"97448",48724000,1000,0.0025594,0,0,0,1,1
"97449",48724500,1000,0.0026631,0,0,0,1,1
"97450",48725000,1000,0.00278705,0,1,0,0,1
"97451",48725500,1000,0.00285869,0,1,1,0,2
"97452",48726000,1000,0.00266147,0,0,1,0,1
"97453",48726500,1000,0.00261236,0,0,0,0,0
"97454",48727000,1000,0.00267904,0,0,0,0,0
"97455",48727500,1000,0.00281261,0,1,0,1,2
"97456",48728000,1000,0.00275057,0,1,0,1,2
"97457",48728500,1000,0.00254366,0,0,0,0,0
"97458",48729000,1000,0.00265397,0,0,0,0,0
"97459",48729500,1000,0.00276561,0,0,0,0,0
"97460",48730000,1000,0.00281979,0,0,1,0,1
"97461",48730500,1000,0.00274531,0,0,1,1,2
"97462",48731000,1000,0.00277725,0,0,1,2,3
"97463",48731500,1000,0.00280947,0,0,1,3,4
"97464",48732000,1000,0.00275842,0,0,0,3,3
"97465",48732500,1000,0.00281594,0,0,1,1,2
"97466",48733000,1000,0.00265393,0,0,1,1,2
"97467",48733500,1000,0.00251782,0,0,0,1,1
"97468",48734000,1000,0.00259967,0,0,0,0,0
"97469",48734500,1000,0.0026637,0,0,0,0,0
"97470",48735000,1000,0.00269579,0,0,0,0,0
"97471",48735500,1000,0.00264634,0,0,0,0,0
"97472",48736000,1000,0.00264423,0,0,0,0,0
"97473",48736500,1000,0.00265642,0,0,0,0,0
"97474",48737000,1000,0.0026739,0,0,0,2,2
"97475",48737500,1000,0.00268284,0,0,0,2,2
"97476",48738000,1000,0.00271816,0,0,0,0,0
"97477",48738500,1000,0.002772,0,0,0,1,1
"97478",48739000,1000,0.00269296,0,0,0,1,1
"97479",48739500,1000,0.00264402,0,0,0,1,1
"97480",48740000,1000,0.00259536,0,0,0,3,3
"97481",48740500,1000,0.00258201,0,0,0,2,2
"97482",48741000,1000,0.00266089,0,0,0,1,1
"97483",48741500,1000,0.00270654,0,0,1,2,3
"97484",48742000,1000,0.00260526,0,0,1,1,2
"97485",48742500,1000,0.00264351,0,0,0,1,1
"97486",48743000,1000,0.00275375,0,0,0,2,2
"97487",48743500,1000,0.00271873,0,0,0,2,2
"97488",48744000,1000,0.0025745,0,0,0,1,1
"97489",48744500,1000,0.0026059,0,0,0,1,1
"97490",48745000,1000,0.00285562,0,1,1,1,3
"97491",48745500,1000,0.0028526,0,1,1,0,2
"97492",48746000,1000,0.00269143,0,0,0,0,0
"97493",48746500,1000,0.00259786,0,0,0,0,0
"97494",48747000,1000,0.00255959,0,0,0,0,0
"97495",48747500,1000,0.00249967,0,0,0,0,0
"97496",48748000,1000,0.00240332,0,0,0,0,0
"97497",48748500,1000,0.00238542,0,0,0,1,1
"97498",48749000,1000,0.00246612,0,0,0,1,1
"97499",48749500,1000,0.00256391,0,0,0,0,0
"97500",48750000,1000,0.00257597,0,0,0,0,0
"97501",48750500,1000,0.00250707,0,0,0,0,0
"97502",48751000,1000,0.00248953,0,0,0,0,0
"97503",48751500,1000,0.00272968,0,0,1,0,1
"97504",48752000,1000,0.00283409,0,0,1,0,1
"97505",48752500,1000,0.00267072,0,0,0,1,1
"97506",48753000,1000,0.00257036,0,0,0,1,1
"97507",48753500,1000,0.00255693,0,0,0,0,0
"97508",48754000,1000,0.0026581,0,0,0,0,0
"97509",48754500,1000,0.00265875,0,0,0,0,0
"97510",48755000,1000,0.00252919,0,0,0,0,0
"97511",48755500,1000,0.0025971,0,0,1,0,1
"97512",48756000,1000,0.00272444,0,0,1,0,1
"97513",48756500,1000,0.00260796,0,0,0,1,1
"97514",48757000,1000,0.00257883,0,0,0,1,1
"97515",48757500,1000,0.00260236,0,0,0,0,0
"97516",48758000,1000,0.00263153,0,0,0,1,1
"97517",48758500,1000,0.00267195,0,0,0,1,1
"97518",48759000,1000,0.00258595,0,0,0,0,0
"97519",48759500,1000,0.00269255,0,0,0,2,2
"97520",48760000,1000,0.00279148,0,0,0,2,2
"97521",48760500,1000,0.00269573,0,0,0,0,0
"97522",48761000,1000,0.00260246,0,0,0,0,0
"97523",48761500,1000,0.00259265,0,0,0,0,0
"97524",48762000,1000,0.00274679,0,0,0,2,2
"97525",48762500,1000,0.00292805,0,0,0,4,4
"97526",48763000,1000,0.00289136,0,0,0,2,2
"97527",48763500,1000,0.00283989,0,0,1,0,1
"97528",48764000,1000,0.00288523,0,0,1,1,2
"97529",48764500,1000,0.00272276,0,0,0,1,1
"97530",48765000,1000,0.00272714,0,0,0,0,0
"97531",48765500,1000,0.00286439,0,0,0,1,1
"97532",48766000,1000,0.00279691,0,0,0,1,1
"97533",48766500,1000,0.0027726,0,0,0,1,1
"97534",48767000,1000,0.00280338,0,0,0,3,3
"97535",48767500,1000,0.00281151,0,0,0,3,3
"97536",48768000,1000,0.0028984,0,1,0,2,3
"97537",48768500,1000,0.00275037,0,1,0,2,3
"97538",48769000,1000,0.00267574,0,0,0,1,1
"97539",48769500,1000,0.00272593,0,0,0,1,1
"97540",48770000,1000,0.00264069,0,0,0,1,1
"97541",48770500,1000,0.00267304,0,0,0,1,1
"97542",48771000,1000,0.00265653,0,0,0,2,2
"97543",48771500,1000,0.00273505,0,0,0,1,1
"97544",48772000,1000,0.00268252,0,0,0,1,1
"97545",48772500,1000,0.00267774,0,0,1,1,2
"97546",48773000,1000,0.00264475,0,0,1,0,1
"97547",48773500,1000,0.00261006,0,0,0,2,2
"97548",48774000,1000,0.00269407,0,0,0,3,3
"97549",48774500,1000,0.00259978,0,0,1,2,3
"97550",48775000,1000,0.00248475,0,0,1,1,2
"97551",48775500,1000,0.00250242,0,0,0,0,0
"97552",48776000,1000,0.00267522,0,0,1,1,2
"97553",48776500,1000,0.00264021,0,0,1,1,2
"97554",48777000,1000,0.00268334,0,0,1,1,2
"97555",48777500,1000,0.00298032,0,0,3,2,5
"97556",48778000,1000,0.00294093,0,0,2,2,4
"97557",48778500,1000,0.00285105,0,0,1,2,3
"97558",48779000,1000,0.00278452,0,0,1,1,2
"97559",48779500,1000,0.00257784,0,0,0,0,0
"97560",48780000,1000,0.00248324,0,0,0,1,1
"97561",48780500,1000,0.00249051,0,0,0,1,1
"97562",48781000,1000,0.00260214,0,0,0,1,1
"97563",48781500,1000,0.00270353,0,0,0,2,2
"97564",48782000,1000,0.00273716,0,0,0,3,3
"97565",48782500,1000,0.00272211,0,0,0,4,4
"97566",48783000,1000,0.00258974,0,0,0,2,2
"97567",48783500,1000,0.00264628,0,0,1,2,3
"97568",48784000,1000,0.00279625,0,0,1,2,3
"97569",48784500,1000,0.00265106,0,0,0,0,0
"97570",48785000,1000,0.00265952,0,0,0,0,0
"97571",48785500,1000,0.00286199,0,0,0,0,0
"97572",48786000,1000,0.00281022,0,0,0,0,0
"97573",48786500,1000,0.00269351,0,0,0,0,0
"97574",48787000,1000,0.00279121,0,0,0,2,2
"97575",48787500,1000,0.00276254,0,0,0,3,3
"97576",48788000,1000,0.00268966,0,0,0,1,1
"97577",48788500,1000,0.00278394,0,0,0,1,1
"97578",48789000,1000,0.00265823,0,0,0,1,1
"97579",48789500,1000,0.0026179,0,0,1,1,2
"97580",48790000,1000,0.00292829,0,0,2,2,4
"97581",48790500,1000,0.00310687,0,1,1,3,5
"97582",48791000,1000,0.00289522,0,1,0,2,3
"97583",48791500,1000,0.0028168,0,0,0,1,1
"97584",48792000,1000,0.0028912,0,0,0,1,1
"97585",48792500,1000,0.00266311,0,0,0,0,0
"97586",48793000,1000,0.00264818,0,0,0,0,0
"97587",48793500,1000,0.00273876,0,0,0,0,0
"97588",48794000,1000,0.00280148,0,0,0,0,0
"97589",48794500,1000,0.0028159,0,0,0,0,0
"97590",48795000,1000,0.00269634,0,0,0,0,0
"97591",48795500,1000,0.00263131,0,0,0,0,0
"97592",48796000,1000,0.00269538,0,0,0,2,2
"97593",48796500,1000,0.00277312,0,0,0,2,2
"97594",48797000,1000,0.00274314,0,0,0,0,0
"97595",48797500,1000,0.00297583,0,1,1,2,4
"97596",48798000,1000,0.00297472,0,1,1,3,5
"97597",48798500,1000,0.00268764,0,0,0,1,1
"97598",48799000,1000,0.00293473,0,1,0,2,3
"97599",48799500,1000,0.00299703,0,1,0,4,5
"97600",48800000,1000,0.0030215,0,1,0,4,5
"97601",48800500,1000,0.00315657,0,1,1,4,6
"97602",48801000,1000,0.00290178,0,0,1,2,3
"97603",48801500,1000,0.00280228,0,0,0,1,1
"97604",48802000,1000,0.00264287,0,0,0,1,1
"97605",48802500,1000,0.00260665,0,0,1,1,2
"97606",48803000,1000,0.00273639,0,0,1,2,3
"97607",48803500,1000,0.00274371,0,0,0,1,1
"97608",48804000,1000,0.0027616,0,0,0,0,0
"97609",48804500,1000,0.00266153,0,0,0,0,0
"97610",48805000,1000,0.00263428,0,0,0,0,0
"97611",48805500,1000,0.00269237,0,0,0,1,1
"97612",48806000,1000,0.00265947,0,0,0,1,1
"97613",48806500,1000,0.00270941,0,0,1,0,1
"97614",48807000,1000,0.00269658,0,0,1,0,1
"97615",48807500,1000,0.0026409,0,0,0,2,2
"97616",48808000,1000,0.00269164,0,0,0,4,4
"97617",48808500,1000,0.00270191,0,0,0,4,4
"97618",48809000,1000,0.00292005,0,1,1,2,4
"97619",48809500,1000,0.0028562,0,1,1,0,2
"97620",48810000,1000,0.00264165,0,0,1,0,1
"97621",48810500,1000,0.00257177,0,0,1,0,1
"97622",48811000,1000,0.00261318,0,0,0,2,2
"97623",48811500,1000,0.00263765,0,0,0,2,2
"97624",48812000,1000,0.00258052,0,0,0,0,0
"97625",48812500,1000,0.00261205,0,0,0,0,0
"97626",48813000,1000,0.00263733,0,0,0,0,0
"97627",48813500,1000,0.00264472,0,0,0,0,0
"97628",48814000,1000,0.00269872,0,0,1,1,2
"97629",48814500,1000,0.00277781,0,0,1,1,2
"97630",48815000,1000,0.0027121,0,0,0,0,0
"97631",48815500,1000,0.00267212,0,0,0,0,0
"97632",48816000,1000,0.00260968,0,0,0,1,1
"97633",48816500,1000,0.00248854,0,0,0,1,1
"97634",48817000,1000,0.00243871,0,0,0,0,0
"97635",48817500,1000,0.00266775,0,0,0,0,0
"97636",48818000,1000,0.0028134,0,0,0,0,0
"97637",48818500,1000,0.00268543,0,0,0,0,0
"97638",48819000,1000,0.0026296,0,0,0,1,1
"97639",48819500,1000,0.00261827,0,0,0,1,1
"97640",48820000,1000,0.00264618,0,0,0,0,0
"97641",48820500,1000,0.00278618,0,0,0,4,4
"97642",48821000,1000,0.00301056,0,1,0,5,6
"97643",48821500,1000,0.00291431,0,1,1,1,3
"97644",48822000,1000,0.00259997,0,0,1,0,1
"97645",48822500,1000,0.00277562,0,1,0,1,2
"97646",48823000,1000,0.00290903,0,1,0,3,4
"97647",48823500,1000,0.00272684,0,0,0,2,2
"97648",48824000,1000,0.00280881,0,0,1,1,2
"97649",48824500,1000,0.00272656,0,0,1,1,2
"97650",48825000,1000,0.00279691,0,0,2,2,4
"97651",48825500,1000,0.00295403,0,1,2,3,6
"97652",48826000,1000,0.00269677,0,1,0,1,2
"97653",48826500,1000,0.00275765,0,0,0,4,4
"97654",48827000,1000,0.00287777,0,0,0,6,6
"97655",48827500,1000,0.00270566,0,0,0,3,3
"97656",48828000,1000,0.00257893,0,0,0,1,1
"97657",48828500,1000,0.00264156,0,0,0,2,2
"97658",48829000,1000,0.0027327,0,0,1,2,3
"97659",48829500,1000,0.00258569,0,0,1,0,1
"97660",48830000,1000,0.00264694,0,0,1,0,1
"97661",48830500,1000,0.00268189,0,0,1,1,2
"97662",48831000,1000,0.00253585,0,0,0,1,1
"97663",48831500,1000,0.00266302,0,0,0,2,2
"97664",48832000,1000,0.00286081,0,1,0,4,5
"97665",48832500,1000,0.00276444,0,1,0,2,3
"97666",48833000,1000,0.00261746,0,0,0,2,2
"97667",48833500,1000,0.00257969,0,0,0,3,3
"97668",48834000,1000,0.00253749,0,0,0,1,1
"97669",48834500,1000,0.00259824,0,0,0,0,0
"97670",48835000,1000,0.00257659,0,0,0,0,0
"97671",48835500,1000,0.00254179,0,0,0,0,0
"97672",48836000,1000,0.00260166,0,0,0,1,1
"97673",48836500,1000,0.00270516,0,0,0,3,3
"97674",48837000,1000,0.00279722,0,0,0,4,4
"97675",48837500,1000,0.00271807,0,0,0,2,2
"97676",48838000,1000,0.00257471,0,0,0,0,0
"97677",48838500,1000,0.00253694,0,0,0,1,1
"97678",48839000,1000,0.00255459,0,0,0,2,2
"97679",48839500,1000,0.00269287,0,0,1,2,3
"97680",48840000,1000,0.00279655,0,0,1,3,4
"97681",48840500,1000,0.00267159,0,0,0,3,3
"97682",48841000,1000,0.00250465,0,0,0,1,1
"97683",48841500,1000,0.00266009,0,0,1,0,1
"97684",48842000,1000,0.00277582,0,0,1,1,2
"97685",48842500,1000,0.00278348,0,0,1,2,3
"97686",48843000,1000,0.00292934,0,0,2,2,4
"97687",48843500,1000,0.00283497,0,0,1,2,3
"97688",48844000,1000,0.00257994,0,0,0,1,1
"97689",48844500,1000,0.00270026,0,0,1,2,3
"97690",48845000,1000,0.00278964,0,0,1,2,3
"97691",48845500,1000,0.0026242,0,0,0,0,0
"97692",48846000,1000,0.00260352,0,0,0,1,1
"97693",48846500,1000,0.00256185,0,0,0,1,1
"97694",48847000,1000,0.00247539,0,0,0,0,0
"97695",48847500,1000,0.00254647,0,0,0,1,1
"97696",48848000,1000,0.00269482,0,0,0,2,2
"97697",48848500,1000,0.00268851,0,0,0,1,1
"97698",48849000,1000,0.00270394,0,0,0,2,2
"97699",48849500,1000,0.00287117,0,0,1,4,5
"97700",48850000,1000,0.00283209,0,0,1,4,5
"97701",48850500,1000,0.0026345,0,0,0,2,2
"97702",48851000,1000,0.0025654,0,0,0,0,0
"97703",48851500,1000,0.00288048,0,1,1,1,3
"97704",48852000,1000,0.00285728,0,1,1,1,3
"97705",48852500,1000,0.00262842,0,0,0,1,1
"97706",48853000,1000,0.002665,0,0,0,1,1
"97707",48853500,1000,0.00288324,0,1,1,0,2
"97708",48854000,1000,0.00295929,0,1,2,1,4
"97709",48854500,1000,0.00278379,0,0,1,3,4
"97710",48855000,1000,0.00276355,0,0,0,2,2
"97711",48855500,1000,0.00261515,0,0,0,0,0
"97712",48856000,1000,0.00262985,0,0,1,0,1
"97713",48856500,1000,0.00291692,0,1,1,0,2
"97714",48857000,1000,0.00305379,0,1,1,2,4
"97715",48857500,1000,0.00291093,0,0,2,3,5
"97716",48858000,1000,0.00267107,0,0,1,1,2
"97717",48858500,1000,0.00269933,0,0,0,3,3
"97718",48859000,1000,0.00273694,0,0,0,4,4
"97719",48859500,1000,0.00253685,0,0,0,2,2
"97720",48860000,1000,0.00250272,0,0,0,1,1
"97721",48860500,1000,0.00263614,0,0,0,1,1
"97722",48861000,1000,0.002761,0,0,1,1,2
"97723",48861500,1000,0.00273323,0,0,1,2,3
"97724",48862000,1000,0.00259776,0,0,0,3,3
"97725",48862500,1000,0.00262687,0,0,0,1,1
"97726",48863000,1000,0.00266069,0,0,0,1,1
"97727",48863500,1000,0.00249092,0,0,0,1,1
"97728",48864000,1000,0.00243424,0,0,0,1,1
"97729",48864500,1000,0.00258612,0,0,0,1,1
"97730",48865000,1000,0.00282742,0,0,1,1,2
"97731",48865500,1000,0.00281143,0,0,1,3,4
"97732",48866000,1000,0.00268369,0,0,0,2,2
"97733",48866500,1000,0.0028463,0,0,1,2,3
"97734",48867000,1000,0.00289986,0,0,1,4,5
"97735",48867500,1000,0.0026866,0,0,0,3,3
"97736",48868000,1000,0.0024863,0,0,0,1,1
"97737",48868500,1000,0.00259644,0,0,0,2,2
"97738",48869000,1000,0.00269326,0,0,0,2,2
"97739",48869500,1000,0.00267821,0,0,0,1,1
"97740",48870000,1000,0.00263167,0,0,0,1,1
"97741",48870500,1000,0.00258898,0,0,0,0,0
"97742",48871000,1000,0.00266069,0,0,0,0,0
"97743",48871500,1000,0.00273586,0,0,1,0,1
"97744",48872000,1000,0.00280799,0,0,1,1,2
"97745",48872500,1000,0.00279626,0,0,1,1,2
"97746",48873000,1000,0.00279215,0,0,1,1,2
"97747",48873500,1000,0.00276536,0,0,0,2,2
"97748",48874000,1000,0.00259002,0,0,0,1,1
"97749",48874500,1000,0.002485,0,0,0,0,0
"97750",48875000,1000,0.00256663,0,0,0,0,0
"97751",48875500,1000,0.00272277,0,0,1,0,1
"97752",48876000,1000,0.00273792,0,0,1,1,2
"97753",48876500,1000,0.00268299,0,0,0,1,1
"97754",48877000,1000,0.00276083,0,0,1,0,1
"97755",48877500,1000,0.00288063,0,0,2,2,4
"97756",48878000,1000,0.0028468,0,0,1,2,3
"97757",48878500,1000,0.00268653,0,0,0,2,2
"97758",48879000,1000,0.00293412,0,1,0,4,5
"97759",48879500,1000,0.00308625,0,1,0,4,5
"97760",48880000,1000,0.00303324,0,0,2,4,6
"97761",48880500,1000,0.0028888,0,0,2,2,4
"97762",48881000,1000,0.00282016,0,0,0,2,2
"97763",48881500,1000,0.00297047,0,0,1,4,5
"97764",48882000,1000,0.00276229,0,0,1,2,3
"97765",48882500,1000,0.00256303,0,0,0,0,0
"97766",48883000,1000,0.00261488,0,0,0,0,0
"97767",48883500,1000,0.0027408,0,0,1,0,1
"97768",48884000,1000,0.00271622,0,0,1,0,1
"97769",48884500,1000,0.00273112,0,0,1,1,2
"97770",48885000,1000,0.00268339,0,0,1,1,2
"97771",48885500,1000,0.0025447,0,0,0,0,0
"97772",48886000,1000,0.0026238,0,0,0,2,2
"97773",48886500,1000,0.00264964,0,0,0,3,3
"97774",48887000,1000,0.00263249,0,0,0,1,1
"97775",48887500,1000,0.00270187,0,0,0,3,3
"97776",48888000,1000,0.00275174,0,0,0,5,5
"97777",48888500,1000,0.00272296,0,0,0,4,4
"97778",48889000,1000,0.002687,0,0,0,2,2
"97779",48889500,1000,0.00283994,0,0,1,3,4
"97780",48890000,1000,0.00282324,0,0,1,4,5
"97781",48890500,1000,0.00263599,0,0,1,1,2
"97782",48891000,1000,0.00278061,0,0,2,2,4
"97783",48891500,1000,0.00264747,0,0,1,2,3
"97784",48892000,1000,0.00254198,0,0,1,0,1
"97785",48892500,1000,0.00267104,0,0,1,0,1
"97786",48893000,1000,0.00266528,0,0,0,1,1
"97787",48893500,1000,0.00266372,0,0,0,1,1
"97788",48894000,1000,0.00266511,0,0,0,1,1
"97789",48894500,1000,0.00264895,0,0,0,1,1
"97790",48895000,1000,0.0026387,0,0,0,0,0
"97791",48895500,1000,0.00277835,0,0,0,0,0
"97792",48896000,1000,0.0026965,0,0,0,0,0
"97793",48896500,1000,0.00251882,0,0,0,0,0
"97794",48897000,1000,0.00268669,0,0,1,1,2
"97795",48897500,1000,0.00262542,0,0,1,1,2
"97796",48898000,1000,0.0027156,0,1,0,0,1
"97797",48898500,1000,0.0030034,0,1,1,2,4
"97798",48899000,1000,0.0028202,0,0,1,4,5
"97799",48899500,1000,0.00276624,0,0,0,3,3
"97800",48900000,1000,0.00261317,0,0,0,1,1
"97801",48900500,1000,0.00258085,0,0,1,1,2
"97802",48901000,1000,0.00272267,0,0,1,1,2
"97803",48901500,1000,0.00255119,0,0,0,0,0
"97804",48902000,1000,0.0025598,0,0,0,1,1
"97805",48902500,1000,0.0026326,0,0,0,2,2
"97806",48903000,1000,0.00264413,0,0,0,2,2
"97807",48903500,1000,0.00275122,0,0,0,3,3
"97808",48904000,1000,0.00296277,0,0,2,3,5
"97809",48904500,1000,0.00289486,0,0,2,2,4
"97810",48905000,1000,0.00271355,0,0,0,3,3
"97811",48905500,1000,0.00262432,0,0,0,2,2
"97812",48906000,1000,0.00253848,0,0,0,1,1
"97813",48906500,1000,0.00260349,0,0,0,2,2
"97814",48907000,1000,0.00262736,0,0,0,3,3
"97815",48907500,1000,0.00263205,0,0,0,3,3
"97816",48908000,1000,0.00261961,0,0,0,1,1
"97817",48908500,1000,0.00249481,0,0,0,0,0
"97818",48909000,1000,0.00246078,0,0,0,0,0
"97819",48909500,1000,0.00258567,0,0,0,0,0
"97820",48910000,1000,0.00267096,0,0,0,0,0
"97821",48910500,1000,0.00265735,0,0,0,0,0
"97822",48911000,1000,0.00271309,0,0,1,0,1
"97823",48911500,1000,0.00279998,0,0,1,0,1
"97824",48912000,1000,0.00263299,0,0,0,0,0
"97825",48912500,1000,0.00257868,0,0,0,0,0
"97826",48913000,1000,0.0027205,0,0,0,0,0
"97827",48913500,1000,0.00289032,0,0,1,1,2
"97828",48914000,1000,0.00290874,0,0,1,1,2
"97829",48914500,1000,0.00280882,0,0,1,1,2
"97830",48915000,1000,0.00275414,0,0,1,2,3
"97831",48915500,1000,0.00266076,0,0,0,1,1
"97832",48916000,1000,0.00276424,0,1,0,0,1
"97833",48916500,1000,0.00280432,0,1,0,2,3
"97834",48917000,1000,0.0026986,0,0,0,4,4
"97835",48917500,1000,0.00267517,0,0,0,2,2
"97836",48918000,1000,0.00265156,0,0,0,0,0
"97837",48918500,1000,0.00276597,0,0,0,2,2
"97838",48919000,1000,0.00288873,0,1,0,2,3
"97839",48919500,1000,0.00276299,0,1,0,0,1
"97840",48920000,1000,0.00262157,0,0,0,0,0
"97841",48920500,1000,0.00263886,0,0,0,1,1
"97842",48921000,1000,0.0027089,0,0,0,1,1
"97843",48921500,1000,0.0027079,0,0,0,0,0
"97844",48922000,1000,0.00268161,0,0,0,2,2
"97845",48922500,1000,0.00318483,0,1,2,3,6
"97846",48923000,1000,0.00317917,0,1,2,1,4
"97847",48923500,1000,0.0027381,0,0,0,1,1
"97848",48924000,1000,0.00266054,0,0,0,1,1
"97849",48924500,1000,0.00256005,0,0,0,1,1
"97850",48925000,1000,0.00261861,0,0,0,2,2
"97851",48925500,1000,0.00275209,0,0,0,1,1
"97852",48926000,1000,0.00292487,0,1,0,0,1
"97853",48926500,1000,0.00282783,0,1,0,0,1
"97854",48927000,1000,0.00272852,0,0,0,2,2
"97855",48927500,1000,0.00264955,0,0,0,2,2
"97856",48928000,1000,0.00252648,0,0,0,0,0
"97857",48928500,1000,0.00264178,0,0,0,0,0
"97858",48929000,1000,0.00279921,0,0,0,0,0
"97859",48929500,1000,0.00272971,0,0,0,0,0
"97860",48930000,1000,0.00259765,0,0,1,0,1
"97861",48930500,1000,0.00262359,0,0,1,1,2
"97862",48931000,1000,0.00257949,0,0,0,1,1
"97863",48931500,1000,0.00256685,0,0,0,0,0
"97864",48932000,1000,0.00268749,0,0,0,1,1
"97865",48932500,1000,0.00272698,0,0,0,2,2
"97866",48933000,1000,0.00279239,0,0,0,1,1
"97867",48933500,1000,0.00281136,0,0,0,1,1
"97868",48934000,1000,0.00266463,0,0,0,1,1
"97869",48934500,1000,0.0026607,0,0,0,1,1
"97870",48935000,1000,0.0028118,0,0,1,3,4
"97871",48935500,1000,0.00271932,0,0,1,2,3
"97872",48936000,1000,0.0025988,0,0,0,0,0
"97873",48936500,1000,0.00260877,0,0,0,1,1
"97874",48937000,1000,0.00265539,0,0,0,1,1
"97875",48937500,1000,0.00272232,0,0,0,1,1
"97876",48938000,1000,0.00275309,0,0,1,1,2
"97877",48938500,1000,0.00277834,0,0,1,2,3
"97878",48939000,1000,0.00272424,0,0,0,4,4
"97879",48939500,1000,0.0027172,0,0,0,2,2
"97880",48940000,1000,0.00261237,0,0,0,0,0
"97881",48940500,1000,0.00278969,0,0,1,0,1
"97882",48941000,1000,0.00288874,0,0,1,1,2
"97883",48941500,1000,0.0028278,0,0,1,2,3
"97884",48942000,1000,0.00288468,0,0,1,1,2
"97885",48942500,1000,0.00275419,0,0,0,0,0
"97886",48943000,1000,0.00276845,0,0,1,1,2
"97887",48943500,1000,0.00264825,0,0,1,1,2
"97888",48944000,1000,0.00263693,0,0,1,0,1
"97889",48944500,1000,0.002668,0,0,1,0,1
"97890",48945000,1000,0.00278354,0,0,1,3,4
"97891",48945500,1000,0.00287361,0,0,1,5,6
"97892",48946000,1000,0.00258008,0,0,0,2,2
"97893",48946500,1000,0.00266772,0,0,1,1,2
"97894",48947000,1000,0.00273258,0,0,1,1,2
"97895",48947500,1000,0.00283855,0,0,1,3,4
"97896",48948000,1000,0.00279179,0,0,1,3,4
"97897",48948500,1000,0.00254219,0,0,0,2,2
"97898",48949000,1000,0.00262326,0,0,0,3,3
"97899",48949500,1000,0.00267806,0,0,0,2,2
"97900",48950000,1000,0.00267741,0,0,0,3,3
"97901",48950500,1000,0.00261595,0,0,0,2,2
"97902",48951000,1000,0.00260487,0,0,0,1,1
"97903",48951500,1000,0.00259347,0,0,0,2,2
"97904",48952000,1000,0.00267612,0,0,1,2,3
"97905",48952500,1000,0.0028393,0,0,2,2,4
"97906",48953000,1000,0.00269041,0,0,1,1,2
"97907",48953500,1000,0.00260546,0,0,1,1,2
"97908",48954000,1000,0.0026528,0,0,1,1,2
"97909",48954500,1000,0.00274393,0,0,1,0,1
"97910",48955000,1000,0.00276357,0,0,1,1,2
"97911",48955500,1000,0.00267376,0,0,1,2,3
"97912",48956000,1000,0.00272058,0,0,2,1,3
"97913",48956500,1000,0.00275412,0,0,1,3,4
"97914",48957000,1000,0.00278862,0,0,1,3,4
"97915",48957500,1000,0.00277262,0,0,1,2,3
"97916",48958000,1000,0.00267246,0,0,0,2,2
"97917",48958500,1000,0.00255084,0,0,0,0,0
"97918",48959000,1000,0.00271131,0,0,1,1,2
"97919",48959500,1000,0.00286849,0,0,1,1,2
"97920",48960000,1000,0.00293875,0,0,0,0,0
"97921",48960500,1000,0.00289086,0,0,0,0,0
"97922",48961000,1000,0.00274429,0,0,0,1,1
"97923",48961500,1000,0.0027656,0,0,1,1,2
"97924",48962000,1000,0.00277113,0,0,1,0,1
"97925",48962500,1000,0.00288819,0,0,2,1,3
"97926",48963000,1000,0.00300117,0,0,3,3,6
"97927",48963500,1000,0.00282404,0,0,1,3,4
"97928",48964000,1000,0.00262556,0,0,0,1,1
"97929",48964500,1000,0.00273076,0,0,1,1,2
"97930",48965000,1000,0.00278812,0,0,1,2,3
"97931",48965500,1000,0.00255442,0,0,0,1,1
"97932",48966000,1000,0.00269244,0,0,1,3,4
"97933",48966500,1000,0.00272721,0,0,1,3,4
"97934",48967000,1000,0.00265105,0,0,0,0,0
"97935",48967500,1000,0.00290689,0,0,1,3,4
"97936",48968000,1000,0.00285654,0,0,1,4,5
"97937",48968500,1000,0.0028357,0,0,1,1,2
"97938",48969000,1000,0.00286529,0,0,2,1,3
"97939",48969500,1000,0.00261889,0,0,1,1,2
"97940",48970000,1000,0.00271577,0,0,0,1,1
"97941",48970500,1000,0.00287609,0,0,0,1,1
"97942",48971000,1000,0.00274597,0,0,0,0,0
"97943",48971500,1000,0.00272116,0,0,0,0,0
"97944",48972000,1000,0.00282565,0,0,0,2,2
"97945",48972500,1000,0.00299158,0,0,2,2,4
"97946",48973000,1000,0.00280629,0,0,2,0,2
"97947",48973500,1000,0.00263499,0,0,0,2,2
"97948",48974000,1000,0.00266095,0,0,0,2,2
"97949",48974500,1000,0.00284538,0,0,1,2,3
"97950",48975000,1000,0.00311386,0,0,3,3,6
"97951",48975500,1000,0.00296382,0,0,3,2,5
"97952",48976000,1000,0.00275057,0,0,1,2,3
"97953",48976500,1000,0.00274584,0,0,0,3,3
"97954",48977000,1000,0.00277657,0,0,0,2,2
"97955",48977500,1000,0.00274431,0,0,0,1,1
"97956",48978000,1000,0.00268686,0,0,0,2,2
"97957",48978500,1000,0.00267983,0,0,0,1,1
"97958",48979000,1000,0.00273564,0,0,1,0,1
"97959",48979500,1000,0.00280048,0,0,2,1,3
"97960",48980000,1000,0.00269692,0,0,1,3,4
"97961",48980500,1000,0.00262455,0,0,0,2,2
"97962",48981000,1000,0.00261052,0,0,0,1,1
"97963",48981500,1000,0.00264846,0,0,0,3,3
"97964",48982000,1000,0.0026814,0,0,0,3,3
"97965",48982500,1000,0.00274383,0,0,0,2,2
"97966",48983000,1000,0.00282781,0,0,0,2,2
"97967",48983500,1000,0.0027986,0,0,1,2,3
"97968",48984000,1000,0.0027146,0,0,1,2,3
"97969",48984500,1000,0.0027101,0,0,0,4,4
"97970",48985000,1000,0.00265588,0,0,0,3,3
"97971",48985500,1000,0.00262137,0,0,0,0,0
"97972",48986000,1000,0.00263671,0,0,0,0,0
"97973",48986500,1000,0.00256933,0,0,0,1,1
"97974",48987000,1000,0.00260478,0,0,0,3,3
"97975",48987500,1000,0.00261512,0,0,0,2,2
"97976",48988000,1000,0.00254011,0,0,0,0,0
"97977",48988500,1000,0.00268544,0,0,1,1,2
"97978",48989000,1000,0.00282922,0,0,2,3,5
"97979",48989500,1000,0.00248897,0,0,1,2,3
"97980",48990000,1000,0.00259774,0,1,0,2,3
"97981",48990500,1000,0.00280715,0,1,0,3,4
"97982",48991000,1000,0.00256158,0,0,0,1,1
"97983",48991500,1000,0.00245794,0,0,0,0,0
"97984",48992000,1000,0.00247703,0,0,0,0,0
"97985",48992500,1000,0.00249111,0,0,0,0,0
"97986",48993000,1000,0.00239339,0,0,0,0,0
"97987",48993500,1000,0.00243955,0,0,0,0,0
"97988",48994000,1000,0.0025397,0,0,1,0,1
"97989",48994500,1000,0.00251829,0,0,1,0,1
"97990",48995000,1000,0.00252732,0,0,0,0,0
"97991",48995500,1000,0.00252378,0,0,0,1,1
"97992",48996000,1000,0.00244293,0,0,0,2,2
"97993",48996500,1000,0.00241811,0,0,0,1,1
"97994",48997000,1000,0.00239316,0,0,0,0,0
"97995",48997500,1000,0.0025001,0,0,0,1,1
"97996",48998000,1000,0.00254917,0,0,0,1,1
"97997",48998500,1000,0.0024217,0,0,0,0,0
"97998",48999000,1000,0.00247237,0,0,0,0,0
"97999",48999500,1000,0.00250662,0,0,0,0,0
"98000",49000000,1000,0.00252802,0,0,0,0,0
"98001",49000500,1000,0.00255632,0,0,0,1,1
"98002",49001000,1000,0.00253876,0,0,0,1,1
"98003",49001500,1000,0.00264092,0,0,1,1,2
"98004",49002000,1000,0.00256513,0,0,1,1,2
"98005",49002500,1000,0.00236006,0,0,0,0,0
"98006",49003000,1000,0.00241537,0,0,0,0,0
"98007",49003500,1000,0.00252507,0,0,0,0,0
"98008",49004000,1000,0.0025839,0,0,0,0,0
"98009",49004500,1000,0.00271861,0,0,0,1,1
"98010",49005000,1000,0.00270463,0,0,0,1,1
"98011",49005500,1000,0.00268233,0,0,0,1,1
"98012",49006000,1000,0.00287798,0,0,2,1,3
"98013",49006500,1000,0.00280151,0,0,2,0,2
"98014",49007000,1000,0.00279164,0,0,1,0,1
"98015",49007500,1000,0.00288485,0,0,1,1,2
"98016",49008000,1000,0.00273448,0,0,0,1,1
"98017",49008500,1000,0.00260483,0,0,0,0,0
"98018",49009000,1000,0.00263314,0,0,0,2,2
"98019",49009500,1000,0.00275474,0,0,1,3,4
"98020",49010000,1000,0.00266597,0,0,1,1,2
"98021",49010500,1000,0.00267478,0,0,1,1,2
"98022",49011000,1000,0.00282192,0,0,1,2,3
"98023",49011500,1000,0.0027241,0,0,0,1,1
"98024",49012000,1000,0.00279082,0,0,1,1,2
"98025",49012500,1000,0.00291898,0,0,2,3,5
"98026",49013000,1000,0.0028904,0,1,1,2,4
"98027",49013500,1000,0.00268081,0,1,0,0,1
"98028",49014000,1000,0.00249881,0,0,0,0,0
"98029",49014500,1000,0.00265645,0,0,1,0,1
"98030",49015000,1000,0.00268582,0,0,1,0,1
"98031",49015500,1000,0.00268386,0,0,0,0,0
"98032",49016000,1000,0.00272966,0,0,0,0,0
"98033",49016500,1000,0.00299288,0,1,1,0,2
"98034",49017000,1000,0.00301253,0,1,1,1,3
"98035",49017500,1000,0.00285736,0,0,2,1,3
"98036",49018000,1000,0.00283321,0,0,2,0,2
"98037",49018500,1000,0.00258424,0,0,0,0,0
"98038",49019000,1000,0.0025661,0,0,0,0,0
"98039",49019500,1000,0.00251047,0,0,0,0,0
"98040",49020000,1000,0.00252235,0,0,0,1,1
"98041",49020500,1000,0.00267842,0,0,0,2,2
"98042",49021000,1000,0.00265957,0,0,0,1,1
"98043",49021500,1000,0.00259772,0,0,0,0,0
"98044",49022000,1000,0.00253129,0,0,0,0,0
"98045",49022500,1000,0.00262729,0,0,1,0,1
"98046",49023000,1000,0.00288515,0,1,1,1,3
"98047",49023500,1000,0.002806,0,1,0,1,2
"98048",49024000,1000,0.00267452,0,0,1,1,2
"98049",49024500,1000,0.00278324,0,0,2,3,5
"98050",49025000,1000,0.00271961,0,0,1,3,4
"98051",49025500,1000,0.00257902,0,0,0,1,1
"98052",49026000,1000,0.00274188,0,0,1,2,3
"98053",49026500,1000,0.00280634,0,0,1,4,5
"98054",49027000,1000,0.00262157,0,0,0,2,2
"98055",49027500,1000,0.00274487,0,0,2,1,3
"98056",49028000,1000,0.00277431,0,0,2,1,3
"98057",49028500,1000,0.00257732,0,0,0,0,0
"98058",49029000,1000,0.00273553,0,0,1,1,2
"98059",49029500,1000,0.00269749,0,0,1,1,2
"98060",49030000,1000,0.00267035,0,0,0,2,2
"98061",49030500,1000,0.00278007,0,0,0,4,4
"98062",49031000,1000,0.00257108,0,0,0,2,2
"98063",49031500,1000,0.00261795,0,0,0,1,1
"98064",49032000,1000,0.00265937,0,0,0,1,1
"98065",49032500,1000,0.00251205,0,0,0,0,0
"98066",49033000,1000,0.00259818,0,0,0,0,0
"98067",49033500,1000,0.00270577,0,0,1,1,2
"98068",49034000,1000,0.00264715,0,0,1,2,3
"98069",49034500,1000,0.00264891,0,0,0,1,1
"98070",49035000,1000,0.00260249,0,0,0,0,0
"98071",49035500,1000,0.0024608,0,0,0,0,0
"98072",49036000,1000,0.00243586,0,0,0,0,0
"98073",49036500,1000,0.00249421,0,0,0,0,0
"98074",49037000,1000,0.00257811,0,0,0,0,0
"98075",49037500,1000,0.0026065,0,0,0,0,0
"98076",49038000,1000,0.00268534,0,0,0,1,1
"98077",49038500,1000,0.00268671,0,0,0,1,1
"98078",49039000,1000,0.00270943,0,0,1,1,2
"98079",49039500,1000,0.00284396,0,0,1,2,3
"98080",49040000,1000,0.00290667,0,0,0,4,4
"98081",49040500,1000,0.00281306,0,0,0,4,4
"98082",49041000,1000,0.00266594,0,0,0,1,1
"98083",49041500,1000,0.00267826,0,0,0,0,0
"98084",49042000,1000,0.00271635,0,0,0,0,0
"98085",49042500,1000,0.00271852,0,0,0,1,1
"98086",49043000,1000,0.00269574,0,0,0,1,1
"98087",49043500,1000,0.00256309,0,0,0,0,0
"98088",49044000,1000,0.00251976,0,0,0,0,0
"98089",49044500,1000,0.00261752,0,0,0,0,0
"98090",49045000,1000,0.00266184,0,0,0,1,1
"98091",49045500,1000,0.00271375,0,0,0,1,1
"98092",49046000,1000,0.00303367,0,0,2,1,3
"98093",49046500,1000,0.00299621,0,0,2,2,4
"98094",49047000,1000,0.00263206,0,0,1,2,3
"98095",49047500,1000,0.00254102,0,0,1,1,2
"98096",49048000,1000,0.00269418,0,0,1,2,3
"98097",49048500,1000,0.00280128,0,0,1,2,3
"98098",49049000,1000,0.00296099,0,1,1,1,3
"98099",49049500,1000,0.00290293,0,1,2,1,4
"98100",49050000,1000,0.0025566,0,0,1,0,1
"98101",49050500,1000,0.00253189,0,0,0,0,0
"98102",49051000,1000,0.00250653,0,0,0,0,0
"98103",49051500,1000,0.00247589,0,0,0,0,0
"98104",49052000,1000,0.00251295,0,0,0,0,0
"98105",49052500,1000,0.00254994,0,0,0,0,0
"98106",49053000,1000,0.00254335,0,0,0,0,0
"98107",49053500,1000,0.00260748,0,0,0,0,0
"98108",49054000,1000,0.00258388,0,0,0,0,0
"98109",49054500,1000,0.00263623,0,0,0,1,1
"98110",49055000,1000,0.00259785,0,0,0,1,1
"98111",49055500,1000,0.00252161,0,0,0,0,0
"98112",49056000,1000,0.00271863,0,0,0,1,1
"98113",49056500,1000,0.00275061,0,0,0,3,3
"98114",49057000,1000,0.00266122,0,0,1,3,4
"98115",49057500,1000,0.00262656,0,0,1,2,3
"98116",49058000,1000,0.00268085,0,0,0,1,1
"98117",49058500,1000,0.00292839,0,0,1,3,4
"98118",49059000,1000,0.00294915,0,0,2,4,6
"98119",49059500,1000,0.00278968,0,0,1,3,4
"98120",49060000,1000,0.00264895,0,0,0,2,2
"98121",49060500,1000,0.00279108,0,0,1,3,4
"98122",49061000,1000,0.00287757,0,0,1,3,4
"98123",49061500,1000,0.00262227,0,0,0,0,0
"98124",49062000,1000,0.00267723,0,0,0,2,2
"98125",49062500,1000,0.00283446,0,0,1,3,4
"98126",49063000,1000,0.00269014,0,0,1,1,2
"98127",49063500,1000,0.00255117,0,0,0,0,0
"98128",49064000,1000,0.00265802,0,0,0,0,0
"98129",49064500,1000,0.00267271,0,0,0,0,0
"98130",49065000,1000,0.0026896,0,0,0,2,2
"98131",49065500,1000,0.00265677,0,0,0,2,2
"98132",49066000,1000,0.00270646,0,0,0,2,2
"98133",49066500,1000,0.00273536,0,0,0,2,2
"98134",49067000,1000,0.00262378,0,0,0,0,0
"98135",49067500,1000,0.00266767,0,0,0,2,2
"98136",49068000,1000,0.00266399,0,0,0,3,3
"98137",49068500,1000,0.00259811,0,0,0,2,2
"98138",49069000,1000,0.00270895,0,0,1,2,3
"98139",49069500,1000,0.0028426,0,0,1,2,3
"98140",49070000,1000,0.0027961,0,0,1,2,3
"98141",49070500,1000,0.00273464,0,0,1,2,3
"98142",49071000,1000,0.00277336,0,0,1,2,3
"98143",49071500,1000,0.00264331,0,0,1,1,2
"98144",49072000,1000,0.00267111,0,0,1,1,2
"98145",49072500,1000,0.00289538,0,0,1,3,4
"98146",49073000,1000,0.00276412,0,0,0,2,2
"98147",49073500,1000,0.00263615,0,0,0,1,1
"98148",49074000,1000,0.00274777,0,0,1,2,3
"98149",49074500,1000,0.00281197,0,0,2,1,3
"98150",49075000,1000,0.00257649,0,0,1,0,1
"98151",49075500,1000,0.00261197,0,0,1,1,2
"98152",49076000,1000,0.00267773,0,0,1,1,2
"98153",49076500,1000,0.00277012,0,1,1,0,2
"98154",49077000,1000,0.0028979,0,1,1,1,3
"98155",49077500,1000,0.00269649,0,0,0,1,1
"98156",49078000,1000,0.00264853,0,0,0,0,0
"98157",49078500,1000,0.00278086,0,0,1,1,2
"98158",49079000,1000,0.00271268,0,0,1,1,2
"98159",49079500,1000,0.00258054,0,0,0,1,1
"98160",49080000,1000,0.00257712,0,0,0,1,1
"98161",49080500,1000,0.00258584,0,0,0,2,2
"98162",49081000,1000,0.00265782,0,0,0,4,4
"98163",49081500,1000,0.00265198,0,0,0,2,2
"98164",49082000,1000,0.00262645,0,0,0,1,1
"98165",49082500,1000,0.00264942,0,0,0,1,1
"98166",49083000,1000,0.00271589,0,0,1,0,1
"98167",49083500,1000,0.00274472,0,0,1,2,3
"98168",49084000,1000,0.00261578,0,0,0,2,2
"98169",49084500,1000,0.00262473,0,0,1,1,2
"98170",49085000,1000,0.0026561,0,0,1,1,2
"98171",49085500,1000,0.00263699,0,0,0,1,1
"98172",49086000,1000,0.00292083,0,0,2,2,4
"98173",49086500,1000,0.00288997,0,0,2,2,4
"98174",49087000,1000,0.00260084,0,0,0,1,1
"98175",49087500,1000,0.00251433,0,0,0,0,0
"98176",49088000,1000,0.00262743,0,0,0,0,0
"98177",49088500,1000,0.00283671,0,0,0,2,2
"98178",49089000,1000,0.00277463,0,0,0,3,3
"98179",49089500,1000,0.00256769,0,0,0,1,1
"98180",49090000,1000,0.00246904,0,0,0,1,1
"98181",49090500,1000,0.00255684,0,0,0,1,1
"98182",49091000,1000,0.00263927,0,0,0,0,0
"98183",49091500,1000,0.00260654,0,0,0,0,0
"98184",49092000,1000,0.0026577,0,0,0,0,0
"98185",49092500,1000,0.00294292,0,1,0,0,1
"98186",49093000,1000,0.00289598,0,1,0,0,1
"98187",49093500,1000,0.00263077,0,0,0,2,2
"98188",49094000,1000,0.00273195,0,0,2,2,4
"98189",49094500,1000,0.00262023,0,0,2,0,2
"98190",49095000,1000,0.00257069,0,0,0,0,0
"98191",49095500,1000,0.00265806,0,0,0,1,1
"98192",49096000,1000,0.0025168,0,0,0,1,1
"98193",49096500,1000,0.00263022,0,0,1,1,2
"98194",49097000,1000,0.00280523,0,0,1,3,4
"98195",49097500,1000,0.00276242,0,0,0,3,3
"98196",49098000,1000,0.00264689,0,0,0,2,2
"98197",49098500,1000,0.00259515,0,0,1,1,2
"98198",49099000,1000,0.00262511,0,0,1,1,2
"98199",49099500,1000,0.00260432,0,0,0,1,1
"98200",49100000,1000,0.00265909,0,0,1,1,2
"98201",49100500,1000,0.00272498,0,0,1,2,3
"98202",49101000,1000,0.00264972,0,0,0,1,1
"98203",49101500,1000,0.0028147,0,0,1,0,1
"98204",49102000,1000,0.00284298,0,0,1,0,1
"98205",49102500,1000,0.00247491,0,0,0,0,0
"98206",49103000,1000,0.0023089,0,0,0,0,0
"98207",49103500,1000,0.00242782,0,0,0,0,0
"98208",49104000,1000,0.00253701,0,0,0,0,0
"98209",49104500,1000,0.00278181,0,1,0,1,2
"98210",49105000,1000,0.00297724,0,1,0,1,2
"98211",49105500,1000,0.00289213,0,0,0,1,1
"98212",49106000,1000,0.00274256,0,0,0,2,2
"98213",49106500,1000,0.00270807,0,0,0,1,1
"98214",49107000,1000,0.00265066,0,0,0,0,0
"98215",49107500,1000,0.00252885,0,0,0,0,0
"98216",49108000,1000,0.00267017,0,0,0,0,0
"98217",49108500,1000,0.00274873,0,0,0,2,2
"98218",49109000,1000,0.00260317,0,0,0,2,2
"98219",49109500,1000,0.00251475,0,0,0,0,0
"98220",49110000,1000,0.00290746,0,1,1,1,3
"98221",49110500,1000,0.00295712,0,1,1,1,3
"98222",49111000,1000,0.00257874,0,0,0,0,0
"98223",49111500,1000,0.00261063,0,0,0,1,1
"98224",49112000,1000,0.00267472,0,0,0,2,2
"98225",49112500,1000,0.00258897,0,0,0,1,1
"98226",49113000,1000,0.00250297,0,0,0,0,0
"98227",49113500,1000,0.00257049,0,0,0,2,2
"98228",49114000,1000,0.00259728,0,0,0,2,2
"98229",49114500,1000,0.0025358,0,0,0,1,1
"98230",49115000,1000,0.00254235,0,0,0,1,1
"98231",49115500,1000,0.0026003,0,0,0,0,0
"98232",49116000,1000,0.00260319,0,0,0,1,1
"98233",49116500,1000,0.00250338,0,0,0,1,1
"98234",49117000,1000,0.0026772,0,0,0,1,1
"98235",49117500,1000,0.0027819,0,0,0,1,1
"98236",49118000,1000,0.00261168,0,0,0,0,0
"98237",49118500,1000,0.00251102,0,0,0,0,0
"98238",49119000,1000,0.00254443,0,0,1,0,1
"98239",49119500,1000,0.00272307,0,0,1,0,1
"98240",49120000,1000,0.00285196,0,0,1,1,2
"98241",49120500,1000,0.00269288,0,0,1,1,2
"98242",49121000,1000,0.00257645,0,0,0,0,0
"98243",49121500,1000,0.00273835,0,0,0,1,1
"98244",49122000,1000,0.00296236,0,1,0,2,3
"98245",49122500,1000,0.00281727,0,1,0,1,2
"98246",49123000,1000,0.00249672,0,0,0,0,0
"98247",49123500,1000,0.00238828,0,0,0,0,0
"98248",49124000,1000,0.0025082,0,0,0,1,1
"98249",49124500,1000,0.00250255,0,0,0,1,1
"98250",49125000,1000,0.00258517,0,0,1,0,1
"98251",49125500,1000,0.00269707,0,0,1,0,1
"98252",49126000,1000,0.00260089,0,0,0,0,0
"98253",49126500,1000,0.00281646,0,1,0,0,1
"98254",49127000,1000,0.00269562,0,1,0,0,1
"98255",49127500,1000,0.00252477,0,0,0,1,1
"98256",49128000,1000,0.00260863,0,0,0,1,1
"98257",49128500,1000,0.00265578,0,0,0,0,0
"98258",49129000,1000,0.00270732,0,0,0,0,0
"98259",49129500,1000,0.00266898,0,0,0,0,0
"98260",49130000,1000,0.0027958,0,0,0,2,2
"98261",49130500,1000,0.00283666,0,0,0,2,2
"98262",49131000,1000,0.00262393,0,0,0,0,0
"98263",49131500,1000,0.00261282,0,0,0,1,1
"98264",49132000,1000,0.00266487,0,0,0,1,1
"98265",49132500,1000,0.00256634,0,0,0,1,1
"98266",49133000,1000,0.00246646,0,0,0,1,1
"98267",49133500,1000,0.00254552,0,0,0,2,2
"98268",49134000,1000,0.00260189,0,0,0,2,2
"98269",49134500,1000,0.00259626,0,0,0,1,1
"98270",49135000,1000,0.00258278,0,0,0,2,2
"98271",49135500,1000,0.00255682,0,0,0,2,2
"98272",49136000,1000,0.00249354,0,0,0,1,1
"98273",49136500,1000,0.00259218,0,1,0,0,1
"98274",49137000,1000,0.00261855,0,1,0,0,1
"98275",49137500,1000,0.0025312,0,0,0,0,0
"98276",49138000,1000,0.00253395,0,0,0,0,0
"98277",49138500,1000,0.00258839,0,0,0,1,1
"98278",49139000,1000,0.0026029,0,0,0,2,2
"98279",49139500,1000,0.00252618,0,0,0,1,1
"98280",49140000,1000,0.00268978,0,0,1,1,2
"98281",49140500,1000,0.00267974,0,0,1,2,3
"98282",49141000,1000,0.00256371,0,0,0,1,1
"98283",49141500,1000,0.00261283,0,0,0,0,0
"98284",49142000,1000,0.00276178,0,0,0,2,2
"98285",49142500,1000,0.00266035,0,0,0,2,2
"98286",49143000,1000,0.00266816,0,0,1,1,2
"98287",49143500,1000,0.00284961,0,0,2,1,3
"98288",49144000,1000,0.00281017,0,0,1,2,3
"98289",49144500,1000,0.00283878,0,0,0,4,4
"98290",49145000,1000,0.00272184,0,0,0,2,2
"98291",49145500,1000,0.0026596,0,0,0,0,0
"98292",49146000,1000,0.00274721,0,0,0,0,0
"98293",49146500,1000,0.00272773,0,0,0,0,0
"98294",49147000,1000,0.00265372,0,0,0,1,1
"98295",49147500,1000,0.00257173,0,0,0,2,2
"98296",49148000,1000,0.00265666,0,0,0,1,1
"98297",49148500,1000,0.00285472,0,0,1,1,2
"98298",49149000,1000,0.00269729,0,0,1,1,2
"98299",49149500,1000,0.00247159,0,0,0,0,0
"98300",49150000,1000,0.0024979,0,0,0,0,0
"98301",49150500,1000,0.00254626,0,0,0,0,0
"98302",49151000,1000,0.00261641,0,0,1,1,2
"98303",49151500,1000,0.0026798,0,0,1,1,2
"98304",49152000,1000,0.00278489,0,0,0,2,2
"98305",49152500,1000,0.00279197,0,0,0,2,2
"98306",49153000,1000,0.00271666,0,0,0,2,2
"98307",49153500,1000,0.00279908,0,1,0,3,4
"98308",49154000,1000,0.00290096,0,1,1,2,4
"98309",49154500,1000,0.00287976,0,0,1,2,3
"98310",49155000,1000,0.00283022,0,0,0,3,3
"98311",49155500,1000,0.00274584,0,0,1,2,3
"98312",49156000,1000,0.0027089,0,0,1,1,2
"98313",49156500,1000,0.00279742,0,0,0,2,2
"98314",49157000,1000,0.00280218,0,0,0,1,1
"98315",49157500,1000,0.00283015,0,0,1,1,2
"98316",49158000,1000,0.00281729,0,0,1,2,3
"98317",49158500,1000,0.00278882,0,0,1,1,2
"98318",49159000,1000,0.00288364,0,0,2,1,3
"98319",49159500,1000,0.002911,0,0,1,3,4
"98320",49160000,1000,0.00281417,0,0,0,3,3
"98321",49160500,1000,0.00267229,0,0,0,2,2
"98322",49161000,1000,0.00272409,0,0,0,2,2
"98323",49161500,1000,0.00267672,0,0,0,1,1
"98324",49162000,1000,0.00251019,0,0,0,0,0
"98325",49162500,1000,0.00263455,0,0,0,1,1
"98326",49163000,1000,0.00280474,0,0,0,1,1
"98327",49163500,1000,0.0027708,0,0,0,2,2
"98328",49164000,1000,0.0027012,0,0,0,2,2
"98329",49164500,1000,0.00261842,0,0,0,0,0
"98330",49165000,1000,0.00271943,0,0,0,3,3
"98331",49165500,1000,0.00276587,0,0,0,4,4
"98332",49166000,1000,0.00275382,0,0,0,2,2
"98333",49166500,1000,0.00281408,0,0,0,2,2
"98334",49167000,1000,0.00268084,0,0,0,1,1
"98335",49167500,1000,0.00270044,0,0,1,1,2
"98336",49168000,1000,0.00287259,0,0,1,3,4
"98337",49168500,1000,0.00277446,0,0,0,2,2
"98338",49169000,1000,0.00265912,0,0,0,0,0
"98339",49169500,1000,0.00273099,0,0,0,1,1
"98340",49170000,1000,0.00271074,0,0,0,1,1
"98341",49170500,1000,0.00263485,0,0,0,0,0
"98342",49171000,1000,0.00268047,0,0,0,1,1
"98343",49171500,1000,0.00274546,0,0,0,1,1
"98344",49172000,1000,0.00282358,0,0,0,1,1
"98345",49172500,1000,0.00281619,0,0,0,1,1
"98346",49173000,1000,0.00271879,0,0,0,1,1
"98347",49173500,1000,0.00279855,0,0,0,3,3
"98348",49174000,1000,0.00270802,0,0,0,2,2
"98349",49174500,1000,0.00258568,0,0,0,0,0
"98350",49175000,1000,0.00260625,0,0,0,1,1
"98351",49175500,1000,0.00268004,0,0,0,1,1
"98352",49176000,1000,0.00268919,0,0,0,0,0
"98353",49176500,1000,0.00263338,0,0,0,0,0
"98354",49177000,1000,0.00262645,0,0,0,0,0
"98355",49177500,1000,0.00256051,0,0,0,1,1
"98356",49178000,1000,0.0025293,0,0,0,2,2
"98357",49178500,1000,0.00259534,0,0,0,1,1
"98358",49179000,1000,0.00271079,0,0,1,0,1
"98359",49179500,1000,0.00267049,0,0,1,0,1
"98360",49180000,1000,0.00259766,0,0,1,0,1
"98361",49180500,1000,0.00273321,0,0,1,1,2
"98362",49181000,1000,0.00286911,0,1,0,1,2
"98363",49181500,1000,0.00282362,0,1,0,1,2
"98364",49182000,1000,0.00268993,0,0,0,1,1
"98365",49182500,1000,0.00267469,0,0,0,2,2
"98366",49183000,1000,0.00276047,0,0,0,2,2
"98367",49183500,1000,0.0026896,0,0,0,0,0
"98368",49184000,1000,0.00260889,0,0,0,0,0
"98369",49184500,1000,0.00267879,0,0,0,2,2
"98370",49185000,1000,0.00267966,0,0,0,2,2
"98371",49185500,1000,0.00262072,0,0,0,0,0
"98372",49186000,1000,0.00260922,0,0,0,0,0
"98373",49186500,1000,0.00260884,0,0,0,1,1
"98374",49187000,1000,0.00259461,0,0,0,1,1
"98375",49187500,1000,0.00258716,0,0,0,1,1
"98376",49188000,1000,0.00256355,0,0,0,1,1
"98377",49188500,1000,0.0026687,0,0,1,1,2
"98378",49189000,1000,0.0027432,0,0,1,1,2
"98379",49189500,1000,0.00268765,0,0,0,0,0
"98380",49190000,1000,0.00271311,0,0,0,2,2
"98381",49190500,1000,0.00269637,0,0,0,3,3
"98382",49191000,1000,0.00255813,0,0,0,1,1
"98383",49191500,1000,0.00249935,0,0,1,0,1
"98384",49192000,1000,0.00251049,0,0,1,0,1
"98385",49192500,1000,0.00255497,0,0,1,0,1
"98386",49193000,1000,0.00267305,0,0,1,1,2
"98387",49193500,1000,0.00269071,0,0,0,1,1
"98388",49194000,1000,0.00265485,0,0,0,0,0
"98389",49194500,1000,0.00281469,0,1,0,1,2
"98390",49195000,1000,0.00293442,0,1,1,3,5
"98391",49195500,1000,0.00272049,0,0,1,3,4
"98392",49196000,1000,0.00259717,0,0,0,2,2
"98393",49196500,1000,0.00264533,0,0,0,1,1
"98394",49197000,1000,0.00271342,0,0,0,2,2
"98395",49197500,1000,0.00266764,0,0,0,2,2
"98396",49198000,1000,0.00256664,0,0,0,0,0
"98397",49198500,1000,0.0027508,0,0,0,4,4
"98398",49199000,1000,0.00287436,0,0,0,4,4
"98399",49199500,1000,0.002713,0,0,0,1,1
"98400",49200000,1000,0.00260705,0,0,0,1,1
"98401",49200500,1000,0.00256648,0,0,0,0,0
"98402",49201000,1000,0.00271455,0,0,0,1,1
"98403",49201500,1000,0.002967,0,1,0,1,2
"98404",49202000,1000,0.00305916,0,1,1,1,3
"98405",49202500,1000,0.00300056,0,0,1,2,3
"98406",49203000,1000,0.00271582,0,0,0,1,1
"98407",49203500,1000,0.00251154,0,0,0,0,0
"98408",49204000,1000,0.00257342,0,0,0,0,0
"98409",49204500,1000,0.00265562,0,0,0,0,0
"98410",49205000,1000,0.00268963,0,0,0,0,0
"98411",49205500,1000,0.00270241,0,0,0,0,0
"98412",49206000,1000,0.00265375,0,0,0,0,0
"98413",49206500,1000,0.00266571,0,0,0,0,0
"98414",49207000,1000,0.00296079,0,0,1,1,2
"98415",49207500,1000,0.00297232,0,0,1,2,3
"98416",49208000,1000,0.00266609,0,0,0,1,1
"98417",49208500,1000,0.00264386,0,0,0,0,0
"98418",49209000,1000,0.0027244,0,0,0,1,1
"98419",49209500,1000,0.00275054,0,0,0,2,2
"98420",49210000,1000,0.0026749,0,0,0,1,1
"98421",49210500,1000,0.0025706,0,0,0,0,0
"98422",49211000,1000,0.00260965,0,0,0,0,0
"98423",49211500,1000,0.00269504,0,0,0,1,1
"98424",49212000,1000,0.00267314,0,0,0,2,2
"98425",49212500,1000,0.00263345,0,0,0,1,1
"98426",49213000,1000,0.0026443,0,0,0,1,1
"98427",49213500,1000,0.00281579,0,1,0,1,2
"98428",49214000,1000,0.00289135,0,1,0,2,3
"98429",49214500,1000,0.00270798,0,0,0,2,2
"98430",49215000,1000,0.00265285,0,0,0,0,0
"98431",49215500,1000,0.00261731,0,0,0,0,0
"98432",49216000,1000,0.00255524,0,0,0,0,0
"98433",49216500,1000,0.00259163,0,0,0,0,0
"98434",49217000,1000,0.00277218,0,1,0,0,1
"98435",49217500,1000,0.00279489,0,1,0,0,1
"98436",49218000,1000,0.00285261,0,1,0,0,1
"98437",49218500,1000,0.00291386,0,1,0,1,2
"98438",49219000,1000,0.00278432,0,0,0,1,1
"98439",49219500,1000,0.00269035,0,0,0,0,0
"98440",49220000,1000,0.00262149,0,0,0,0,0
"98441",49220500,1000,0.00267083,0,0,0,2,2
"98442",49221000,1000,0.00273886,0,0,1,3,4
"98443",49221500,1000,0.00276892,0,0,1,2,3
"98444",49222000,1000,0.00271988,0,0,0,1,1
"98445",49222500,1000,0.0028057,0,0,0,1,1
"98446",49223000,1000,0.00298259,0,0,1,2,3
"98447",49223500,1000,0.00278862,0,0,1,2,3
"98448",49224000,1000,0.00262123,0,0,0,1,1
"98449",49224500,1000,0.00275623,0,0,0,2,2
"98450",49225000,1000,0.00271173,0,0,0,2,2
"98451",49225500,1000,0.00270052,0,0,0,2,2
"98452",49226000,1000,0.00269006,0,0,0,2,2
"98453",49226500,1000,0.00267379,0,0,0,1,1
"98454",49227000,1000,0.00278099,0,0,0,1,1
"98455",49227500,1000,0.00278892,0,0,0,1,1
"98456",49228000,1000,0.00276097,0,0,1,3,4
"98457",49228500,1000,0.00269977,0,0,2,2,4
"98458",49229000,1000,0.00263802,0,0,1,0,1
"98459",49229500,1000,0.00275874,0,0,1,0,1
"98460",49230000,1000,0.00269106,0,0,1,0,1
"98461",49230500,1000,0.0025282,0,0,0,0,0
"98462",49231000,1000,0.00261384,0,0,0,0,0
"98463",49231500,1000,0.00261703,0,0,0,0,0
"98464",49232000,1000,0.00269089,0,0,0,2,2
"98465",49232500,1000,0.00277081,0,0,0,4,4
"98466",49233000,1000,0.00270716,0,0,0,2,2
"98467",49233500,1000,0.00277157,0,0,0,3,3
"98468",49234000,1000,0.00266811,0,0,0,3,3
"98469",49234500,1000,0.00252368,0,0,0,0,0
"98470",49235000,1000,0.00257764,0,0,0,2,2
"98471",49235500,1000,0.00268489,0,0,0,3,3
"98472",49236000,1000,0.00294342,0,0,2,1,3
"98473",49236500,1000,0.00286973,0,0,2,0,2
"98474",49237000,1000,0.00269464,0,0,0,1,1
"98475",49237500,1000,0.00272468,0,0,0,2,2
"98476",49238000,1000,0.00262082,0,0,0,1,1
"98477",49238500,1000,0.00260696,0,0,0,2,2
"98478",49239000,1000,0.00275963,0,0,0,2,2
"98479",49239500,1000,0.00285807,0,0,0,1,1
"98480",49240000,1000,0.00272249,0,0,0,1,1
"98481",49240500,1000,0.00271104,0,0,1,2,3
"98482",49241000,1000,0.00265821,0,0,1,3,4
"98483",49241500,1000,0.00267637,0,0,0,3,3
"98484",49242000,1000,0.00278302,0,0,0,2,2
"98485",49242500,1000,0.00266999,0,0,0,0,0
"98486",49243000,1000,0.00262159,0,0,0,1,1
"98487",49243500,1000,0.00268764,0,0,0,2,2
"98488",49244000,1000,0.00277942,0,0,0,3,3
"98489",49244500,1000,0.00267374,0,0,0,2,2
"98490",49245000,1000,0.00286502,0,0,2,0,2
"98491",49245500,1000,0.00296632,0,0,2,2,4
"98492",49246000,1000,0.00268729,0,0,0,3,3
"98493",49246500,1000,0.0026594,0,0,0,2,2
"98494",49247000,1000,0.00282954,0,0,0,4,4
"98495",49247500,1000,0.00278617,0,0,0,3,3
"98496",49248000,1000,0.0026732,0,0,0,0,0
"98497",49248500,1000,0.00278614,0,0,0,3,3
"98498",49249000,1000,0.00271114,0,0,0,3,3
"98499",49249500,1000,0.0025956,0,0,1,0,1
"98500",49250000,1000,0.00278842,0,0,2,1,3
"98501",49250500,1000,0.0029313,0,0,2,2,4
"98502",49251000,1000,0.00270146,0,0,1,1,2
"98503",49251500,1000,0.00258478,0,0,0,3,3
"98504",49252000,1000,0.00295322,0,0,0,7,7
"98505",49252500,1000,0.00300506,0,0,0,4,4
"98506",49253000,1000,0.00287904,0,0,1,1,2
"98507",49253500,1000,0.00278472,0,0,1,1,2
"98508",49254000,1000,0.00260513,0,0,0,0,0
"98509",49254500,1000,0.00268909,0,0,0,2,2
"98510",49255000,1000,0.00283059,0,0,0,2,2
"98511",49255500,1000,0.00289218,0,0,1,0,1
"98512",49256000,1000,0.00275012,0,0,1,2,3
"98513",49256500,1000,0.00261088,0,0,0,3,3
"98514",49257000,1000,0.00258641,0,0,0,1,1
"98515",49257500,1000,0.00263784,0,0,0,0,0
"98516",49258000,1000,0.00276963,0,0,0,2,2
"98517",49258500,1000,0.00287378,0,0,1,3,4
"98518",49259000,1000,0.00282435,0,0,1,3,4
"98519",49259500,1000,0.0026293,0,0,0,2,2
"98520",49260000,1000,0.00242102,0,0,0,0,0
"98521",49260500,1000,0.0024442,0,0,0,0,0
"98522",49261000,1000,0.00255947,0,0,0,0,0
"98523",49261500,1000,0.00261705,0,0,0,1,1
"98524",49262000,1000,0.00282522,0,0,1,3,4
"98525",49262500,1000,0.00280147,0,0,1,2,3
"98526",49263000,1000,0.00259469,0,0,0,0,0
"98527",49263500,1000,0.0026162,0,0,0,0,0
"98528",49264000,1000,0.0027575,0,0,0,1,1
"98529",49264500,1000,0.00271157,0,0,0,1,1
"98530",49265000,1000,0.00246515,0,0,0,0,0
"98531",49265500,1000,0.00252592,0,0,0,2,2
"98532",49266000,1000,0.00284555,0,1,0,2,3
"98533",49266500,1000,0.00291357,0,1,1,0,2
"98534",49267000,1000,0.00274085,0,0,1,0,1
"98535",49267500,1000,0.00275548,0,0,1,0,1
"98536",49268000,1000,0.00273364,0,0,1,0,1
"98537",49268500,1000,0.00259171,0,0,0,0,0
"98538",49269000,1000,0.00278147,0,1,0,0,1
"98539",49269500,1000,0.00286272,0,1,0,2,3
"98540",49270000,1000,0.00274819,0,0,0,5,5
"98541",49270500,1000,0.00267281,0,0,1,3,4
"98542",49271000,1000,0.00278364,0,0,2,2,4
"98543",49271500,1000,0.00270331,0,0,1,2,3
"98544",49272000,1000,0.00257485,0,0,0,1,1
"98545",49272500,1000,0.00276679,0,0,0,3,3
"98546",49273000,1000,0.00283021,0,0,1,3,4
"98547",49273500,1000,0.00280331,0,0,2,1,3
"98548",49274000,1000,0.00267375,0,0,1,0,1
"98549",49274500,1000,0.0027452,0,0,0,1,1
"98550",49275000,1000,0.0029835,0,0,1,2,3
"98551",49275500,1000,0.0029198,0,0,1,2,3
"98552",49276000,1000,0.00297839,0,1,0,2,3
"98553",49276500,1000,0.00305909,0,1,1,2,4
"98554",49277000,1000,0.00272175,0,0,1,1,2
"98555",49277500,1000,0.00268516,0,0,1,0,1
"98556",49278000,1000,0.00299734,0,1,1,1,3
"98557",49278500,1000,0.00287141,0,1,0,1,2
"98558",49279000,1000,0.00282586,0,0,1,0,1
"98559",49279500,1000,0.00290089,0,0,1,2,3
"98560",49280000,1000,0.0026867,0,0,0,3,3
"98561",49280500,1000,0.00260659,0,0,0,2,2
"98562",49281000,1000,0.00273193,0,0,1,2,3
"98563",49281500,1000,0.00270018,0,0,1,1,2
"98564",49282000,1000,0.00268226,0,0,0,2,2
"98565",49282500,1000,0.00273458,0,0,0,2,2
"98566",49283000,1000,0.00262522,0,0,0,0,0
"98567",49283500,1000,0.00271066,0,0,0,2,2
"98568",49284000,1000,0.00279843,0,0,0,4,4
"98569",49284500,1000,0.00273631,0,0,0,2,2
"98570",49285000,1000,0.00274169,0,0,0,1,1
"98571",49285500,1000,0.00276149,0,0,0,1,1
"98572",49286000,1000,0.00268211,0,0,0,0,0
"98573",49286500,1000,0.00264085,0,0,0,2,2
"98574",49287000,1000,0.00257347,0,0,0,2,2
"98575",49287500,1000,0.00265434,0,0,0,1,1
"98576",49288000,1000,0.00267154,0,0,0,1,1
"98577",49288500,1000,0.00251564,0,0,0,0,0
"98578",49289000,1000,0.00258386,0,0,0,0,0
"98579",49289500,1000,0.00282836,0,0,2,0,2
"98580",49290000,1000,0.0029882,0,0,3,0,3
"98581",49290500,1000,0.00282617,0,0,1,0,1
"98582",49291000,1000,0.00265915,0,0,0,0,0
"98583",49291500,1000,0.00260187,0,0,0,1,1
"98584",49292000,1000,0.00256916,0,0,0,1,1
"98585",49292500,1000,0.0025385,0,0,0,1,1
"98586",49293000,1000,0.00252965,0,0,0,1,1
"98587",49293500,1000,0.00253325,0,0,0,0,0
"98588",49294000,1000,0.00246861,0,0,0,0,0
"98589",49294500,1000,0.00241237,0,0,0,0,0
"98590",49295000,1000,0.00244124,0,0,0,0,0
"98591",49295500,1000,0.00259128,0,0,0,2,2
"98592",49296000,1000,0.00254425,0,0,0,2,2
"98593",49296500,1000,0.00246996,0,0,0,0,0
"98594",49297000,1000,0.00260574,0,0,0,0,0
"98595",49297500,1000,0.00258776,0,0,0,0,0
"98596",49298000,1000,0.00267386,0,0,0,0,0
"98597",49298500,1000,0.00280819,0,0,0,1,1
"98598",49299000,1000,0.00272274,0,0,0,2,2
"98599",49299500,1000,0.00274002,0,0,1,2,3
"98600",49300000,1000,0.00268816,0,0,1,1,2
"98601",49300500,1000,0.00263524,0,0,0,0,0
"98602",49301000,1000,0.00261871,0,0,0,0,0
"98603",49301500,1000,0.00266843,0,0,0,2,2
"98604",49302000,1000,0.00279416,0,0,0,3,3
"98605",49302500,1000,0.00281103,0,0,1,2,3
"98606",49303000,1000,0.0027264,0,0,1,3,4
"98607",49303500,1000,0.00260519,0,0,0,2,2
"98608",49304000,1000,0.00274072,0,0,0,2,2
"98609",49304500,1000,0.0026318,0,0,0,2,2
"98610",49305000,1000,0.0023776,0,0,0,0,0
"98611",49305500,1000,0.0025784,0,0,0,0,0
"98612",49306000,1000,0.00261004,0,0,0,0,0
"98613",49306500,1000,0.00266635,0,0,1,2,3
"98614",49307000,1000,0.00279055,0,0,1,2,3
"98615",49307500,1000,0.0027444,0,0,1,2,3
"98616",49308000,1000,0.0027285,0,0,1,2,3
"98617",49308500,1000,0.00263492,0,0,0,2,2
"98618",49309000,1000,0.00273338,0,0,0,4,4
"98619",49309500,1000,0.00268397,0,0,0,2,2
"98620",49310000,1000,0.00260472,0,0,1,1,2
"98621",49310500,1000,0.00265459,0,0,1,3,4
"98622",49311000,1000,0.00269409,0,0,0,2,2
"98623",49311500,1000,0.00270827,0,0,0,0,0
"98624",49312000,1000,0.00264687,0,0,0,0,0
"98625",49312500,1000,0.00261108,0,0,0,0,0
"98626",49313000,1000,0.00254243,0,0,0,0,0
"98627",49313500,1000,0.00262329,0,0,1,1,2
"98628",49314000,1000,0.00267649,0,0,1,3,4
"98629",49314500,1000,0.00258229,0,0,0,2,2
"98630",49315000,1000,0.00264933,0,0,1,1,2
"98631",49315500,1000,0.00261829,0,0,1,1,2
"98632",49316000,1000,0.00253716,0,0,0,1,1
"98633",49316500,1000,0.00276291,0,1,0,1,2
"98634",49317000,1000,0.00293339,0,1,0,1,2
"98635",49317500,1000,0.00290422,0,0,1,1,2
"98636",49318000,1000,0.00276401,0,0,1,1,2
"98637",49318500,1000,0.00252125,0,0,0,1,1
"98638",49319000,1000,0.00251809,0,0,1,1,2
"98639",49319500,1000,0.00254763,0,0,1,1,2
"98640",49320000,1000,0.0024769,0,0,0,0,0
"98641",49320500,1000,0.00247374,0,0,0,0,0
"98642",49321000,1000,0.00263297,0,0,0,1,1
"98643",49321500,1000,0.00273005,0,0,0,1,1
"98644",49322000,1000,0.00257454,0,0,0,0,0
"98645",49322500,1000,0.00256804,0,0,0,2,2
"98646",49323000,1000,0.0027935,0,0,1,2,3
"98647",49323500,1000,0.00277516,0,0,1,0,1
"98648",49324000,1000,0.0026075,0,0,0,0,0
"98649",49324500,1000,0.00283864,0,0,2,2,4
"98650",49325000,1000,0.00281434,0,0,2,2,4
"98651",49325500,1000,0.00256846,0,0,0,0,0
"98652",49326000,1000,0.0025285,0,0,0,0,0
"98653",49326500,1000,0.00266901,0,0,0,2,2
"98654",49327000,1000,0.00283572,0,0,1,3,4
"98655",49327500,1000,0.00269967,0,0,1,2,3
"98656",49328000,1000,0.00263179,0,0,0,1,1
"98657",49328500,1000,0.00269177,0,0,0,1,1
"98658",49329000,1000,0.00259218,0,0,0,1,1
"98659",49329500,1000,0.00254363,0,0,0,0,0
"98660",49330000,1000,0.00268558,0,1,0,0,1
"98661",49330500,1000,0.00273709,0,1,0,1,2
"98662",49331000,1000,0.00275676,0,0,1,2,3
"98663",49331500,1000,0.00259835,0,0,1,1,2
"98664",49332000,1000,0.002536,0,0,0,1,1
"98665",49332500,1000,0.00259696,0,0,0,2,2
"98666",49333000,1000,0.00268021,0,0,1,2,3
"98667",49333500,1000,0.0026593,0,0,1,1,2
"98668",49334000,1000,0.00248336,0,0,0,0,0
"98669",49334500,1000,0.00271151,0,0,0,2,2
"98670",49335000,1000,0.00271392,0,0,0,3,3
"98671",49335500,1000,0.00251813,0,0,0,2,2
"98672",49336000,1000,0.00262482,0,0,0,2,2
"98673",49336500,1000,0.00274084,0,0,1,2,3
"98674",49337000,1000,0.00271404,0,0,1,1,2
"98675",49337500,1000,0.00259258,0,0,0,0,0
"98676",49338000,1000,0.00268236,0,0,0,1,1
"98677",49338500,1000,0.00266769,0,0,0,1,1
"98678",49339000,1000,0.00251387,0,0,0,0,0
"98679",49339500,1000,0.00267463,0,0,0,2,2
"98680",49340000,1000,0.00283344,0,0,0,4,4
"98681",49340500,1000,0.00273424,0,0,0,2,2
"98682",49341000,1000,0.00262812,0,0,0,0,0
"98683",49341500,1000,0.00262571,0,0,0,1,1
"98684",49342000,1000,0.00257024,0,0,0,1,1
"98685",49342500,1000,0.00260264,0,0,0,1,1
"98686",49343000,1000,0.00276555,0,0,1,1,2
"98687",49343500,1000,0.0027652,0,0,2,1,3
"98688",49344000,1000,0.00253247,0,0,1,1,2
"98689",49344500,1000,0.00246386,0,0,0,0,0
"98690",49345000,1000,0.00250805,0,0,0,0,0
"98691",49345500,1000,0.00261887,0,0,1,1,2
"98692",49346000,1000,0.00285515,0,1,1,1,3
"98693",49346500,1000,0.00270489,0,1,0,0,1
"98694",49347000,1000,0.00247218,0,0,0,0,0
"98695",49347500,1000,0.0025561,0,0,0,0,0
"98696",49348000,1000,0.00266101,0,0,0,0,0
"98697",49348500,1000,0.00258676,0,0,0,0,0
"98698",49349000,1000,0.0026034,0,0,0,2,2
"98699",49349500,1000,0.0026056,0,0,0,2,2
"98700",49350000,1000,0.00253289,0,0,0,1,1
"98701",49350500,1000,0.00263293,0,0,0,3,3
"98702",49351000,1000,0.00255496,0,0,0,2,2
"98703",49351500,1000,0.00250802,0,0,0,0,0
"98704",49352000,1000,0.00256413,0,0,0,1,1
"98705",49352500,1000,0.00260885,0,0,0,2,2
"98706",49353000,1000,0.00267204,0,0,0,2,2
"98707",49353500,1000,0.00260963,0,0,0,1,1
"98708",49354000,1000,0.00244996,0,0,0,0,0
"98709",49354500,1000,0.00247291,0,0,0,0,0
"98710",49355000,1000,0.00260858,0,0,0,0,0
"98711",49355500,1000,0.00260518,0,0,0,2,2
"98712",49356000,1000,0.0025205,0,0,0,3,3
"98713",49356500,1000,0.00247299,0,0,0,1,1
"98714",49357000,1000,0.00255515,0,0,0,1,1
"98715",49357500,1000,0.00255977,0,0,0,1,1
"98716",49358000,1000,0.00262704,0,0,0,0,0
"98717",49358500,1000,0.00270798,0,0,0,0,0
"98718",49359000,1000,0.00261375,0,0,0,0,0
"98719",49359500,1000,0.00253516,0,0,0,0,0
"98720",49360000,1000,0.00243428,0,0,0,0,0
"98721",49360500,1000,0.00252454,0,0,0,0,0
"98722",49361000,1000,0.00264353,0,0,0,0,0
"98723",49361500,1000,0.00249149,0,0,0,0,0
"98724",49362000,1000,0.00229149,0,0,0,0,0
"98725",49362500,1000,0.00245446,0,0,0,0,0
"98726",49363000,1000,0.00276154,0,0,1,1,2
"98727",49363500,1000,0.00274305,0,0,1,2,3
"98728",49364000,1000,0.00260888,0,0,0,1,1
"98729",49364500,1000,0.00282412,0,1,0,1,2
"98730",49365000,1000,0.00292236,0,1,0,3,4
"98731",49365500,1000,0.00282996,0,0,1,2,3
"98732",49366000,1000,0.00279373,0,0,1,0,1
"98733",49366500,1000,0.00272255,0,0,1,0,1
"98734",49367000,1000,0.0028458,0,0,1,3,4
"98735",49367500,1000,0.00280643,0,0,1,4,5
"98736",49368000,1000,0.00269937,0,0,1,1,2
"98737",49368500,1000,0.00270351,0,0,0,0,0
"98738",49369000,1000,0.002711,0,0,0,1,1
"98739",49369500,1000,0.00269806,0,0,0,1,1
"98740",49370000,1000,0.00265259,0,0,0,0,0
"98741",49370500,1000,0.00258079,0,0,0,0,0
"98742",49371000,1000,0.00252599,0,0,0,0,0
"98743",49371500,1000,0.00249218,0,0,0,0,0
"98744",49372000,1000,0.00260984,0,0,0,1,1
"98745",49372500,1000,0.00261909,0,0,0,1,1
"98746",49373000,1000,0.0026576,0,0,0,2,2
"98747",49373500,1000,0.00289522,0,0,1,2,3
"98748",49374000,1000,0.00281232,0,0,1,0,1
"98749",49374500,1000,0.00261661,0,0,0,0,0
"98750",49375000,1000,0.00267801,0,0,0,2,2
"98751",49375500,1000,0.00269902,0,0,0,2,2
"98752",49376000,1000,0.00273029,0,0,0,2,2
"98753",49376500,1000,0.00266505,0,0,0,2,2
"98754",49377000,1000,0.00285681,0,0,1,1,2
"98755",49377500,1000,0.00297497,0,0,1,3,4
"98756",49378000,1000,0.00265956,0,0,0,2,2
"98757",49378500,1000,0.00261509,0,0,0,0,0
"98758",49379000,1000,0.00270697,0,0,1,1,2
"98759",49379500,1000,0.00267509,0,0,1,1,2
"98760",49380000,1000,0.00259336,0,0,0,0,0
"98761",49380500,1000,0.00268809,0,0,0,1,1
"98762",49381000,1000,0.0027215,0,0,0,2,2
"98763",49381500,1000,0.00273896,0,0,0,2,2
"98764",49382000,1000,0.00279338,0,0,0,2,2
"98765",49382500,1000,0.00280371,0,0,0,2,2
"98766",49383000,1000,0.00267912,0,0,0,1,1
"98767",49383500,1000,0.00262624,0,0,0,1,1
"98768",49384000,1000,0.00274186,0,0,0,2,2
"98769",49384500,1000,0.00261895,0,0,0,1,1
"98770",49385000,1000,0.00253365,0,0,0,0,0
"98771",49385500,1000,0.0025674,0,0,0,0,0
"98772",49386000,1000,0.0026442,0,0,0,1,1
"98773",49386500,1000,0.00274198,0,0,0,1,1
"98774",49387000,1000,0.00279745,0,0,1,1,2
"98775",49387500,1000,0.00291082,0,0,2,1,3
"98776",49388000,1000,0.00288134,0,0,1,1,2
"98777",49388500,1000,0.00291116,0,0,0,2,2
"98778",49389000,1000,0.00279382,0,0,0,2,2
"98779",49389500,1000,0.00269241,0,0,0,3,3
"98780",49390000,1000,0.00287919,0,0,1,2,3
"98781",49390500,1000,0.00285841,0,0,1,1,2
"98782",49391000,1000,0.00264937,0,0,0,1,1
"98783",49391500,1000,0.00250713,0,0,0,0,0
"98784",49392000,1000,0.00270768,0,0,1,1,2
"98785",49392500,1000,0.00283686,0,0,1,3,4
"98786",49393000,1000,0.00277956,0,0,0,5,5
"98787",49393500,1000,0.00287509,0,0,0,4,4
"98788",49394000,1000,0.00279442,0,0,0,2,2
"98789",49394500,1000,0.00285122,0,1,0,2,3
"98790",49395000,1000,0.002977,0,1,0,3,4
"98791",49395500,1000,0.00282628,0,0,0,3,3
"98792",49396000,1000,0.00261656,0,0,0,1,1
"98793",49396500,1000,0.00263375,0,0,0,1,1
"98794",49397000,1000,0.0028645,0,0,0,3,3
"98795",49397500,1000,0.00285347,0,0,0,2,2
"98796",49398000,1000,0.00266445,0,0,0,0,0
"98797",49398500,1000,0.00260229,0,0,0,2,2
"98798",49399000,1000,0.00270708,0,0,0,4,4
"98799",49399500,1000,0.00264404,0,0,0,2,2
"98800",49400000,1000,0.00301746,0,1,0,2,3
"98801",49400500,1000,0.00311279,0,1,0,3,4
"98802",49401000,1000,0.00268335,0,0,0,2,2
"98803",49401500,1000,0.00281018,0,1,0,1,2
"98804",49402000,1000,0.00278084,0,1,0,1,2
"98805",49402500,1000,0.00271053,0,0,0,4,4
"98806",49403000,1000,0.00282564,0,0,0,5,5
"98807",49403500,1000,0.0027234,0,0,0,2,2
"98808",49404000,1000,0.00266119,0,0,0,0,0
"98809",49404500,1000,0.0026606,0,0,0,0,0
"98810",49405000,1000,0.00263521,0,0,0,0,0
"98811",49405500,1000,0.00275865,0,0,1,0,1
"98812",49406000,1000,0.00270903,0,0,1,0,1
"98813",49406500,1000,0.00273653,0,0,0,0,0
"98814",49407000,1000,0.0028234,0,0,0,1,1
"98815",49407500,1000,0.00264532,0,0,0,1,1
"98816",49408000,1000,0.00252819,0,0,0,0,0
"98817",49408500,1000,0.0026146,0,0,0,0,0
"98818",49409000,1000,0.00280387,0,0,1,0,1
"98819",49409500,1000,0.00299315,0,0,2,4,6
"98820",49410000,1000,0.00290725,0,0,1,5,6
"98821",49410500,1000,0.00263953,0,0,0,1,1
"98822",49411000,1000,0.00263243,0,0,0,2,2
"98823",49411500,1000,0.00277465,0,0,0,2,2
"98824",49412000,1000,0.00276138,0,0,0,0,0
"98825",49412500,1000,0.002829,0,0,0,2,2
"98826",49413000,1000,0.00277186,0,0,0,2,2
"98827",49413500,1000,0.002559,0,0,0,1,1
"98828",49414000,1000,0.00254339,0,0,0,1,1
"98829",49414500,1000,0.00271146,0,0,0,0,0
"98830",49415000,1000,0.0027959,0,0,0,0,0
"98831",49415500,1000,0.00260064,0,0,0,0,0
"98832",49416000,1000,0.00265162,0,0,0,0,0
"98833",49416500,1000,0.00261967,0,0,0,0,0
"98834",49417000,1000,0.00253774,0,0,0,0,0
"98835",49417500,1000,0.00256925,0,0,0,0,0
"98836",49418000,1000,0.00249154,0,0,0,0,0
"98837",49418500,1000,0.00255931,0,0,0,1,1
"98838",49419000,1000,0.00264751,0,0,0,1,1
"98839",49419500,1000,0.00270275,0,0,0,0,0
"98840",49420000,1000,0.00284579,0,1,0,0,1
"98841",49420500,1000,0.00288736,0,1,0,1,2
"98842",49421000,1000,0.00267473,0,0,0,1,1
"98843",49421500,1000,0.00261464,0,0,0,1,1
"98844",49422000,1000,0.00268181,0,0,0,3,3
"98845",49422500,1000,0.00261638,0,0,0,2,2
"98846",49423000,1000,0.00258796,0,0,0,0,0
"98847",49423500,1000,0.00248322,0,0,0,0,0
"98848",49424000,1000,0.00247996,0,0,0,0,0
"98849",49424500,1000,0.0025989,0,0,0,1,1
"98850",49425000,1000,0.00251748,0,0,0,1,1
"98851",49425500,1000,0.00251922,0,0,0,0,0
"98852",49426000,1000,0.00253822,0,0,0,1,1
"98853",49426500,1000,0.00251796,0,0,0,1,1
"98854",49427000,1000,0.00265806,0,0,0,1,1
"98855",49427500,1000,0.00274509,0,0,0,2,2
"98856",49428000,1000,0.00260834,0,0,0,2,2
"98857",49428500,1000,0.00255523,0,0,0,1,1
"98858",49429000,1000,0.00266797,0,0,1,1,2
"98859",49429500,1000,0.00270665,0,0,2,2,4
"98860",49430000,1000,0.00259591,0,0,1,1,2
"98861",49430500,1000,0.00262836,0,0,0,2,2
"98862",49431000,1000,0.0026795,0,0,0,3,3
"98863",49431500,1000,0.00273768,0,0,1,2,3
"98864",49432000,1000,0.00287015,0,0,1,2,3
"98865",49432500,1000,0.00267171,0,0,0,1,1
"98866",49433000,1000,0.00271407,0,0,0,1,1
"98867",49433500,1000,0.00287634,0,0,0,2,2
"98868",49434000,1000,0.00282848,0,0,1,2,3
"98869",49434500,1000,0.00289275,0,0,3,1,4
"98870",49435000,1000,0.00295761,0,0,3,0,3
"98871",49435500,1000,0.00291616,0,0,1,1,2
"98872",49436000,1000,0.0027818,0,0,0,1,1
"98873",49436500,1000,0.00266071,0,0,0,0,0
"98874",49437000,1000,0.00269036,0,0,0,0,0
"98875",49437500,1000,0.00274786,0,0,0,2,2
"98876",49438000,1000,0.00275737,0,0,0,2,2
"98877",49438500,1000,0.00266667,0,0,0,0,0
"98878",49439000,1000,0.00257561,0,0,0,0,0
"98879",49439500,1000,0.00266267,0,0,0,0,0
"98880",49440000,1000,0.0026766,0,0,0,0,0
"98881",49440500,1000,0.00272121,0,0,0,0,0
"98882",49441000,1000,0.00289085,0,0,0,2,2
"98883",49441500,1000,0.00285133,0,0,0,2,2
"98884",49442000,1000,0.00270665,0,0,0,0,0
"98885",49442500,1000,0.00264399,0,0,0,1,1
"98886",49443000,1000,0.00267267,0,0,0,1,1
"98887",49443500,1000,0.00270956,0,0,0,0,0
"98888",49444000,1000,0.00265165,0,0,0,0,0
"98889",49444500,1000,0.00260017,0,0,0,0,0
"98890",49445000,1000,0.00260376,0,0,0,0,0
"98891",49445500,1000,0.00260171,0,0,0,0,0
"98892",49446000,1000,0.00269614,0,0,1,0,1
"98893",49446500,1000,0.00285735,0,0,1,2,3
"98894",49447000,1000,0.00295701,0,0,1,3,4
"98895",49447500,1000,0.00277317,0,0,1,1,2
"98896",49448000,1000,0.00253814,0,0,0,0,0
"98897",49448500,1000,0.00258063,0,0,0,2,2
"98898",49449000,1000,0.002658,0,0,0,2,2
"98899",49449500,1000,0.0026688,0,0,0,0,0
"98900",49450000,1000,0.00268986,0,0,0,0,0
"98901",49450500,1000,0.00280494,0,0,0,1,1
"98902",49451000,1000,0.00284864,0,0,0,2,2
"98903",49451500,1000,0.0027416,0,0,0,1,1
"98904",49452000,1000,0.00263894,0,0,0,0,0
"98905",49452500,1000,0.00275084,0,0,1,1,2
"98906",49453000,1000,0.00288982,0,0,1,2,3
"98907",49453500,1000,0.00277225,0,0,0,1,1
"98908",49454000,1000,0.00272867,0,0,0,1,1
"98909",49454500,1000,0.00280267,0,0,1,1,2
"98910",49455000,1000,0.00265817,0,0,1,0,1
"98911",49455500,1000,0.00266749,0,1,0,0,1
"98912",49456000,1000,0.00272171,0,1,0,0,1
"98913",49456500,1000,0.00263286,0,0,0,0,0
"98914",49457000,1000,0.00271213,0,0,0,0,0
"98915",49457500,1000,0.00272957,0,0,0,0,0
"98916",49458000,1000,0.00263274,0,0,0,0,0
"98917",49458500,1000,0.00272041,0,0,0,1,1
"98918",49459000,1000,0.00289174,0,0,0,1,1
"98919",49459500,1000,0.00288356,0,0,0,1,1
"98920",49460000,1000,0.00267343,0,0,0,1,1
"98921",49460500,1000,0.0027054,0,0,0,0,0
"98922",49461000,1000,0.0028327,0,0,0,2,2
"98923",49461500,1000,0.00275188,0,0,0,3,3
"98924",49462000,1000,0.00273491,0,0,0,1,1
"98925",49462500,1000,0.00268794,0,0,0,2,2
"98926",49463000,1000,0.00261127,0,0,0,2,2
"98927",49463500,1000,0.00261258,0,0,0,0,0
"98928",49464000,1000,0.00272565,0,0,0,2,2
"98929",49464500,1000,0.002813,0,0,0,3,3
"98930",49465000,1000,0.00270277,0,0,0,1,1
"98931",49465500,1000,0.00266174,0,0,0,0,0
"98932",49466000,1000,0.0026602,0,0,0,0,0
"98933",49466500,1000,0.00269498,0,0,0,1,1
"98934",49467000,1000,0.00285797,0,0,0,1,1
"98935",49467500,1000,0.00287517,0,0,1,0,1
"98936",49468000,1000,0.00270111,0,0,1,0,1
"98937",49468500,1000,0.00270108,0,0,0,1,1
"98938",49469000,1000,0.00272832,0,0,0,1,1
"98939",49469500,1000,0.00268539,0,0,0,1,1
"98940",49470000,1000,0.0025346,0,0,0,1,1
"98941",49470500,1000,0.00255763,0,0,0,1,1
"98942",49471000,1000,0.00280905,0,0,0,2,2
"98943",49471500,1000,0.00280172,0,0,0,1,1
"98944",49472000,1000,0.00275629,0,0,0,0,0
"98945",49472500,1000,0.00275021,0,0,0,0,0
"98946",49473000,1000,0.00277896,0,0,0,0,0
"98947",49473500,1000,0.00273856,0,0,0,1,1
"98948",49474000,1000,0.00280177,0,1,0,1,2
"98949",49474500,1000,0.0027682,0,1,0,0,1
"98950",49475000,1000,0.00261683,0,0,0,0,0
"98951",49475500,1000,0.00268226,0,0,0,0,0
"98952",49476000,1000,0.00264775,0,0,0,0,0
"98953",49476500,1000,0.00270028,0,0,1,0,1
"98954",49477000,1000,0.00289174,0,0,2,0,2
"98955",49477500,1000,0.00269551,0,0,1,0,1
"98956",49478000,1000,0.00258296,0,0,0,0,0
"98957",49478500,1000,0.00273496,0,0,0,1,1
"98958",49479000,1000,0.0029438,0,1,0,3,4
"98959",49479500,1000,0.00293895,0,1,0,3,4
"98960",49480000,1000,0.00270575,0,0,0,2,2
"98961",49480500,1000,0.00266265,0,0,0,1,1
"98962",49481000,1000,0.00276228,0,0,1,0,1
"98963",49481500,1000,0.00281104,0,0,2,0,2
"98964",49482000,1000,0.00288405,0,0,1,0,1
"98965",49482500,1000,0.00279859,0,0,0,0,0
"98966",49483000,1000,0.00270692,0,0,0,0,0
"98967",49483500,1000,0.00294406,0,0,0,1,1
"98968",49484000,1000,0.00311561,0,0,1,3,4
"98969",49484500,1000,0.00286304,0,0,1,2,3
"98970",49485000,1000,0.00255197,0,0,0,0,0
"98971",49485500,1000,0.00270706,0,1,0,0,1
"98972",49486000,1000,0.00282203,0,1,0,1,2
"98973",49486500,1000,0.00268821,0,0,0,1,1
"98974",49487000,1000,0.00266401,0,0,0,0,0
"98975",49487500,1000,0.00277787,0,0,0,0,0
"98976",49488000,1000,0.00291415,0,0,1,1,2
"98977",49488500,1000,0.00287511,0,0,1,1,2
"98978",49489000,1000,0.00273162,0,0,0,0,0
"98979",49489500,1000,0.0026289,0,0,0,0,0
"98980",49490000,1000,0.00258431,0,0,0,0,0
"98981",49490500,1000,0.00263634,0,0,0,0,0
"98982",49491000,1000,0.00273225,0,0,0,0,0
"98983",49491500,1000,0.00283603,0,0,0,0,0
"98984",49492000,1000,0.00286715,0,0,0,1,1
"98985",49492500,1000,0.00278247,0,0,0,1,1
"98986",49493000,1000,0.00264726,0,0,0,0,0
"98987",49493500,1000,0.00257028,0,0,0,0,0
"98988",49494000,1000,0.00253722,0,0,0,0,0
"98989",49494500,1000,0.00263348,0,0,0,0,0
"98990",49495000,1000,0.00252355,0,0,0,0,0
"98991",49495500,1000,0.00243553,0,0,0,0,0
"98992",49496000,1000,0.00255888,0,0,0,0,0
"98993",49496500,1000,0.00246314,0,0,0,0,0
"98994",49497000,1000,0.00244366,0,0,0,0,0
"98995",49497500,1000,0.00245991,0,0,0,0,0
"98996",49498000,1000,0.00245353,0,0,0,0,0
"98997",49498500,1000,0.00243786,0,0,0,0,0
"98998",49499000,1000,0.00246355,0,0,0,0,0
"98999",49499500,1000,0.00294032,0,1,1,1,3
"99000",49500000,1000,0.00299215,0,1,2,1,4
"99001",49500500,1000,0.00265348,0,0,1,0,1
"99002",49501000,1000,0.00256836,0,0,0,0,0
"99003",49501500,1000,0.00266568,0,0,1,1,2
"99004",49502000,1000,0.00278198,0,0,1,1,2
"99005",49502500,1000,0.00263085,0,0,0,0,0
"99006",49503000,1000,0.0026133,0,0,0,0,0
"99007",49503500,1000,0.00271277,0,0,0,1,1
"99008",49504000,1000,0.00265528,0,0,0,1,1
"99009",49504500,1000,0.00262905,0,0,0,1,1
"99010",49505000,1000,0.0027389,0,0,0,2,2
"99011",49505500,1000,0.0027153,0,0,0,1,1
"99012",49506000,1000,0.00264432,0,0,0,1,1
"99013",49506500,1000,0.00269862,0,0,0,2,2
"99014",49507000,1000,0.0027523,0,0,0,1,1
"99015",49507500,1000,0.00282086,0,0,0,1,1
"99016",49508000,1000,0.00277661,0,0,0,1,1
"99017",49508500,1000,0.00267483,0,0,0,0,0
"99018",49509000,1000,0.00268587,0,0,0,0,0
"99019",49509500,1000,0.0028784,0,1,0,0,1
"99020",49510000,1000,0.00296963,0,1,0,1,2
"99021",49510500,1000,0.00311219,0,1,1,2,4
"99022",49511000,1000,0.00292734,0,1,1,1,3
"99023",49511500,1000,0.0025973,0,0,0,1,1
"99024",49512000,1000,0.00270339,0,0,0,2,2
"99025",49512500,1000,0.00273299,0,0,0,3,3
"99026",49513000,1000,0.00263907,0,0,0,2,2
"99027",49513500,1000,0.00269192,0,0,1,0,1
"99028",49514000,1000,0.00274705,0,0,1,0,1
"99029",49514500,1000,0.00267327,0,0,0,1,1
"99030",49515000,1000,0.00275899,0,0,0,1,1
"99031",49515500,1000,0.00277683,0,0,1,0,1
"99032",49516000,1000,0.00279045,0,0,2,1,3
"99033",49516500,1000,0.00270704,0,0,1,1,2
"99034",49517000,1000,0.00271251,0,0,0,2,2
"99035",49517500,1000,0.00282052,0,0,0,4,4
"99036",49518000,1000,0.00271049,0,0,0,3,3
"99037",49518500,1000,0.00269451,0,0,0,1,1
"99038",49519000,1000,0.00261297,0,0,0,1,1
"99039",49519500,1000,0.00252276,0,0,0,1,1
"99040",49520000,1000,0.00257882,0,0,0,0,0
"99041",49520500,1000,0.00262081,0,0,0,0,0
"99042",49521000,1000,0.00263742,0,0,0,0,0
"99043",49521500,1000,0.00264976,0,0,0,0,0
"99044",49522000,1000,0.00275122,0,0,0,1,1
"99045",49522500,1000,0.00270995,0,0,0,2,2
"99046",49523000,1000,0.0026594,0,0,0,2,2
"99047",49523500,1000,0.00263641,0,0,0,1,1
"99048",49524000,1000,0.00257632,0,0,0,0,0
"99049",49524500,1000,0.00254725,0,0,0,0,0
"99050",49525000,1000,0.00257142,0,0,0,0,0
"99051",49525500,1000,0.00257209,0,0,0,0,0
"99052",49526000,1000,0.00260733,0,0,0,1,1
"99053",49526500,1000,0.00263607,0,0,0,1,1
"99054",49527000,1000,0.00270682,0,0,0,2,2
"99055",49527500,1000,0.00284026,0,0,1,3,4
"99056",49528000,1000,0.00268383,0,0,1,1,2
"99057",49528500,1000,0.00259706,0,0,0,0,0
"99058",49529000,1000,0.00263154,0,0,0,0,0
"99059",49529500,1000,0.00272533,0,0,0,2,2
"99060",49530000,1000,0.00270029,0,0,0,2,2
"99061",49530500,1000,0.00255773,0,0,0,0,0
"99062",49531000,1000,0.00260033,0,0,1,1,2
"99063",49531500,1000,0.00267725,0,0,1,2,3
"99064",49532000,1000,0.00278708,0,0,0,2,2
"99065",49532500,1000,0.00281391,0,0,0,2,2
"99066",49533000,1000,0.00271251,0,0,0,3,3
"99067",49533500,1000,0.00273018,0,0,1,2,3
"99068",49534000,1000,0.00282997,0,0,1,3,4
"99069",49534500,1000,0.00261168,0,0,0,3,3
"99070",49535000,1000,0.00239581,0,0,0,0,0
"99071",49535500,1000,0.00262279,0,0,1,1,2
"99072",49536000,1000,0.00281196,0,0,2,1,3
"99073",49536500,1000,0.00270109,0,0,1,0,1
"99074",49537000,1000,0.0025317,0,0,0,0,0
"99075",49537500,1000,0.00249891,0,0,0,0,0
"99076",49538000,1000,0.00263794,0,0,0,1,1
"99077",49538500,1000,0.00279731,0,0,0,1,1
"99078",49539000,1000,0.00276895,0,0,0,0,0
"99079",49539500,1000,0.00257596,0,0,0,1,1
"99080",49540000,1000,0.00251952,0,0,0,2,2
"99081",49540500,1000,0.00258804,0,0,0,1,1
"99082",49541000,1000,0.00257663,0,0,0,0,0
"99083",49541500,1000,0.00276218,0,1,0,1,2
"99084",49542000,1000,0.002654,0,1,0,1,2
"99085",49542500,1000,0.00243793,0,0,0,0,0
"99086",49543000,1000,0.0026247,0,0,0,0,0
"99087",49543500,1000,0.00265677,0,0,0,0,0
"99088",49544000,1000,0.00266699,0,0,0,1,1
"99089",49544500,1000,0.00272714,0,0,0,1,1
"99090",49545000,1000,0.00272959,0,0,1,0,1
"99091",49545500,1000,0.00267797,0,0,1,0,1
"99092",49546000,1000,0.0026939,0,0,0,1,1
"99093",49546500,1000,0.00292977,0,1,1,1,3
"99094",49547000,1000,0.00287491,0,1,1,0,2
"99095",49547500,1000,0.00273196,0,0,0,1,1
"99096",49548000,1000,0.00266611,0,0,0,1,1
"99097",49548500,1000,0.0026267,0,0,0,1,1
"99098",49549000,1000,0.00267237,0,0,0,1,1
"99099",49549500,1000,0.00266743,0,0,0,0,0
"99100",49550000,1000,0.00269619,0,0,0,1,1
"99101",49550500,1000,0.0026271,0,0,0,1,1
"99102",49551000,1000,0.00268786,0,0,0,2,2
"99103",49551500,1000,0.00272811,0,0,0,3,3
"99104",49552000,1000,0.00267311,0,0,0,1,1
"99105",49552500,1000,0.00271106,0,0,0,0,0
"99106",49553000,1000,0.00277233,0,0,0,0,0
"99107",49553500,1000,0.00276543,0,0,0,0,0
"99108",49554000,1000,0.0026388,0,0,0,0,0
"99109",49554500,1000,0.00268008,0,0,0,0,0
"99110",49555000,1000,0.00266757,0,0,0,0,0
"99111",49555500,1000,0.00252426,0,0,0,0,0
"99112",49556000,1000,0.00279819,0,0,1,1,2
"99113",49556500,1000,0.00289927,0,0,1,1,2
"99114",49557000,1000,0.00262907,0,0,0,0,0
"99115",49557500,1000,0.0025624,0,0,0,0,0
"99116",49558000,1000,0.00266233,0,0,0,1,1
"99117",49558500,1000,0.00273775,0,0,1,1,2
"99118",49559000,1000,0.00288961,0,0,2,2,4
"99119",49559500,1000,0.00290075,0,0,2,3,5
"99120",49560000,1000,0.00281969,0,0,2,1,3
"99121",49560500,1000,0.00268127,0,0,1,0,1
"99122",49561000,1000,0.0025862,0,0,0,0,0
"99123",49561500,1000,0.00266802,0,0,0,0,0
"99124",49562000,1000,0.00266601,0,0,0,1,1
"99125",49562500,1000,0.00269662,0,1,0,1,2
"99126",49563000,1000,0.00284874,0,1,0,2,3
"99127",49563500,1000,0.00290556,0,0,1,2,3
"99128",49564000,1000,0.00273139,0,0,1,1,2
"99129",49564500,1000,0.0026325,0,0,0,1,1
"99130",49565000,1000,0.00266568,0,0,1,1,2
"99131",49565500,1000,0.00275506,0,0,2,2,4
"99132",49566000,1000,0.00274894,0,0,1,1,2
"99133",49566500,1000,0.00255996,0,0,0,0,0
"99134",49567000,1000,0.00257207,0,0,0,0,0
"99135",49567500,1000,0.00273734,0,0,0,0,0
"99136",49568000,1000,0.00269772,0,0,0,0,0
"99137",49568500,1000,0.00263069,0,0,0,1,1
"99138",49569000,1000,0.00220289,0,0,0,1,1
"99139",49569500,1000,0.00221935,0,0,0,2,2
"99140",49570000,1000,0.00265812,0,0,1,2,3
"99141",49570500,1000,0.00293123,0,1,1,1,3
"99142",49571000,1000,0.00302521,0,1,0,3,4
"99143",49571500,1000,0.00282453,0,0,1,2,3
"99144",49572000,1000,0.00270545,0,0,1,0,1
"99145",49572500,1000,0.00288999,0,0,1,2,3
"99146",49573000,1000,0.00291367,0,0,1,2,3
"99147",49573500,1000,0.00264943,0,0,0,0,0
"99148",49574000,1000,0.00274076,0,0,0,1,1
"99149",49574500,1000,0.0027296,0,0,1,1,2
"99150",49575000,1000,0.00262525,0,0,1,0,1
"99151",49575500,1000,0.00251055,0,0,0,1,1
"99152",49576000,1000,0.00240829,0,0,0,1,1
"99153",49576500,1000,0.00259586,0,1,0,0,1
"99154",49577000,1000,0.00274764,0,1,0,0,1
"99155",49577500,1000,0.00261534,0,0,0,0,0
"99156",49578000,1000,0.00272978,0,1,0,0,1
"99157",49578500,1000,0.00286132,0,1,0,0,1
"99158",49579000,1000,0.00285454,0,0,0,2,2
"99159",49579500,1000,0.00284647,0,0,0,2,2
"99160",49580000,1000,0.00266443,0,0,0,0,0
"99161",49580500,1000,0.00257099,0,0,0,0,0
"99162",49581000,1000,0.00267081,0,0,1,1,2
"99163",49581500,1000,0.00272413,0,0,1,1,2
"99164",49582000,1000,0.00273652,0,0,0,1,1
"99165",49582500,1000,0.00273851,0,0,0,2,2
"99166",49583000,1000,0.0027249,0,0,0,1,1
"99167",49583500,1000,0.0027419,0,0,0,1,1
"99168",49584000,1000,0.00277343,0,0,0,2,2
"99169",49584500,1000,0.00265997,0,0,0,1,1
"99170",49585000,1000,0.00256964,0,0,0,0,0
"99171",49585500,1000,0.00265099,0,0,0,0,0
"99172",49586000,1000,0.00265648,0,0,0,0,0
"99173",49586500,1000,0.00263813,0,0,0,0,0
"99174",49587000,1000,0.00274605,0,0,1,1,2
"99175",49587500,1000,0.00277405,0,0,1,1,2
"99176",49588000,1000,0.00263768,0,0,0,0,0
"99177",49588500,1000,0.00262869,0,0,0,0,0
"99178",49589000,1000,0.00262731,0,0,0,0,0
"99179",49589500,1000,0.00254389,0,0,0,0,0
"99180",49590000,1000,0.00250512,0,0,0,0,0
"99181",49590500,1000,0.0025485,0,0,0,0,0
"99182",49591000,1000,0.00269227,0,0,0,1,1
"99183",49591500,1000,0.00274448,0,0,0,3,3
"99184",49592000,1000,0.00276174,0,0,0,4,4
"99185",49592500,1000,0.00265933,0,0,0,2,2
"99186",49593000,1000,0.00265543,0,0,1,1,2
"99187",49593500,1000,0.00280117,0,0,2,1,3
"99188",49594000,1000,0.00269638,0,0,1,0,1
"99189",49594500,1000,0.00263937,0,0,0,0,0
"99190",49595000,1000,0.00270672,0,0,0,0,0
"99191",49595500,1000,0.0028653,0,0,1,2,3
"99192",49596000,1000,0.00289641,0,0,1,3,4
"99193",49596500,1000,0.00277976,0,0,0,2,2
"99194",49597000,1000,0.00274725,0,0,0,3,3
"99195",49597500,1000,0.00268193,0,0,0,2,2
"99196",49598000,1000,0.0026427,0,0,0,0,0
"99197",49598500,1000,0.00259098,0,0,0,0,0
"99198",49599000,1000,0.00257765,0,0,0,0,0
"99199",49599500,1000,0.00256785,0,0,0,0,0
"99200",49600000,1000,0.002585,0,0,0,0,0
"99201",49600500,1000,0.00263665,0,0,0,0,0
"99202",49601000,1000,0.00268077,0,0,0,0,0
"99203",49601500,1000,0.00272565,0,0,0,0,0
"99204",49602000,1000,0.00262308,0,0,0,0,0
"99205",49602500,1000,0.00265027,0,0,0,0,0
"99206",49603000,1000,0.00260059,0,0,0,0,0
"99207",49603500,1000,0.00255646,0,0,0,0,0
"99208",49604000,1000,0.00272377,0,0,0,1,1
"99209",49604500,1000,0.00275654,0,0,0,1,1
"99210",49605000,1000,0.00272433,0,0,1,1,2
"99211",49605500,1000,0.00282892,0,0,1,3,4
"99212",49606000,1000,0.00268815,0,0,0,2,2
"99213",49606500,1000,0.0025662,0,0,0,1,1
"99214",49607000,1000,0.00263172,0,0,0,1,1
"99215",49607500,1000,0.00263804,0,0,0,0,0
"99216",49608000,1000,0.00276714,0,1,0,0,1
"99217",49608500,1000,0.00273309,0,1,0,0,1
"99218",49609000,1000,0.00270787,0,0,1,1,2
"99219",49609500,1000,0.00280367,0,0,1,2,3
"99220",49610000,1000,0.00278242,0,0,0,2,2
"99221",49610500,1000,0.00268555,0,0,0,1,1
"99222",49611000,1000,0.0026624,0,0,0,0,0
"99223",49611500,1000,0.00265592,0,0,0,0,0
"99224",49612000,1000,0.00263979,0,0,0,0,0
"99225",49612500,1000,0.00272452,0,0,0,2,2
"99226",49613000,1000,0.0026346,0,0,0,2,2
"99227",49613500,1000,0.00261869,0,0,0,1,1
"99228",49614000,1000,0.00263204,0,0,0,1,1
"99229",49614500,1000,0.00261861,0,0,1,0,1
"99230",49615000,1000,0.00261513,0,0,1,0,1
"99231",49615500,1000,0.00263083,0,0,0,0,0
"99232",49616000,1000,0.00273324,0,0,0,0,0
"99233",49616500,1000,0.00273683,0,0,0,1,1
"99234",49617000,1000,0.00262854,0,0,0,1,1
"99235",49617500,1000,0.00260323,0,0,1,1,2
"99236",49618000,1000,0.00272113,0,0,1,2,3
"99237",49618500,1000,0.00270853,0,0,0,1,1
"99238",49619000,1000,0.00261495,0,0,0,0,0
"99239",49619500,1000,0.00263274,0,0,1,0,1
"99240",49620000,1000,0.0026246,0,0,1,0,1
"99241",49620500,1000,0.00253266,0,0,0,0,0
"99242",49621000,1000,0.00253391,0,0,0,0,0
"99243",49621500,1000,0.00259089,0,0,0,0,0
"99244",49622000,1000,0.00269826,0,0,0,0,0
"99245",49622500,1000,0.00276147,0,0,1,0,1
"99246",49623000,1000,0.00266819,0,0,1,0,1
"99247",49623500,1000,0.00264403,0,0,0,1,1
"99248",49624000,1000,0.00275369,0,0,1,1,2
"99249",49624500,1000,0.00271536,0,0,1,1,2
"99250",49625000,1000,0.00262885,0,0,0,1,1
"99251",49625500,1000,0.00258389,0,0,0,0,0
"99252",49626000,1000,0.0025772,0,0,1,0,1
"99253",49626500,1000,0.00255191,0,0,1,0,1
"99254",49627000,1000,0.00262016,0,0,1,1,2
"99255",49627500,1000,0.0026804,0,0,1,1,2
"99256",49628000,1000,0.00271694,0,0,0,2,2
"99257",49628500,1000,0.00274544,0,0,0,2,2
"99258",49629000,1000,0.00270437,0,0,1,0,1
"99259",49629500,1000,0.00270031,0,0,1,0,1
"99260",49630000,1000,0.00274207,0,1,0,0,1
"99261",49630500,1000,0.00262072,0,1,0,0,1
"99262",49631000,1000,0.00242134,0,0,0,0,0
"99263",49631500,1000,0.00262384,0,0,0,1,1
"99264",49632000,1000,0.00263735,0,0,0,1,1
"99265",49632500,1000,0.00248576,0,0,0,1,1
"99266",49633000,1000,0.00263315,0,0,0,1,1
"99267",49633500,1000,0.00269926,0,0,0,0,0
"99268",49634000,1000,0.00264234,0,0,0,0,0
"99269",49634500,1000,0.00261765,0,0,0,0,0
"99270",49635000,1000,0.00249836,0,0,0,0,0
"99271",49635500,1000,0.00250882,0,0,0,1,1
"99272",49636000,1000,0.00265472,0,0,0,2,2
"99273",49636500,1000,0.00254898,0,0,0,1,1
"99274",49637000,1000,0.00256046,0,0,0,1,1
"99275",49637500,1000,0.00278941,0,0,0,3,3
"99276",49638000,1000,0.00281461,0,0,0,4,4
"99277",49638500,1000,0.00276059,0,0,1,2,3
"99278",49639000,1000,0.00270113,0,0,1,0,1
"99279",49639500,1000,0.0025127,0,0,0,0,0
"99280",49640000,1000,0.00245698,0,0,0,1,1
"99281",49640500,1000,0.00258121,0,0,0,1,1
"99282",49641000,1000,0.00271035,0,0,0,2,2
"99283",49641500,1000,0.00263333,0,0,0,3,3
"99284",49642000,1000,0.00259468,0,0,0,3,3
"99285",49642500,1000,0.00265852,0,0,0,2,2
"99286",49643000,1000,0.00254968,0,0,0,0,0
"99287",49643500,1000,0.00265,0,0,0,0,0
"99288",49644000,1000,0.00277137,0,0,0,1,1
"99289",49644500,1000,0.00258066,0,0,0,1,1
"99290",49645000,1000,0.00247364,0,0,0,0,0
"99291",49645500,1000,0.00269804,0,0,2,0,2
"99292",49646000,1000,0.00283832,0,0,3,1,4
"99293",49646500,1000,0.0026578,0,0,1,1,2
"99294",49647000,1000,0.00258593,0,0,0,1,1
"99295",49647500,1000,0.0026557,0,0,0,3,3
"99296",49648000,1000,0.00271231,0,0,0,3,3
"99297",49648500,1000,0.00278764,0,0,0,2,2
"99298",49649000,1000,0.00271988,0,0,0,3,3
"99299",49649500,1000,0.0027098,0,0,0,3,3
"99300",49650000,1000,0.0027812,0,0,0,3,3
"99301",49650500,1000,0.00263038,0,0,0,2,2
"99302",49651000,1000,0.00251641,0,0,0,0,0
"99303",49651500,1000,0.00260579,0,0,1,1,2
"99304",49652000,1000,0.00267638,0,0,1,1,2
"99305",49652500,1000,0.0026441,0,0,0,1,1
"99306",49653000,1000,0.00250532,0,0,0,1,1
"99307",49653500,1000,0.00251193,0,0,0,0,0
"99308",49654000,1000,0.00260929,0,0,0,0,0
"99309",49654500,1000,0.00262863,0,0,0,0,0
"99310",49655000,1000,0.00271131,0,0,1,1,2
"99311",49655500,1000,0.00259033,0,0,1,1,2
"99312",49656000,1000,0.00262629,0,0,1,1,2
"99313",49656500,1000,0.00280764,0,0,2,2,4
"99314",49657000,1000,0.00263193,0,0,1,1,2
"99315",49657500,1000,0.00262811,0,0,0,3,3
"99316",49658000,1000,0.0025843,0,0,0,3,3
"99317",49658500,1000,0.00257767,0,0,0,0,0
"99318",49659000,1000,0.00269302,0,0,0,0,0
"99319",49659500,1000,0.00267009,0,0,0,1,1
"99320",49660000,1000,0.00276215,0,0,0,1,1
"99321",49660500,1000,0.00279521,0,0,1,0,1
"99322",49661000,1000,0.00263978,0,0,1,0,1
"99323",49661500,1000,0.00260065,0,0,0,0,0
"99324",49662000,1000,0.00266953,0,0,0,2,2
"99325",49662500,1000,0.00267821,0,0,0,3,3
"99326",49663000,1000,0.00271466,0,0,0,1,1
"99327",49663500,1000,0.00265928,0,0,0,0,0
"99328",49664000,1000,0.002514,0,0,0,0,0
"99329",49664500,1000,0.00251863,0,0,0,0,0
"99330",49665000,1000,0.0025909,0,0,0,1,1
"99331",49665500,1000,0.00261433,0,0,0,2,2
"99332",49666000,1000,0.00258663,0,0,0,1,1
"99333",49666500,1000,0.00280703,0,0,1,3,4
"99334",49667000,1000,0.00279205,0,0,1,4,5
"99335",49667500,1000,0.00250227,0,0,0,1,1
"99336",49668000,1000,0.00250412,0,0,0,0,0
"99337",49668500,1000,0.00252843,0,0,1,0,1
"99338",49669000,1000,0.00253098,0,0,1,0,1
"99339",49669500,1000,0.00263733,0,0,1,1,2
"99340",49670000,1000,0.00271972,0,0,1,1,2
"99341",49670500,1000,0.00259077,0,0,0,0,0
"99342",49671000,1000,0.00249272,0,0,0,0,0
"99343",49671500,1000,0.00271165,0,0,1,3,4
"99344",49672000,1000,0.00279211,0,0,1,3,4
"99345",49672500,1000,0.00261317,0,0,0,0,0
"99346",49673000,1000,0.00265769,0,0,0,2,2
"99347",49673500,1000,0.00276839,0,1,0,2,3
"99348",49674000,1000,0.00268645,0,1,0,0,1
"99349",49674500,1000,0.00253094,0,0,0,1,1
"99350",49675000,1000,0.00248986,0,0,0,1,1
"99351",49675500,1000,0.00264122,0,0,1,1,2
"99352",49676000,1000,0.0026755,0,0,1,1,2
"99353",49676500,1000,0.00254463,0,0,0,0,0
"99354",49677000,1000,0.00262685,0,0,1,0,1
"99355",49677500,1000,0.00260026,0,0,1,0,1
"99356",49678000,1000,0.00245789,0,0,0,0,0
"99357",49678500,1000,0.00263599,0,0,1,2,3
"99358",49679000,1000,0.00278096,0,0,2,3,5
"99359",49679500,1000,0.00255961,0,0,1,1,2
"99360",49680000,1000,0.00253199,0,0,0,0,0
"99361",49680500,1000,0.00267033,0,0,0,2,2
"99362",49681000,1000,0.0026088,0,0,0,3,3
"99363",49681500,1000,0.00255911,0,0,0,1,1
"99364",49682000,1000,0.00263504,0,0,0,0,0
"99365",49682500,1000,0.00263403,0,0,0,0,0
"99366",49683000,1000,0.00274602,0,0,1,1,2
"99367",49683500,1000,0.00296042,0,0,2,2,4
"99368",49684000,1000,0.00296894,0,0,1,1,2
"99369",49684500,1000,0.00276989,0,0,0,1,1
"99370",49685000,1000,0.00255852,0,0,0,1,1
"99371",49685500,1000,0.00245066,0,0,0,0,0
"99372",49686000,1000,0.00262484,0,0,1,2,3
"99373",49686500,1000,0.00268355,0,0,1,2,3
"99374",49687000,1000,0.00272445,0,1,0,1,2
"99375",49687500,1000,0.00285712,0,1,0,3,4
"99376",49688000,1000,0.0027734,0,0,0,3,3
"99377",49688500,1000,0.00263848,0,0,0,1,1
"99378",49689000,1000,0.00259238,0,0,0,0,0
"99379",49689500,1000,0.00272102,0,0,1,1,2
"99380",49690000,1000,0.00271969,0,0,1,2,3
"99381",49690500,1000,0.00276501,0,0,0,3,3
"99382",49691000,1000,0.00267943,0,0,0,2,2
"99383",49691500,1000,0.0025348,0,0,0,0,0
"99384",49692000,1000,0.00273116,0,0,1,2,3
"99385",49692500,1000,0.00281304,0,0,1,2,3
"99386",49693000,1000,0.00258616,0,0,0,0,0
"99387",49693500,1000,0.00264734,0,0,1,1,2
"99388",49694000,1000,0.00279509,0,0,1,2,3
"99389",49694500,1000,0.00268193,0,0,0,3,3
"99390",49695000,1000,0.00259842,0,0,0,2,2
"99391",49695500,1000,0.0025665,0,0,0,0,0
"99392",49696000,1000,0.00268766,0,0,0,0,0
"99393",49696500,1000,0.00274236,0,0,0,0,0
"99394",49697000,1000,0.00278085,0,0,1,1,2
"99395",49697500,1000,0.00272123,0,0,1,2,3
"99396",49698000,1000,0.00261252,0,0,0,1,1
"99397",49698500,1000,0.00260949,0,0,0,1,1
"99398",49699000,1000,0.00262844,0,0,0,1,1
"99399",49699500,1000,0.00261527,0,0,0,0,0
"99400",49700000,1000,0.0025953,0,0,0,0,0
"99401",49700500,1000,0.00279219,0,0,0,2,2
"99402",49701000,1000,0.00280691,0,0,0,2,2
"99403",49701500,1000,0.00263553,0,0,0,1,1
"99404",49702000,1000,0.00262209,0,0,0,2,2
"99405",49702500,1000,0.00273196,0,0,0,1,1
"99406",49703000,1000,0.0027712,0,0,0,0,0
"99407",49703500,1000,0.00269687,0,0,0,0,0
"99408",49704000,1000,0.00267764,0,0,0,0,0
"99409",49704500,1000,0.00285552,0,1,0,1,2
"99410",49705000,1000,0.00289894,0,1,0,1,2
"99411",49705500,1000,0.00286416,0,0,0,2,2
"99412",49706000,1000,0.00278656,0,0,0,2,2
"99413",49706500,1000,0.00260971,0,0,0,0,0
"99414",49707000,1000,0.0026262,0,0,0,1,1
"99415",49707500,1000,0.00265174,0,0,0,1,1
"99416",49708000,1000,0.0026239,0,0,0,1,1
"99417",49708500,1000,0.002587,0,0,0,2,2
"99418",49709000,1000,0.00256461,0,0,0,1,1
"99419",49709500,1000,0.00255952,0,0,0,0,0
"99420",49710000,1000,0.00254858,0,0,0,0,0
"99421",49710500,1000,0.0025623,0,0,0,0,0
"99422",49711000,1000,0.00265509,0,0,0,0,0
"99423",49711500,1000,0.00305151,0,1,1,1,3
"99424",49712000,1000,0.00300234,0,1,1,1,3
"99425",49712500,1000,0.00262868,0,0,0,0,0
"99426",49713000,1000,0.00270728,0,0,1,1,2
"99427",49713500,1000,0.00277243,0,0,1,2,3
"99428",49714000,1000,0.00269411,0,0,0,1,1
"99429",49714500,1000,0.00275727,0,0,0,3,3
"99430",49715000,1000,0.00279221,0,0,0,3,3
"99431",49715500,1000,0.00266982,0,0,0,0,0
"99432",49716000,1000,0.00271993,0,0,0,0,0
"99433",49716500,1000,0.00273419,0,0,0,0,0
"99434",49717000,1000,0.00259459,0,0,0,0,0
"99435",49717500,1000,0.00260139,0,0,0,1,1
"99436",49718000,1000,0.00265268,0,0,0,2,2
"99437",49718500,1000,0.00265968,0,0,1,1,2
"99438",49719000,1000,0.00276244,0,0,1,2,3
"99439",49719500,1000,0.00282806,0,0,0,2,2
"99440",49720000,1000,0.00271437,0,0,0,0,0
"99441",49720500,1000,0.00260108,0,0,0,1,1
"99442",49721000,1000,0.00261237,0,0,0,1,1
"99443",49721500,1000,0.00272379,0,0,0,0,0
"99444",49722000,1000,0.00283166,0,0,0,1,1
"99445",49722500,1000,0.00284705,0,0,0,1,1
"99446",49723000,1000,0.00272225,0,0,0,0,0
"99447",49723500,1000,0.00266312,0,0,0,0,0
"99448",49724000,1000,0.00266125,0,0,0,0,0
"99449",49724500,1000,0.0026653,0,0,0,1,1
"99450",49725000,1000,0.00270836,0,0,0,2,2
"99451",49725500,1000,0.00260075,0,0,0,1,1
"99452",49726000,1000,0.00272115,0,0,1,1,2
"99453",49726500,1000,0.00278045,0,0,1,1,2
"99454",49727000,1000,0.00279445,0,0,0,2,2
"99455",49727500,1000,0.00297796,0,0,0,2,2
"99456",49728000,1000,0.00288067,0,0,0,1,1
"99457",49728500,1000,0.00280744,0,0,0,3,3
"99458",49729000,1000,0.00282306,0,1,0,2,3
"99459",49729500,1000,0.00295234,0,2,0,0,2
"99460",49730000,1000,0.00287608,0,1,0,0,1
"99461",49730500,1000,0.00256999,0,0,0,0,0
"99462",49731000,1000,0.00257837,0,0,0,0,0
"99463",49731500,1000,0.00255963,0,0,0,0,0
"99464",49732000,1000,0.00256013,0,0,0,1,1
"99465",49732500,1000,0.00262913,0,0,0,1,1
"99466",49733000,1000,0.00270968,0,0,0,2,2
"99467",49733500,1000,0.00265017,0,0,0,2,2
"99468",49734000,1000,0.00253795,0,0,0,0,0
"99469",49734500,1000,0.00257804,0,0,0,1,1
"99470",49735000,1000,0.00260724,0,0,0,1,1
"99471",49735500,1000,0.00257179,0,0,0,1,1
"99472",49736000,1000,0.00262176,0,0,1,2,3
"99473",49736500,1000,0.00272428,0,0,1,2,3
"99474",49737000,1000,0.00263649,0,0,0,1,1
"99475",49737500,1000,0.00263225,0,0,0,1,1
"99476",49738000,1000,0.00263733,0,0,0,1,1
"99477",49738500,1000,0.00247413,0,0,0,0,0
"99478",49739000,1000,0.00258599,0,0,0,1,1
"99479",49739500,1000,0.00264048,0,0,0,1,1
"99480",49740000,1000,0.00261334,0,0,0,1,1
"99481",49740500,1000,0.00284643,0,0,0,3,3
"99482",49741000,1000,0.00283405,0,0,1,2,3
"99483",49741500,1000,0.00284096,0,0,1,0,1
"99484",49742000,1000,0.00272986,0,0,0,0,0
"99485",49742500,1000,0.00252989,0,0,0,0,0
"99486",49743000,1000,0.00272566,0,0,0,2,2
"99487",49743500,1000,0.00281654,0,0,0,4,4
"99488",49744000,1000,0.00264652,0,0,0,2,2
"99489",49744500,1000,0.00263096,0,0,0,3,3
"99490",49745000,1000,0.002681,0,0,1,3,4
"99491",49745500,1000,0.00263838,0,0,1,0,1
"99492",49746000,1000,0.00255086,0,0,0,0,0
"99493",49746500,1000,0.00249298,0,0,0,0,0
"99494",49747000,1000,0.00261323,0,0,0,1,1
"99495",49747500,1000,0.00273415,0,0,0,1,1
"99496",49748000,1000,0.00270866,0,0,0,1,1
"99497",49748500,1000,0.00266989,0,0,0,1,1
"99498",49749000,1000,0.00281551,0,0,0,3,3
"99499",49749500,1000,0.00278963,0,0,0,3,3
"99500",49750000,1000,0.00266775,0,0,0,0,0
"99501",49750500,1000,0.0028157,0,0,1,3,4
"99502",49751000,1000,0.00288838,0,0,2,3,5
"99503",49751500,1000,0.00284031,0,0,1,2,3
"99504",49752000,1000,0.00273702,0,0,0,3,3
"99505",49752500,1000,0.00256788,0,0,0,1,1
"99506",49753000,1000,0.00267729,0,0,0,1,1
"99507",49753500,1000,0.00287891,0,0,1,2,3
"99508",49754000,1000,0.00277948,0,0,1,1,2
"99509",49754500,1000,0.0027396,0,0,0,1,1
"99510",49755000,1000,0.00271486,0,0,0,1,1
"99511",49755500,1000,0.00264993,0,0,0,0,0
"99512",49756000,1000,0.00272155,0,0,1,0,1
"99513",49756500,1000,0.00280133,0,0,2,1,3
"99514",49757000,1000,0.00280191,0,0,1,1,2
"99515",49757500,1000,0.00281067,0,0,1,0,1
"99516",49758000,1000,0.0029603,0,0,2,2,4
"99517",49758500,1000,0.0028375,0,0,1,2,3
"99518",49759000,1000,0.00273663,0,0,1,1,2
"99519",49759500,1000,0.00262622,0,0,1,1,2
"99520",49760000,1000,0.00251849,0,0,0,1,1
"99521",49760500,1000,0.00255766,0,0,0,1,1
"99522",49761000,1000,0.00258067,0,0,0,0,0
"99523",49761500,1000,0.00262392,0,0,0,0,0
"99524",49762000,1000,0.00261852,0,0,0,0,0
"99525",49762500,1000,0.00268993,0,0,0,0,0
"99526",49763000,1000,0.00267614,0,0,0,0,0
"99527",49763500,1000,0.00254409,0,0,0,0,0
"99528",49764000,1000,0.00252293,0,0,0,1,1
"99529",49764500,1000,0.00263362,0,0,0,1,1
"99530",49765000,1000,0.0025262,0,0,0,0,0
"99531",49765500,1000,0.002555,0,0,0,0,0
"99532",49766000,1000,0.00264534,0,0,0,0,0
"99533",49766500,1000,0.00265488,0,0,0,0,0
"99534",49767000,1000,0.00272062,0,0,0,0,0
"99535",49767500,1000,0.00273694,0,0,1,1,2
"99536",49768000,1000,0.00268362,0,0,1,1,2
"99537",49768500,1000,0.00273854,0,0,0,1,1
"99538",49769000,1000,0.00281613,0,0,1,2,3
"99539",49769500,1000,0.00263921,0,0,1,1,2
"99540",49770000,1000,0.0026322,0,0,1,1,2
"99541",49770500,1000,0.00279455,0,0,2,3,5
"99542",49771000,1000,0.00264439,0,0,1,2,3
"99543",49771500,1000,0.00258238,0,0,0,0,0
"99544",49772000,1000,0.00281415,0,0,0,5,5
"99545",49772500,1000,0.00288436,0,0,1,6,7
"99546",49773000,1000,0.00279023,0,0,2,1,3
"99547",49773500,1000,0.00269075,0,0,1,0,1
"99548",49774000,1000,0.00261763,0,0,0,0,0
"99549",49774500,1000,0.00269023,0,0,0,2,2
"99550",49775000,1000,0.0027433,0,0,0,2,2
"99551",49775500,1000,0.00263493,0,0,0,0,0
"99552",49776000,1000,0.00275651,0,1,0,0,1
"99553",49776500,1000,0.00278238,0,1,0,0,1
"99554",49777000,1000,0.0025804,0,0,0,0,0
"99555",49777500,1000,0.0024921,0,0,0,0,0
"99556",49778000,1000,0.00251118,0,0,0,1,1
"99557",49778500,1000,0.00254019,0,0,0,1,1
"99558",49779000,1000,0.00253122,0,0,0,0,0
"99559",49779500,1000,0.00262022,0,0,0,0,0
"99560",49780000,1000,0.00262728,0,0,0,0,0
"99561",49780500,1000,0.00267422,0,0,0,1,1
"99562",49781000,1000,0.00268212,0,0,0,1,1
"99563",49781500,1000,0.00266129,0,0,0,1,1
"99564",49782000,1000,0.00277901,0,0,1,3,4
"99565",49782500,1000,0.00266366,0,0,1,2,3
"99566",49783000,1000,0.0025506,0,0,0,0,0
"99567",49783500,1000,0.0026607,0,0,1,0,1
"99568",49784000,1000,0.00270617,0,0,1,0,1
"99569",49784500,1000,0.00274089,0,0,0,0,0
"99570",49785000,1000,0.00273932,0,0,0,0,0
"99571",49785500,1000,0.00262183,0,0,0,0,0
"99572",49786000,1000,0.00255506,0,0,0,0,0
"99573",49786500,1000,0.00274701,0,0,0,2,2
"99574",49787000,1000,0.00278961,0,0,0,2,2
"99575",49787500,1000,0.00265647,0,0,0,0,0
"99576",49788000,1000,0.00266978,0,0,0,2,2
"99577",49788500,1000,0.0025649,0,0,0,2,2
"99578",49789000,1000,0.00247136,0,0,0,0,0
"99579",49789500,1000,0.0024776,0,0,0,0,0
"99580",49790000,1000,0.00270108,0,0,1,0,1
"99581",49790500,1000,0.00267569,0,0,1,0,1
"99582",49791000,1000,0.00268511,0,0,0,2,2
"99583",49791500,1000,0.00285144,0,0,0,2,2
"99584",49792000,1000,0.00262995,0,0,0,0,0
"99585",49792500,1000,0.00256105,0,0,0,0,0
"99586",49793000,1000,0.00263032,0,0,0,1,1
"99587",49793500,1000,0.00270009,0,0,0,2,2
"99588",49794000,1000,0.00269226,0,0,0,1,1
"99589",49794500,1000,0.00262898,0,0,0,0,0
"99590",49795000,1000,0.00267986,0,0,0,0,0
"99591",49795500,1000,0.00260565,0,0,0,0,0
"99592",49796000,1000,0.00255503,0,0,0,0,0
"99593",49796500,1000,0.00266183,0,0,0,0,0
"99594",49797000,1000,0.00282242,0,0,1,1,2
"99595",49797500,1000,0.0030785,0,1,1,2,4
"99596",49798000,1000,0.00298438,0,1,0,1,2
"99597",49798500,1000,0.00285381,0,1,0,0,1
"99598",49799000,1000,0.00278703,0,1,0,0,1
"99599",49799500,1000,0.00279513,0,0,1,3,4
"99600",49800000,1000,0.00288618,0,0,2,4,6
"99601",49800500,1000,0.00272463,0,0,1,2,3
"99602",49801000,1000,0.00274468,0,0,1,2,3
"99603",49801500,1000,0.00272585,0,0,1,2,3
"99604",49802000,1000,0.0026963,0,1,0,1,2
"99605",49802500,1000,0.00269297,0,1,0,1,2
"99606",49803000,1000,0.00269162,0,1,0,1,2
"99607",49803500,1000,0.0027099,0,1,1,1,3
"99608",49804000,1000,0.00267422,0,0,2,2,4
"99609",49804500,1000,0.0025908,0,0,1,2,3
"99610",49805000,1000,0.00259318,0,0,0,1,1
"99611",49805500,1000,0.0026033,0,0,0,0,0
"99612",49806000,1000,0.002622,0,0,1,0,1
"99613",49806500,1000,0.00268932,0,0,1,0,1
"99614",49807000,1000,0.00260998,0,0,0,0,0
"99615",49807500,1000,0.00263207,0,0,0,0,0
"99616",49808000,1000,0.00264704,0,0,0,1,1
"99617",49808500,1000,0.00268976,0,0,0,3,3
"99618",49809000,1000,0.00274653,0,0,0,2,2
"99619",49809500,1000,0.00263993,0,0,0,0,0
"99620",49810000,1000,0.00263786,0,0,0,2,2
"99621",49810500,1000,0.00266805,0,0,0,2,2
"99622",49811000,1000,0.00259766,0,0,0,1,1
"99623",49811500,1000,0.00257488,0,0,0,1,1
"99624",49812000,1000,0.00265548,0,0,1,1,2
"99625",49812500,1000,0.00271975,0,0,1,3,4
"99626",49813000,1000,0.00263428,0,0,0,2,2
"99627",49813500,1000,0.00256662,0,0,0,0,0
"99628",49814000,1000,0.00270437,0,0,0,2,2
"99629",49814500,1000,0.00264529,0,0,0,2,2
"99630",49815000,1000,0.00248368,0,0,0,0,0
"99631",49815500,1000,0.00256827,0,0,0,0,0
"99632",49816000,1000,0.00257385,0,0,0,0,0
"99633",49816500,1000,0.0025455,0,0,0,0,0
"99634",49817000,1000,0.00246604,0,0,0,0,0
"99635",49817500,1000,0.00253192,0,0,0,2,2
"99636",49818000,1000,0.00269112,0,0,0,2,2
"99637",49818500,1000,0.00276518,0,0,0,2,2
"99638",49819000,1000,0.0027646,0,0,0,2,2
"99639",49819500,1000,0.00256531,0,0,0,0,0
"99640",49820000,1000,0.00253891,0,0,0,2,2
"99641",49820500,1000,0.00263044,0,0,0,2,2
"99642",49821000,1000,0.00262261,0,0,0,0,0
"99643",49821500,1000,0.00261062,0,0,0,0,0
"99644",49822000,1000,0.00276643,0,0,1,1,2
"99645",49822500,1000,0.00273698,0,0,1,1,2
"99646",49823000,1000,0.00260122,0,0,0,0,0
"99647",49823500,1000,0.0026298,0,0,0,0,0
"99648",49824000,1000,0.00262767,0,0,0,0,0
"99649",49824500,1000,0.00260629,0,0,0,1,1
"99650",49825000,1000,0.00252834,0,0,0,1,1
"99651",49825500,1000,0.00249733,0,0,0,0,0
"99652",49826000,1000,0.00254761,0,0,0,0,0
"99653",49826500,1000,0.00273747,0,0,0,2,2
"99654",49827000,1000,0.00274967,0,0,0,3,3
"99655",49827500,1000,0.00268834,0,0,0,1,1
"99656",49828000,1000,0.00270555,0,0,0,0,0
"99657",49828500,1000,0.00268012,0,0,0,0,0
"99658",49829000,1000,0.00267598,0,0,0,1,1
"99659",49829500,1000,0.0026246,0,0,0,1,1
"99660",49830000,1000,0.0028395,0,0,1,2,3
"99661",49830500,1000,0.00275423,0,0,1,2,3
"99662",49831000,1000,0.00247442,0,0,0,0,0
"99663",49831500,1000,0.00270232,0,0,1,0,1
"99664",49832000,1000,0.00282603,0,0,1,2,3
"99665",49832500,1000,0.00278273,0,0,0,2,2
"99666",49833000,1000,0.00276932,0,0,0,1,1
"99667",49833500,1000,0.00268661,0,0,0,1,1
"99668",49834000,1000,0.00260313,0,0,0,0,0
"99669",49834500,1000,0.00258681,0,0,0,1,1
"99670",49835000,1000,0.0026059,0,0,0,1,1
"99671",49835500,1000,0.00264946,0,0,0,0,0
"99672",49836000,1000,0.00268932,0,0,0,0,0
"99673",49836500,1000,0.0027319,0,0,0,0,0
"99674",49837000,1000,0.00279346,0,0,1,1,2
"99675",49837500,1000,0.0027632,0,0,1,1,2
"99676",49838000,1000,0.00271136,0,0,0,0,0
"99677",49838500,1000,0.00264733,0,0,0,0,0
"99678",49839000,1000,0.00271758,0,0,1,0,1
"99679",49839500,1000,0.00282946,0,0,1,0,1
"99680",49840000,1000,0.00276433,0,0,0,1,1
"99681",49840500,1000,0.0027404,0,0,1,2,3
"99682",49841000,1000,0.00280011,0,0,2,2,4
"99683",49841500,1000,0.00267107,0,0,1,1,2
"99684",49842000,1000,0.00283618,0,1,1,1,3
"99685",49842500,1000,0.00287344,0,1,1,1,3
"99686",49843000,1000,0.00261997,0,0,0,0,0
"99687",49843500,1000,0.00274377,0,0,0,2,2
"99688",49844000,1000,0.00282221,0,0,0,2,2
"99689",49844500,1000,0.00294567,0,0,1,2,3
"99690",49845000,1000,0.00301579,0,0,2,3,5
"99691",49845500,1000,0.00280351,0,0,1,1,2
"99692",49846000,1000,0.00268918,0,0,0,0,0
"99693",49846500,1000,0.00275111,0,0,0,0,0
"99694",49847000,1000,0.0028011,0,0,0,1,1
"99695",49847500,1000,0.00287017,0,0,0,2,2
"99696",49848000,1000,0.00282425,0,0,0,2,2
"99697",49848500,1000,0.00271862,0,0,0,1,1
"99698",49849000,1000,0.00269466,0,0,0,0,0
"99699",49849500,1000,0.00270358,0,0,0,0,0
"99700",49850000,1000,0.00267218,0,0,0,0,0
"99701",49850500,1000,0.00268099,0,0,0,0,0
"99702",49851000,1000,0.00249413,0,0,0,0,0
"99703",49851500,1000,0.00241746,0,0,0,0,0
"99704",49852000,1000,0.00262349,0,0,0,0,0
"99705",49852500,1000,0.00260734,0,0,0,0,0
"99706",49853000,1000,0.00262151,0,0,0,1,1
"99707",49853500,1000,0.0027036,0,0,0,2,2
"99708",49854000,1000,0.00266464,0,0,0,1,1
"99709",49854500,1000,0.00261198,0,0,0,0,0
"99710",49855000,1000,0.00270155,0,0,0,1,1
"99711",49855500,1000,0.00274616,0,0,0,1,1
"99712",49856000,1000,0.00265372,0,0,0,1,1
"99713",49856500,1000,0.00272876,0,0,0,2,2
"99714",49857000,1000,0.00270989,0,0,0,1,1
"99715",49857500,1000,0.00266206,0,0,1,1,2
"99716",49858000,1000,0.00264129,0,0,1,1,2
"99717",49858500,1000,0.00259332,0,0,0,1,1
"99718",49859000,1000,0.00271919,0,0,0,1,1
"99719",49859500,1000,0.00276976,0,0,0,2,2
"99720",49860000,1000,0.002693,0,0,0,2,2
"99721",49860500,1000,0.00269768,0,0,0,1,1
"99722",49861000,1000,0.00262278,0,0,0,1,1
"99723",49861500,1000,0.00274454,0,1,0,0,1
"99724",49862000,1000,0.00282176,0,1,0,0,1
"99725",49862500,1000,0.00252815,0,0,0,0,0
"99726",49863000,1000,0.00252128,0,0,0,0,0
"99727",49863500,1000,0.00259224,0,0,0,0,0
"99728",49864000,1000,0.00265574,0,0,0,1,1
"99729",49864500,1000,0.00275712,0,0,0,1,1
"99730",49865000,1000,0.00275915,0,0,0,0,0
"99731",49865500,1000,0.00274902,0,0,0,0,0
"99732",49866000,1000,0.00276726,0,0,0,0,0
"99733",49866500,1000,0.0028838,0,0,1,0,1
"99734",49867000,1000,0.00271514,0,0,1,0,1
"99735",49867500,1000,0.00255004,0,0,0,0,0
"99736",49868000,1000,0.00276457,0,0,0,0,0
"99737",49868500,1000,0.00295799,0,1,0,1,2
"99738",49869000,1000,0.00280961,0,1,0,1,2
"99739",49869500,1000,0.00268829,0,0,0,0,0
"99740",49870000,1000,0.00274555,0,0,0,1,1
"99741",49870500,1000,0.0026655,0,0,0,1,1
"99742",49871000,1000,0.00269512,0,0,0,1,1
"99743",49871500,1000,0.00267457,0,0,0,1,1
"99744",49872000,1000,0.00259828,0,0,0,0,0
"99745",49872500,1000,0.00281387,0,0,1,1,2
"99746",49873000,1000,0.00282665,0,0,1,1,2
"99747",49873500,1000,0.00280393,0,0,0,2,2
"99748",49874000,1000,0.00274238,0,0,0,3,3
"99749",49874500,1000,0.00249951,0,0,0,1,1
"99750",49875000,1000,0.00259574,0,0,0,1,1
"99751",49875500,1000,0.00266502,0,0,0,1,1
"99752",49876000,1000,0.00273899,0,1,0,0,1
"99753",49876500,1000,0.00266774,0,1,0,0,1
"99754",49877000,1000,0.00250601,0,0,0,0,0
"99755",49877500,1000,0.00267788,0,0,0,2,2
"99756",49878000,1000,0.00286414,0,0,1,3,4
"99757",49878500,1000,0.00284568,0,0,2,2,4
"99758",49879000,1000,0.00293549,0,0,2,3,5
"99759",49879500,1000,0.00285406,0,0,1,2,3
"99760",49880000,1000,0.00272769,0,0,1,1,2
"99761",49880500,1000,0.00263259,0,0,1,1,2
"99762",49881000,1000,0.00256551,0,0,0,0,0
"99763",49881500,1000,0.00268958,0,0,0,0,0
"99764",49882000,1000,0.00268538,0,0,1,0,1
"99765",49882500,1000,0.00279206,0,0,1,1,2
"99766",49883000,1000,0.00274074,0,0,0,1,1
"99767",49883500,1000,0.00264583,0,0,0,0,0
"99768",49884000,1000,0.00272216,0,0,0,0,0
"99769",49884500,1000,0.00268878,0,0,0,1,1
"99770",49885000,1000,0.00266705,0,0,0,2,2
"99771",49885500,1000,0.00267048,0,0,0,2,2
"99772",49886000,1000,0.00269189,0,0,0,1,1
"99773",49886500,1000,0.00266874,0,0,0,0,0
"99774",49887000,1000,0.00265382,0,0,0,0,0
"99775",49887500,1000,0.00276363,0,0,0,0,0
"99776",49888000,1000,0.00277085,0,0,0,0,0
"99777",49888500,1000,0.00281987,0,0,0,1,1
"99778",49889000,1000,0.0027597,0,0,0,3,3
"99779",49889500,1000,0.00275186,0,0,0,3,3
"99780",49890000,1000,0.00282647,0,0,0,1,1
"99781",49890500,1000,0.00254001,0,0,0,0,0
"99782",49891000,1000,0.00252639,0,0,0,0,0
"99783",49891500,1000,0.0029402,0,1,0,0,1
"99784",49892000,1000,0.00281768,0,1,0,0,1
"99785",49892500,1000,0.00253122,0,0,0,1,1
"99786",49893000,1000,0.00261806,0,0,0,2,2
"99787",49893500,1000,0.00262738,0,0,0,2,2
"99788",49894000,1000,0.00262753,0,0,0,1,1
"99789",49894500,1000,0.00261677,0,0,0,0,0
"99790",49895000,1000,0.00263736,0,0,0,1,1
"99791",49895500,1000,0.00270028,0,0,0,1,1
"99792",49896000,1000,0.0026056,0,0,0,0,0
"99793",49896500,1000,0.00260584,0,0,0,1,1
"99794",49897000,1000,0.00268911,0,0,0,1,1
"99795",49897500,1000,0.00273726,0,0,0,0,0
"99796",49898000,1000,0.00277332,0,0,0,1,1
"99797",49898500,1000,0.00268,0,0,1,1,2
"99798",49899000,1000,0.00266557,0,0,1,1,2
"99799",49899500,1000,0.002602,0,0,0,1,1
"99800",49900000,1000,0.00256357,0,0,0,1,1
"99801",49900500,1000,0.00277292,0,0,0,2,2
"99802",49901000,1000,0.00284215,0,0,0,1,1
"99803",49901500,1000,0.00268817,0,0,0,0,0
"99804",49902000,1000,0.00247318,0,0,0,0,0
"99805",49902500,1000,0.00258108,0,0,0,1,1
"99806",49903000,1000,0.00272716,0,0,0,1,1
"99807",49903500,1000,0.00260361,0,0,0,0,0
"99808",49904000,1000,0.00260986,0,0,0,0,0
"99809",49904500,1000,0.00271297,0,0,1,0,1
"99810",49905000,1000,0.00267722,0,0,1,0,1
"99811",49905500,1000,0.00260262,0,0,0,0,0
"99812",49906000,1000,0.00272821,0,0,1,1,2
"99813",49906500,1000,0.00281254,0,0,1,2,3
"99814",49907000,1000,0.00281942,0,0,0,2,2
"99815",49907500,1000,0.00274528,0,0,0,2,2
"99816",49908000,1000,0.00278404,0,0,0,1,1
"99817",49908500,1000,0.00289525,0,0,0,0,0
"99818",49909000,1000,0.0028304,0,0,0,1,1
"99819",49909500,1000,0.00268259,0,0,0,1,1
"99820",49910000,1000,0.00246341,0,0,0,0,0
"99821",49910500,1000,0.00254228,0,0,1,0,1
"99822",49911000,1000,0.00266052,0,0,1,0,1
"99823",49911500,1000,0.00256222,0,0,0,0,0
"99824",49912000,1000,0.00269871,0,0,0,1,1
"99825",49912500,1000,0.00280321,0,0,0,1,1
"99826",49913000,1000,0.00278636,0,0,0,0,0
"99827",49913500,1000,0.00282074,0,0,0,0,0
"99828",49914000,1000,0.00276317,0,0,0,0,0
"99829",49914500,1000,0.00267449,0,0,0,1,1
"99830",49915000,1000,0.00263888,0,0,0,1,1
"99831",49915500,1000,0.00258598,0,0,0,0,0
"99832",49916000,1000,0.00271791,0,0,0,1,1
"99833",49916500,1000,0.00280318,0,0,0,1,1
"99834",49917000,1000,0.00269796,0,0,0,1,1
"99835",49917500,1000,0.00261684,0,0,0,1,1
"99836",49918000,1000,0.00264785,0,0,0,2,2
"99837",49918500,1000,0.00279833,0,0,1,3,4
"99838",49919000,1000,0.0027735,0,0,1,3,4
"99839",49919500,1000,0.0026319,0,0,0,2,2
"99840",49920000,1000,0.0026338,0,0,0,0,0
"99841",49920500,1000,0.00285419,0,0,1,0,1
"99842",49921000,1000,0.00275697,0,0,1,0,1
"99843",49921500,1000,0.00253114,0,0,0,0,0
"99844",49922000,1000,0.00268943,0,0,1,1,2
"99845",49922500,1000,0.00278413,0,0,1,1,2
"99846",49923000,1000,0.00269667,0,0,0,2,2
"99847",49923500,1000,0.00270891,0,0,0,3,3
"99848",49924000,1000,0.00272597,0,0,0,1,1
"99849",49924500,1000,0.00278082,0,0,1,0,1
"99850",49925000,1000,0.00275505,0,0,1,0,1
"99851",49925500,1000,0.00298866,0,1,0,2,3
"99852",49926000,1000,0.00295941,0,1,0,2,3
"99853",49926500,1000,0.00260186,0,0,0,0,0
"99854",49927000,1000,0.00263148,0,0,0,0,0
"99855",49927500,1000,0.00256579,0,0,0,0,0
"99856",49928000,1000,0.00254311,0,0,0,1,1
"99857",49928500,1000,0.00266475,0,0,0,2,2
"99858",49929000,1000,0.0028763,0,0,0,2,2
"99859",49929500,1000,0.00279586,0,0,0,1,1
"99860",49930000,1000,0.00273737,0,1,0,0,1
"99861",49930500,1000,0.00276029,0,1,0,0,1
"99862",49931000,1000,0.00257958,0,0,0,0,0
"99863",49931500,1000,0.00257134,0,0,0,0,0
"99864",49932000,1000,0.002525,0,0,0,0,0
"99865",49932500,1000,0.00256199,0,0,0,0,0
"99866",49933000,1000,0.00266639,0,0,0,0,0
"99867",49933500,1000,0.00261319,0,0,0,0,0
"99868",49934000,1000,0.00270086,0,0,0,0,0
"99869",49934500,1000,0.00278062,0,0,0,0,0
"99870",49935000,1000,0.00270445,0,0,0,0,0
"99871",49935500,1000,0.00296548,0,1,0,1,2
"99872",49936000,1000,0.00302795,0,1,0,2,3
"99873",49936500,1000,0.00265815,0,0,0,2,2
"99874",49937000,1000,0.00259891,0,0,0,2,2
"99875",49937500,1000,0.00256197,0,0,0,1,1
"99876",49938000,1000,0.00279691,0,0,2,0,2
"99877",49938500,1000,0.00290736,0,0,2,0,2
"99878",49939000,1000,0.00277722,0,0,0,0,0
"99879",49939500,1000,0.00275349,0,0,0,0,0
"99880",49940000,1000,0.00263213,0,0,0,0,0
"99881",49940500,1000,0.00272547,0,0,0,1,1
"99882",49941000,1000,0.00265898,0,0,0,1,1
"99883",49941500,1000,0.00267641,0,0,0,2,2
"99884",49942000,1000,0.00284937,0,0,0,2,2
"99885",49942500,1000,0.00281837,0,0,0,0,0
"99886",49943000,1000,0.00275463,0,0,0,0,0
"99887",49943500,1000,0.00272111,0,0,0,1,1
"99888",49944000,1000,0.00278425,0,0,1,1,2
"99889",49944500,1000,0.00276935,0,0,1,1,2
"99890",49945000,1000,0.00277285,0,0,1,2,3
"99891",49945500,1000,0.00275735,0,0,1,1,2
"99892",49946000,1000,0.00273638,0,0,0,0,0
"99893",49946500,1000,0.00286876,0,0,0,0,0
"99894",49947000,1000,0.00310816,0,1,0,0,1
"99895",49947500,1000,0.00298142,0,1,0,0,1
"99896",49948000,1000,0.00265303,0,0,0,0,0
"99897",49948500,1000,0.00260864,0,0,0,0,0
"99898",49949000,1000,0.0025588,0,0,0,0,0
"99899",49949500,1000,0.0026938,0,0,0,1,1
"99900",49950000,1000,0.00271234,0,0,0,1,1
"99901",49950500,1000,0.00266076,0,0,0,0,0
"99902",49951000,1000,0.00270167,0,0,0,1,1
"99903",49951500,1000,0.00258139,0,0,0,1,1
"99904",49952000,1000,0.00260101,0,0,0,1,1
"99905",49952500,1000,0.00301413,0,1,2,1,4
"99906",49953000,1000,0.0029497,0,1,2,0,3
"99907",49953500,1000,0.00271775,0,0,0,2,2
"99908",49954000,1000,0.00276666,0,0,0,2,2
"99909",49954500,1000,0.00273282,0,0,1,1,2
"99910",49955000,1000,0.00277483,0,0,1,2,3
"99911",49955500,1000,0.00270012,0,0,0,1,1
"99912",49956000,1000,0.00269812,0,0,0,0,0
"99913",49956500,1000,0.00272098,0,0,0,0,0
"99914",49957000,1000,0.00275716,0,0,0,0,0
"99915",49957500,1000,0.00277836,0,0,0,2,2
"99916",49958000,1000,0.00273061,0,0,1,3,4
"99917",49958500,1000,0.00265144,0,0,1,1,2
"99918",49959000,1000,0.00260009,0,0,0,0,0
"99919",49959500,1000,0.00265574,0,0,0,0,0
"99920",49960000,1000,0.00281264,0,0,2,2,4
"99921",49960500,1000,0.00285451,0,0,2,3,5
"99922",49961000,1000,0.00271114,0,0,0,3,3
"99923",49961500,1000,0.0026357,0,0,0,2,2
"99924",49962000,1000,0.00269025,0,0,1,1,2
"99925",49962500,1000,0.00274884,0,0,1,2,3
"99926",49963000,1000,0.00266529,0,0,0,1,1
"99927",49963500,1000,0.00267235,0,0,0,0,0
"99928",49964000,1000,0.00260402,0,0,0,0,0
"99929",49964500,1000,0.00250637,0,0,0,0,0
"99930",49965000,1000,0.00252896,0,0,0,0,0
"99931",49965500,1000,0.00249382,0,0,0,0,0
"99932",49966000,1000,0.00259505,0,0,0,0,0
"99933",49966500,1000,0.002643,0,0,0,1,1
"99934",49967000,1000,0.00264477,0,0,0,1,1
"99935",49967500,1000,0.0027032,0,0,0,0,0
"99936",49968000,1000,0.00266134,0,0,0,0,0
"99937",49968500,1000,0.0025349,0,0,0,0,0
"99938",49969000,1000,0.00264759,0,1,0,1,2
"99939",49969500,1000,0.0027311,0,1,0,1,2
"99940",49970000,1000,0.0026204,0,0,0,0,0
"99941",49970500,1000,0.00265953,0,0,0,1,1
"99942",49971000,1000,0.00277252,0,0,0,3,3
"99943",49971500,1000,0.00265101,0,0,0,2,2
"99944",49972000,1000,0.00240126,0,0,0,0,0
"99945",49972500,1000,0.00244158,0,0,0,0,0
"99946",49973000,1000,0.00269282,0,0,0,2,2
"99947",49973500,1000,0.00276792,0,0,0,2,2
"99948",49974000,1000,0.00278849,0,0,0,0,0
"99949",49974500,1000,0.00271381,0,0,0,0,0
"99950",49975000,1000,0.00272919,0,0,0,2,2
"99951",49975500,1000,0.0027885,0,0,0,3,3
"99952",49976000,1000,0.00274631,0,0,0,2,2
"99953",49976500,1000,0.00276472,0,0,0,1,1
"99954",49977000,1000,0.00266027,0,0,0,0,0
"99955",49977500,1000,0.00260048,0,0,0,0,0
"99956",49978000,1000,0.00261555,0,0,0,1,1
"99957",49978500,1000,0.00281662,0,1,0,1,2
"99958",49979000,1000,0.00274509,0,1,0,0,1
"99959",49979500,1000,0.00259854,0,0,0,0,0
"99960",49980000,1000,0.00270082,0,0,0,0,0
"99961",49980500,1000,0.00276558,0,0,0,1,1
"99962",49981000,1000,0.00283271,0,1,0,1,2
"99963",49981500,1000,0.00294995,0,1,2,0,3
"99964",49982000,1000,0.00287986,0,0,2,0,2
"99965",49982500,1000,0.00274048,0,0,0,2,2
"99966",49983000,1000,0.0027214,0,0,0,2,2
"99967",49983500,1000,0.00280359,0,0,1,2,3
"99968",49984000,1000,0.00295219,0,1,1,2,4
"99969",49984500,1000,0.00287871,0,1,0,2,3
"99970",49985000,1000,0.00274837,0,0,0,3,3
"99971",49985500,1000,0.00268827,0,0,0,1,1
"99972",49986000,1000,0.0026562,0,0,0,0,0
"99973",49986500,1000,0.00275363,0,0,0,2,2
"99974",49987000,1000,0.00280975,0,0,0,3,3
"99975",49987500,1000,0.00296681,0,1,0,2,3
"99976",49988000,1000,0.00283352,0,1,0,1,2
"99977",49988500,1000,0.00267893,0,0,1,0,1
"99978",49989000,1000,0.00286862,0,0,1,1,2
"99979",49989500,1000,0.00277243,0,0,0,1,1
"99980",49990000,1000,0.00256146,0,0,0,0,0
"99981",49990500,1000,0.00262253,0,0,0,1,1
"99982",49991000,1000,0.00269208,0,0,0,2,2
"99983",49991500,1000,0.00263869,0,0,0,2,2
"99984",49992000,1000,0.00283317,0,0,1,2,3
"99985",49992500,1000,0.00282633,0,0,1,2,3
"99986",49993000,1000,0.00264476,0,0,0,1,1
"99987",49993500,1000,0.00244798,0,0,0,0,0
"99988",49994000,1000,0.00239336,0,0,0,0,0
"99989",49994500,1000,0.00276341,0,1,0,0,1
"99990",49995000,1000,0.00279281,0,1,0,0,1
"99991",49995500,1000,0.00257042,0,0,0,0,0
"99992",49996000,1000,0.00272578,0,0,0,0,0
"99993",49996500,1000,0.00278985,0,0,0,0,0
"99994",49997000,1000,0.00258883,0,0,0,0,0
"99995",49997500,1000,0.00256872,0,0,0,0,0
"99996",49998000,1000,0.00270797,0,0,0,1,1
"99997",49998500,1000,0.00279654,0,0,0,2,2
"99998",49999000,1000,0.00270218,0,0,0,1,1
"99999",49999500,1000,0.00266304,0,0,0,1,1
